ܐܦܪܝܩܐ	Afriko
ܝܦܢ	Japanio
ܐܡܪܝܩܐ ܬܝܡܢܝܬܐ	Sudameriko
ܢܘܪܒܝܓ	Norvegio
ܩܘܛܢܝܘܬܐ ܕܐܝܪܠܢܕ	Irlando
ܡܓܪ	Hungario
ܐܣܦܢܝܐ	Hispanio
ܐܘܚܕܢܐ ܡܚܝܕܐ	Usono
ܒܠܓܝܩܐ	Belgio
ܠܘܟܣܡܒܘܪܓ	Luksemburgo (lando)
ܬܒܝܠ	Universo
ܐܪܥܐ	Tero
ܡܘܬܐ	Morto
ܒܪ ܐܢܫܐ	Homo
ܓܘܪܓ ܘܐܫܝܢܓܛܘܢ	George Washington
ܦܝܢܠܢܕ	Finnlando
ܣܘܝܕ	Svedio
ܕܐܢܡܐܪܩ	Danio
ܦܘܠܢܕ	Pollando
ܠܬܘܢܝܐ	Litovio
ܐܝܛܠܝܐ	Italio
ܣܘܝܣܪܐ	Svislando
ܢܡܣܐ	Aŭstrio
ܝܘܢ	Grekio
ܛܘܪܩܝܐ	Turkio
ܦܘܪܛܘܓܠ	Portugalio
ܐܘܪܘܦܐ (ܝܒܫܬܐ)	Eŭropo
ܐܣܝܐ (ܝܒܫܬܐ)	Azio
ܐܡܪܝܩܐ ܓܪܒܝܝܬܐ	Nordameriko
ܐܢܛܐܪܩܛܝܩܐ	Antarkto
ܘܝܩܝܦܕܝܐ	Vikipedio
ܗܘܠܢܕܐ	Nederlando
ܢܝܘ ܝܘܪܩ (ܡܕܝܢܬܐ)	Novjorko
ܘܐܫܢܓܛܘܢ (ܐܪܫܟܝܬܐ)	Vaŝingtono
ܒܪܠܝܢ	Berlino
ܚܫܘܒܐ (ܡܐܟܢܐ)	Komputilo
ܒܪܢ	Berno
ܬܣܝܪܝܟ	Zuriko
ܐܢܛܪܢܛ	Interreto
ܒܪܐܩ ܐܘܒܐܡܐ	Barack Obama
ܠܘܢܕܘܢ	Londono
ܐܠܟܣܢܕܪܝܐ	Aleksandrio
ܚܙܘܪܐ	Pomo
ܦܐܪܝܣ	Parizo
ܡܟܣܝܩܘ	Meksiko
ܐܘܩܝܢܘܣ ܐܛܠܢܛܝܐ	Atlantika Oceano
ܐܘܩܝܢܘܣ ܫܝܢܝܐ	Pacifika Oceano
ܒܘܣܛܘܢ	Bostono
ܬܪܝܢܒܫܒܐ	Lundo
ܟܢܘܢ ܒ	Januaro
ܫܒܛ	Februaro
ܐܕܪ	Marto
ܟܘܫ	Etiopio
ܢܝܣܢ	Aprilo
ܐܝܪ	Majo
ܚܙܝܪܢ	Junio
ܬܡܘܙ	Julio
ܐܒ	Aŭgusto
ܐܝܠܘܠ	Septembro
ܬܫܪܝܢ ܐ	Oktobro
ܬܫܪܝܢ ܒ	Novembro
ܟܢܘܢ ܐ	Decembro
ܬܠܬܒܫܒܐ	Mardo
ܐܪܒܥܒܫܒܐ	Merkredo
ܚܡܫܒܫܒܐ	Ĵaŭdo
ܥܪܘܒܬܐ	Vendredo
ܫܒܬܐ (ܙܒܢܐ)	Sabato
ܚܕܒܫܒܐ	Dimanĉo
ܐܪܝܐ	Leono
ܦܪܢܣܐ	Francio
ܟܠܒܐ	Hundo
ܡܠܟܘܬܐ ܡܚܝܕܬܐ	Unuiĝinta Reĝlando
ܩܛܐ	Hejma kato
ܩܘܛܢܝܘܬܐ ܥܡܡܝܬܐ ܕܨܝܢ	Ĉina Popola Respubliko
ܠܫܢܐ ܦܪܢܣܝܐ	Franca lingvo
ܒܪܐܙܝܠ	Brazilo
ܪܘܣܝܐ	Rusio
ܝܡܐ	Maro
ܝܡܐ ܐܘܟܡܐ	Nigra Maro
Π	Pio (litero)
ܐܠܒܐܡܐ	Alabamo
ܣܐܘ ܦܐܘܠܘ	San-Paŭlo (urbo)
ܩܝܒܩ (ܗܘܦܪܟܝܐ)	Kebekio
ܓܪܡܢ	Germanio
ܒܠܐܪܘܣ	Belorusio
ܠܫܢܐ ܓܪܡܢܝܐ	Germana lingvo
ܐܠܗܐ	Dio
ܐܣܛܘܢܝܐ	Estonio
ܛܝܣܬܐ	Aviadilo
ܩܪܒܐ	Milito
1 (ܡܢܝܢܐ)	1 (nombro)
2 (ܡܢܝܢܐ)	2 (nombro)
3 (ܡܢܝܢܐ)	3 (nombro)
4 (ܡܢܝܢܐ)	4 (nombro)
5 (ܡܢܝܢܐ)	5 (nombro)
ܠܐܛܒܝܐ	Latvio
ܐܘܩܪܐܝܢܐ	Ukrainio
ܬܫܝܟ	Ĉeĥio
ܣܠܘܒܩܝܐ	Slovakio
ܣܠܘܒܢܝܐ	Slovenio
ܡܘܠܕܘܒܐ	Moldava Respubliko
ܪܘܡܢܝܐ	Rumanio
ܒܘܠܓܐܪܝܐ	Bulgario
ܪܗܘܡܐ (ܡܕܝܢܬܐ)	Romo
ܩܘܛܢܝܘܬܐ ܕܡܩܕܘܢܝܐ	Respubliko Makedonio
ܐܠܒܢܝܐ	Albanio
ܩܪܘܐܛܝܐ	Kroatio
ܒܘܣܢܐ ܘܗܪܬܣܓܘܒܝܢܐ	Bosnio kaj Hercegovino
ܐܙܪܒܝܓܐܢ	Azerbajĝano
ܐܢܕܘܪܐ	Andoro
ܩܘܦܪܘܣ	Kipro
ܓܘܪܓܝܐ (ܐܬܪܐ)	Kartvelio
ܩܙܩܣܛܐܢ	Kazaĥio
ܡܝܠܛܐ	Malto
ܡܘܢܐܩܘ	Monako
ܛܘܪܐ ܐܘܟܡܐ	Montenegro
ܡܕܝܢܬܐ ܕܘܛܝܩܢ	Vatikano
ܣܢ ܡܪܝܢܘ	San-Marino
ܒܪܘܟܣܠ	Brusela Ĉefurba Regiono
ܠܘܕܒܝܓ ܒܐܢ ܒܝܛܗܘܒܢ	Ludwig van Beethoven
ܠܫܢܐ ܛܘܪܩܝܐ	Turka lingvo
ܓܙܐܐܪ	Alĝerio
ܐܘܙܒܩܣܛܐܢ	Uzbekujo
ܘܐܪܣܘ	Varsovio
ܚܡܪܐ (ܫܬܝܐ)	Vino
ܡܝܐ	Akvo
ܦܪܣ ܚܙܘܐ	Televido
ܬܫܝܠܝ	Ĉilio
ܐܠ ܓܪܝܩܘ	El Greco
ܝܫܘܥ	Jesuo Kristo
ܠܫܢܐ (ܡܡܠܠܐ)	Lingvo
ܫܘܠܛܢ ܛܪܘܢܘܬܐ	Diktatoreco
ܡܡܠܠܘܬ ܟܘܟܒܐ	Astronomio
ܡܪܝܡ (ܐܡܗ ܕܝܫܘܥ)	Maria (patrino de Jesuo)
ܠܝܟܛܢܫܛܝܢ	Liĥtenŝtejno
ܐܕܘܠܦ ܗܝܛܠܪ	Adolf Hitler
ܠܝܢܘܟܣ	Linukso
ܠܫܢܐ ܠܐܛܝܢܝܐ	Latina lingvo
ܒܚܪܝܢ	Barejno
ܐܪܡܢܝܐ	Armenio
ܣܪܒܝܐ	Serbio
ܣܗܪܐ	Luno
ܐܝܣܛܢܒܘܠ (ܡܕܝܢܬܐ)	Istanbulo
ܐܘܣܛܪܠܝܐ (ܐܬܪܐ)	Aŭstralio
ܦܝܣܝܟ	Fiziko
ܩܘܪܐܢ	Korano
ܐܣܠܐܡ	Islamo
ܟܡܬܪܐ	Pirarbo
ܠܟ ܒܐܘܢܣܐ	Lech Wałęsa
ܫܠܡܐ (ܫܝܢܐ)	Paco
ܚܘܝܕܐ ܐܘܪܘܦܝܐ	Eŭropa Unio
ܐܢܬܬܐ	Virino
ܛܝܙܐ	Anuso
ܫܚܬܐ (ܝܘܠܦܢ ܨܪܘܝܘܬܐ)	Akselo
ܗܒܒܐ	Floro
ܝܘܠܦܢ ܨܪܘܝܘܬܐ	Anatomio
ܡܕܝܢܬܐ	Urbo
ܢܐܦܠܝܘܢ ܒܘܢܐܦܪܛ	Napoleono Bonaparte
ܟܘܟܒܐ	Stelo
ܫܡܫܐ	Suno
ܩܪܝܬܐ	Vilaĝo
ܝܡܐ ܕܡܕܢܚܐ	Balta Maro
ܫܢܐ	Dento
ܘܝܩܝܡܝܕܝܐ ܩܘܡܡܘܢܣ	Vikimedia Komunejo
ܟܬܒܐ (ܣܦܪܐ)	Libro
ܝܘܡܐ	Tago
ܠܠܝܐ	Nokto
ܫܢܬܐ (ܙܒܢܐ)	Jaro
ܕܪܐ	Jarcento
ܐܘܣܠܘ	Oslo
ܠܫܒܘܢܐ	Lisbono
ܦܠܝܛܐ	Planedo
ܙܡܪܘܬܐ	Muziko
ܡܘܣܩܒܐ	Moskvo
ܠܫܢܐ ܐܝܛܠܝܐ	Itala lingvo
ܬܫܐܕ	Ĉado
ܬܝܡܢܐ	Nordo
ܢܝܘ ܙܝܠܢܕ	Nov-Zelando
ܓܪܒܝܐ	Sudo
ܗܢܕܘ	Barato
ܦܪܙܠܐ	Fero
ܡܥܪܒܐ	Okcidento
ܡܕܢܚܐ	Oriento
ܒܢܙܘܝܠܐ	Venezuelo
ܛܠܦܣܢܐ	Ŝako
ܡܝܢ	Majno
ܣܘܣܝܐ	Ĉevalo
ܐܡܣܛܪܕܐܡ	Amsterdamo
ܙܝܢܐ	Armilo
ܚܝܘܬܐ	Bestoj
ܩܘܠܘܡܒܝܐ	Kolombio
ܢܝܘ ܗܐܡܦܫܪ	Nov-Hampŝiro
ܠܝܘܢܪܕܘ ܕܗ ܒܢܬܫܝ	Leonardo da Vinci
ܡܐܣܐܬܫܘܣܬܣ	Masaĉuseco
ܐܘܛܪܝܟܛ (ܗܘܦܪܟܝܐ)	Utrecht (provinco)
ܟܘܢܝܬܝܟܬ	Konektikuto
ܐܝܪܐܢ	Irano
ܥܝܪܐܩ	Irako
ܐܠܐܣܟܐ	Alasko
ܐܝܣܪܐܝܠ	Israelo
ܐܘܛܪܝܟܛ (ܡܕܝܢܬܐ)	Utrecht
ܝܡܢ	Jemeno
ܠܫܢܐ ܦܘܠܢܕܝܐ	Pola lingvo
ܝܘܪܕܢܢ	Jordanio
ܩܝܪܓܝܙܣܛܐܢ	Kirgizio
ܐܪܝܙܘܢܐ	Arizono
ܟܘܘܝܬ (ܐܬܪܐ)	Kuvajto
ܠܒܢܢ	Libano
ܐܘܪܝܓܘܢ	Oregono
ܐܡܪܝܩܐ	Ameriko
ܝܘܬܐ	Utaho
ܥܘܡܐܢ	Omano
ܦܐܩܣܛܐܢ	Pakistano
ܩܛܪ	Kataro
ܣܥܘܕܝܐ	Sauda Arabio
ܝܘܣܦ ܣܛܐܠܝܢ	Josif Stalin
ܣܘܪܝܐ	Sirio
ܛܐܓܝܩܣܛܐܢ	Taĝikio
ܦܪܣ ܩܠܐ	Radiofonio
ܛܘܪܩܡܢܣܛܐܢ	Turkmenio
ܐܡܝܪܘܬܐ ܥܪܒܝܬܐ ܡܚܝܕܬܐ	Unuiĝintaj Arabaj Emirlandoj
ܐܦܓܐܢܣܛܐܢ	Afganio
ܕܗܒܐ	Oro
ܡܠܝ	Malio
ܦܝܠܝܦܝܢܝܐ	Filipinoj
ܩܘܛܢܝܘܬܐ ܕܐܦܪܝܩܐ ܡܨܥܝܬܐ	Centr-Afrika Respubliko
ܐܝܣܚܩ ܢܝܘܛܢ	Isaac Newton
ܫܥܘܬܐ (ܓܘܢܐ)	Flava
ܬܘܢܣ (ܐܬܪܐ)	Tunizio
ܬܝܡܢܐ ܕܣܘܕܐܢ	Sud-Sudano
ܩܘܛܢܝܘܬܐ ܕܩܘܢܓܘ	Respubliko Kongo
ܩܘܛܢܝܘܬܐ ܕܩܘܢܓܘ ܕܝܡܘܩܪܛܝܬܐ	Demokratia Respubliko Kongo
ܦܐܦܐ ܝܘܚܢܢ ܦܘܠܘܣ ܬܪܝܢܐ	Johano Paŭlo la 2-a
ܛܒܝܠܝܣܝ	Tbiliso
ܩܐܡܪܘܢ	Kameruno
ܠܘܒܐ	Libio
ܡܘܪܝܛܢܝܐ	Maŭritanio
ܡܓܪܒ	Maroko
ܢܝܓܪ	Niĝero
ܣܘܕܐܢ	Sudano
ܩܫܬܐ ܕܡܪܢ	Ĉielarko
ܗܐܡܒܘܪܓ	Hamburgo
ܝܡܬܐ ܕܐܘܢܛܪܝܘ	Ontario (lago)
ܝܡܬܐ ܕܣܘܦܝܪܝܘܪ	Supra Lago
ܓܐܘܓܪܦܝܐ	Geografio
ܠܒܐ	Koro
ܡܘܚܐ	Cerbo
ܓܠܕܐ	Haŭto
ܓܘܢܐ	Koloro
ܦܪܐܓ	Prago
ܙܪܩܐ	Blua
ܟܣܦܐ (ܣܐܡܐ)	Arĝento
ܡܫܝܓܢ	Miĉigano
ܝܡܬܐ ܕܡܝܫܝܓܢ	Miĉigano (lago)
ܐܠܝܢܘܝ	Ilinojso
ܢܘܪܬ ܕܐܟܘܬܐ	Norda Dakoto
ܣܐܘܬ ܕܐܟܘܬܐ	Suda Dakoto
ܡܘܢܬܐܢܐ	Montano
ܘܐܝܘܡܝܢܓ	Vajomingo
ܐܘܪܫܠܡ	Jerusalemo
ܐܝܕܐܗܘ	Idaho
ܢܝܒܐܕܐ	Nevado
ܐܘܩܝܢܘܣ ܗܢܕܘܝܐ	Hinda Oceano
ܟܘܠܘܪܐܕܘ	Koloradio
ܫܝܩܓܘ	Ĉikago
ܣܬܘܐ	Vintro
ܬܕܐܐ	Printempo
ܩܝܛܐ	Somero
ܬܫܪܝܬܐ	Aŭtuno
ܨܕܐܡ ܚܘܣܝܢ	Saddam Hussein
ܠܫܢܐ ܐܣܦܢܝܐ	Hispana lingvo
ܓܘܓܝ	Araneuloj
ܐܒܐ (ܦܐܪܐ)	Frukto
ܩܘܦܐ	Simio
ܒܪܓܝܢܝܐ	Virginio (ŝtato)
ܝܡܬܐ ܕܝܘܪܘܢ	Lago Hurono
ܢܝܘ ܝܘܪܩ (ܐܘܚܕܢܐ ܡܚܝܕܐ)	Nov-Jorkio
ܪܘܕ ܐܝܠܐܢܕ	Rod-Insulo
ܪܚܫܐ	Insekto
ܡܐܪܝܠܐܢܕ	Marilando
ܕܝܠܐܘܝܪ	Delavaro
ܐܘܗܐܝܘ	Ohio
ܦܢܣܝܠܒܐܢܝܐ	Pensilvanio
ܐܝܛܙܢ	Uetersen
ܐܓܘܣܛܘܣ ܩܣܪ	Aŭgusto Cezaro
ܢܝܘ ܓܝܪܣܝ	Nov-Ĵerzejo
ܐܢܕܝܐܢܐ	Indianio
ܪܕܝܬܐ	Aŭtomobilo
ܓܘܪܓܝܐ (ܐܘܚܕܢܐ ܡܚܝܕܐ)	Georgio
ܣܩܠܝܐ	Sicilio
ܣܢ (ܢܗܪܐ)	Sejno
ܛܘܩܝܘ	Tokio
ܦܪܕܝܢܢܕ ܡܓܝܠܢ	Fernão de Magalhães
ܢܝܘ ܡܝܟܣܝܟܘ	Nov-Meksiko
ܐܬܢܘܣ	Ateno
ܡܢܝܣܘܬܐ	Minesoto
ܒܓܕܐܕ (ܡܕܝܢܬܐ)	Bagdado
ܘܝܣܟܘܢܣܢ	Viskonsino
ܐܝܐܘܐ	Iovao
ܢܝܒܪܐܣܟܐ	Nebrasko
ܟܐܢܣܐܣ	Kansaso
ܡܝܙܘܪܝ	Misurio
ܐܪܟܢܣܐܣ	Arkansaso
ܠܫܢܐ ܕܐܘܪܕܘ	Urduo
ܐܘܟܠܐܗܘܡܐ	Oklahomo
ܝܡܐ ܕܓܪܒܝܐ	Norda Maro
ܒܝܝܢܐ	Vieno
ܩܘܦܢܗܐܓܢ	Kopenhago
ܣܛܘܩܗܘܠܡ	Stokholmo
ܗܠܣܢܩܝ	Helsinko
ܕܒܠܢ	Dublino
ܒܪܛܝܣܠܐܒܐ	Bratislavo
ܟܬܒܐ ܩܕܝܫܐ	Biblio
ܥܕܬܐ ܫܪܝܪܬܐ ܕܝܫܘܥ	Vera Eklezio de Jesuo
ܠܫܢܐ ܐܢܓܠܝܐ	Angla lingvo
ܩܘܢܣܦܣܝܘܢ (ܬܫܝܠܝ)	Koncepciono
ܐܘܢܛܐܪܝܘ	Ontario
ܡܐܢܝܛܘܒܐ	Manitobo
ܐܠܒܪܛܐ	Alberto
ܢܘܒܐ ܣܩܘܛܝܐ	Nov-Skotio
ܩܘܢܣܩܘܒܘܠܐ	Końskowola
ܢܝܘ ܒܪܘܢܙܘܝܩ	Nov-Brunsviko
ܩܘܠܘܡܒܝܐ ܒܪܝܛܝܬܐ	Brita Kolumbio
ܓܙܪܬܐ ܕܐܡܝܪܐ ܐܕܘܐܪܕ	Insulo de Princo Eduardo
ܣܐܣܩܐܬܫܘܐܢ	Saskaĉevano
2012	2012
2011	2011
2010	2010
2009	2009
ܢܝܘܦܐܘܢܕܠܢܕ ܘܠܐܒܪܐܕܘܪ	Novlando kaj Labradoro
2008	2008
ܐܘܚܕܢܐ ܓܪܒܝܝܐ-ܡܥܪܒܝܐ	Nordokcidentaj Teritorioj
ܝܘܩܘܢ	Jukonio
2005	2005
2006	2006
ܢܘܢܐܒܘܛ	Nunavuto
2007	2007
ܡܐܟܘܠܬܐ	Manĝaĵo
ܚܘܝܐ	Serpento
ܩܘܪܘܦ	Kurów
ܟܝܡܝܐ	Kemio
1968	1968
ܩܛܠܥܡܐ ܝܗܘܕܝܐ	Holokaŭsto
ܡܕܪܝܕ (ܡܕܝܢܬܐ)	Madrido
ܗܘܦܪܟܝܣ ܘܐܘܚܕܢܐ ܕܩܢܕܐ	Provincoj kaj teritorioj de Kanado
ܣܢܛܝܐܓܘ ܕܐ ܬܫܝܠܝ	Santiago de Ĉilio
ܚܐܪܘܬܐ	Libereco
ܣܝܕܢܝ	Sidnejo
ܝܪܘܩܐ	Verdo
ܡܠܒܘܪܢ	Melburno
ܣܘܡܩܐ	Ruĝa
ܢܘܪܐ (ܕܠܩܐ)	Fajro
ܢܝܠܘܣ	Nilo
ܓܙܐܐܪ (ܡܕܝܢܬܐ)	Alĝero
ܬܘܢܣ (ܡܕܝܢܬܐ)	Tunizo
ܛܗܪܐܢ	Teherano
ܐܢܩܪܐ	Ankaro
ܢܝܐܡܝ	Niameo
ܒܡܩܘ	Bamako
ܕܪܡܣܘܩ	Damasko
ܥܡܐܢ	Amano
ܒܝܪܘܬ	Bejruto
ܒܝܬ ܨܘܒܐ	Universitato
ܒܝܬܐ (ܒܢܝܢܐ)	Domo
ܐܘܣܛܪܠܝܐ (ܝܒܫܬܐ)	Aŭstralia kontinento
ܢܗܪܐ	Rivero
ܪܝܫܐ ܕܣܒܪܐ ܛܒܐ	Kabo de Bona Espero
ܫܘܚܡܠܐ	Investado
ܩܘܪܝܛܝܒܐ	Kuritibo
ܥܒܐ	Arbaro
ܩܘܢܦܘܫܝܘܣ	Konfuceo
ܩܢܐ	Nesto
ܐܘܪܘ	Eŭro
ܝܡܐ ܚܘܪܐ ܡܨܥܝܐ	Mediteraneo
ܡܫܝܚܝܘܬܐ	Kristanismo
ܩܠܒܐ:ܐܘܝܐ	Ŝablono:Por
ܪܘܙܐ	Rizo
ܝܒܫܬܐ	Kontinento
ܛܝܪܐ	Birdoj
ܐܪܫܟܝܬܐ	Ĉefurbo
ܠܫܢܐ ܦܘܪܛܘܓܠܝܐ	Portugala lingvo
ܝܪܚܐ	Monato
ܡܘܨܛܦܐ ܟܡܐܠ ܐܛܐܛܘܪܩ	Mustafa Kemal Atatürk
ܐܠܡܐܙܢ	Almazán
ܠܫܢܐ ܝܦܢܝܐ	Japana lingvo
ܦܐܬܐ ܪܝܫܝܬܐ	Vikipedio:Ĉefpaĝo
ܦܪܢܣܝܣܩܘ ܓܘܝܐ	Francisco de Goya
ܝܡܐ ܐܚܪܝܐ	Kaspio
ܝܡܬܐ ܕܐܝܪܝ	Eria Lago
ܣܠܒܐܕܘܪ ܕܐܠܝ	Salvador Dalí
ܒܢܣܢܬ ܦܢ ܟܘܟ	Vincent van Gogh
ܦܪܝܕܐ ܩܐܠܘ	Frida Kahlo
ܗܢܪܝ ܡܐܛܝܣ	Henri Matisse
ܡܝܟܠܐܢܓܠܘ	Mikelanĝelo
ܦܒܠܘ ܦܝܩܐܣܘ	Pablo Picasso
ܪܡܒܪܢܛ	Rembrandt Harmenszoon van Rijn
ܐܢܕܝ ܘܘܪܗܘܠ	Andy Warhol
ܢܝܢܘܐ (ܡܕܝܢܬܐ)	Ninivo
ܒܒܠ	Babilono
ܐܝܪܝܚܘ	Jeriĥo
ܩܛܠܘܢܝܐ	Katalunio
ܡܕܪܝܕ (ܗܘܦܪܟܝܐ)	Madrida Regiono
ܒܝܬ ܠܚܡ	Bet-Leĥem
ܣܕܪܐ:Candidates for speedy deletion	Kategorio:Tujforigendaj artikoloj
ܪܫܡܠܘܬܐ	Kapitalismo
ܐܘܡܬܐ	Nacio
ܩܪܬܐܓܘ	Kartago
ܣܕܪܐ:ܐܣܛܪܘܢܘܡܝܐ	Kategorio:Astronomio
ܨܚܪܐܐ	Saharo
ܫܐܕܐ	Diablo
ܒܝܬ ܟܬܒܐ	Librarejo
ܫܘܠܛܢܘܬܐ (ܫܘܬܐܣܐ)	Registaro
ܬܫܝܢ ܫܝ ܗܘܐܢܓ	Qin Shihuangdi
ܡܕܢܚܐ ܡܨܥܝܬܐ	Mezoriento
ܡܠܟܘܬܐ	Monarkio
ܩܘܛܢܝܘܬܐ	Respubliko
ܐܬܪܐ	Ŝtato
ܓܒܐ	Partio (politiko)
ܝܗܘܕܝܐ	Judoj
ܝܡܡܬܐ ܪܘܪܒܬܐ	Grandaj Lagoj (Nordameriko)
ܐܘܩܝܢܘܣ ܬܝܡܢܝܐ	Suda Oceano
ܐܕܢܐ (ܝܘܠܦܢ ܨܪܘܝܘܬܐ)	Orelo
ܢܚܝܪܐ	Nazo (organo)
ܥܝܢܐ (ܝܘܠܦܢ ܨܪܘܝܘܬܐ)	Okulo
ܥܘܩܒܪܬܐ	Muskolo
ܙܡܝܪܬܐ	Kanto
ܓܡܠܐ	Kamelo
ܫܘܫܡܢܐ	Formiko
ܕܒܫܬܐ	Abelo
ܠܫܢܐ ܗܘܠܢܕܝܐ	Nederlanda lingvo
ܐܡܐ (ܒܝܬܝܘܬܐ)	Patrino
ܐܒܐ (ܒܝܬܝܘܬܐ)	Patro
1847	1847
ܨܦܪܐ (ܙܒܢܐ)	Mateno
ܪܡܫܐ	Vespero
ܩܛܝܢܬܐ	Minuto
ܠܫܢܐ ܪܘܣܝܐ	Rusa lingvo
ܩܢܘܢܐ	Leĝo (jura)
ܠܫܢܐ ܨܝܢܝܐ	Ĉina lingvaro
ܕܡܐ	Sango
ܬܓܪܘܡܬܐ	Skeleto
ܪܐܬܐ	Pulmo
ܠܫܢܐ ܪܘܡܢܝܐ	Rumana lingvo
ܡܛܪܐ	Pluvo
ܢܠܣܘܢ ܡܐܢܕܝܠܐ	Nelson Mandela
ܐܒܢܐ	Rokaĵo
ܥܢܢܐ	Nubo
ܩܢܘܢܐ ܕܠܥܙܐ	Gramatiko
ܠܫܢܐ ܓܘܪܓܝܐ	Kartvela lingvo
ܝܘܠܦܢ ܡܡܫܚܘܬܐ	Ekonomiko
ܙܘܙܐ	Valuto
ܡܕܐܬܐ	Imposto
ܐܠܦܒܝܬ ܥܪܒܝܐ	Araba alfabeto
ܐܠܦܒܝܬ ܝܘܢܝܐ	Greka alfabeto
ܐܠܦܒܝܬ ܠܐܛܝܢܝܐ	Latina alfabeto
ܣܕܪܐ:ܦܪܢܣܐ	Kategorio:Francio
ܟܢܫܐ	Socio
ܓܒܪܐ	Viro
ܙܘܘܓܐ	Geedzeco
ܙܕܩܐ ܕܒܪܢܫܐ	Homaj rajtoj
ܩܪܒܐ ܓܘܝܐ	Interna milito
ܓܪܡܐ ܕܣܢܘܢܝܬܐ	Sternumo
ܬܪܝܢܐ	Suko
ܚܠܒܐ (ܕܝܘܒܐ)	Lakto
ܛܘܪܐ	Monto
ܡܕܒܪܐ	Dezerto
ܠܫܢܐ ܐܠܒܢܝܐ	Albana lingvo
ܠܫܢܐ ܐܪܡܢܝܐ	Armena lingvo
ܝܘܗܐܢ ܓܘܛܢܒܪܓ	Johannes Gutenberg
ܠܫܢܐ ܣܘܝܕܝܐ	Sveda lingvo
ܢܝܩܘܠܐ ܛܣܠܐ	Nikola Tesla
ܡܘܫܐ	Moseo
ܬܕܐ	Mamo
ܢܘܗܪܐ (ܚܙܝܬܐ)	Lumo
ܠܫܢܐ ܝܘܢܝܐ	Greka lingvo
ܠܫܢܐ ܦܪܣܝܐ	Persa lingvo
ܬܘܕܝܬܐ	Religio
ܐܒܪܗܡ	Abraham
ܣܦܪܐ ܕܒܪܝܬܐ	Genezo
ܠܫܢܐ ܩܢܛܘܢܝܐ	Kantona lingvo
ܠܫܢܐ ܡܢܕܪܝܢܝܐ	Nordĉina dialektaro
ܦܘܠܘܣ ܫܠܝܚܐ	Paŭlo de Tarso
ܙܝܓܡܘܢܕ ܦܪܘܝܕ	Sigmund Freud
ܙܠܛܐ	Salato
ܝܗܘܕܝܘܬܐ	Judismo
ܠܫܢܐ ܥܒܪܝܐ	Hebrea lingvo
ܟܒܕܐ	Hepato
ܛܚܠܐ	Lieno
ܟܘܠܝܬܐ	Reno
ܫܠܦܘܚܬܐ	Urina veziko
ܐܫܟܐ	Testiko
ܐܘܩܝܢܘܣ	Oceano
ܒܘܕܗܐ	Sidarto Gotamo
ܡܘܚܡܕ	Mohamedo
ܟܪܣܐ	Ventro
ܚܒܠܐ ܟܘܒܝܐ	Mjelo
ܘܪܝܕܐ	Vejno
ܡܪܒܥܐ	Utero
ܠܫܢܐ (ܗܕܡܐ)	Lango (anatomio)
ܓܝܕܐ	Nervo
ܨܘܪܐ (ܝܘܠܦܢ ܨܪܘܝܘܬܐ)	Kolo
ܦܘܡܐ	Buŝo
ܓܓܪܬܐ	Laringo
ܡܥܝܐ	Intesto
ܫܪܝܬܐ	Artiko
ܚܕܝܐ	Brusto
ܬܝܪܬܐ	Glando
ܚܠܒܐ (ܝܘܠܦܢ ܨܪܘܝܘܬܐ)	Toraka diafragmo
ܫܪܝܢܐ	Arterio
A	A
B	B
ܢܘܛܦܬܐ	Ejakulaĵo
G	G
U	U
Z	Z
F	F
J	J
ܐܠܦܒܝܬ	Alfabeto
T	T
C	C
R	R
D	D
Α	Alfo
Ω	Omego
I	I
Μ	Muo (litero)
E	E
H	H
ܗܐܪܠܡ (ܗܘܠܢܕܐ)	Haarlemo
K	K
L	L
M	M
N	N
O	O
Q	Q
S	S
V	V
W	W
X	X
Y	Y
ܐܢܫܟܕܐ	Enschede
ܗܢܓܠܘ	Hengelo
Φ	Fio (litero)
ܝܘܢܐ	Kolombedoj
ܐܝܠܢܐ	Arbo
Λ	Lambdo
ܓܒܬܐ	Fromaĝo
ܥܢܒܬܐ	Vinbero
ܕܒܫܐ	Mielo
ܒܣܪܐ	Viando
ܫܟܪ	Sukero
ܣܦܪܙܒܢܐ	Gazeto
ܙܥܘܩܐ	Telefono
ܡܪܕܘܬܐ	Kulturo
ܡܥܝܐ ܥܒܝܐ	Dika intesto
ܡܥܝܐ ܩܛܝܢܐ	Maldika intesto
ܣܘܪܓܕܐ ܝܘܠܝܝܐ	Julia kalendaro
ܐܣܝܘܬܐ	Medicino
ܡܠܚܐ (ܐܨܪܐ)	Salo
ܣܕܪܐ:ܒܪܐܙܝܠ	Kategorio:Brazilo
ܙܘܝܬܐ (ܡܚܪܘܬܐ)	Angulo
ܬܘܩܦܐ	Energio
ܣܦܝܢܬܐ	Ŝipo
ܩܠܐ (ܨܘܬܐ)	Sono
ܙܓܘܓܝܬܐ	Vitro
ܫܛܝܚܘܬܐ	Areo
ܡܢܝܢܐ	Nombro
ܪܦܦܐ	Sekundo
ܣܥܪܬܐ	Ordinara hordeo
ܘܘܗܐܢ	Vuhano
ܡܟܬܒܢܘܬܐ ܕܐܬܪܘܬܐ	Listo de sendependaj ŝtatoj
ܒܝܬ ܢܗܪܝܢ	Mezopotamio
ܕܒܐ	Urso
ܬܠܗܝܐ	Kancero
ܡܠܟܐ	Reĝo
ܚܛܬܐ	Tritiko
ܣܘܪܓܕܐ	Kalendaro
ܟܘܪܗܢܐ	Malsano
ܣܘܪܓܕܐ ܓܪܝܓܘܪܝܐ	Gregoria kalendaro
ܟܦܣܐ	Menstruo
ܥܡܐ ܩܪܕܘܝܐ	Kurdoj
ܓܫܪܐ	Ponto
ܡܓܕܠܐ (ܒܢܝܢܐ)	Turo
ܐܡܪܝܩܐ ܠܐܛܝܢܝܬܐ	Latin-Ameriko
ܟܗܪܒܐ	Elektro
ܡܙܝܥܢܐ ܕܩܝܕܐ ܓܘܝܐ	Eksplodmotoro
ܣܝܦܐ (ܙܝܢܐ)	Glavo
ܫܡܥܘܢ ܩܢܢܝܐ	Simono Zeloto
ܩܪܩܦܬܐ	Kranio
ܓܘܡܠܐ!	Joomla!
ܐܦܫܬܐ	Sekvinbero
ܠܫܢܐ ܥܪܒܝܐ	Araba lingvo
ܠܫܢܐ ܐܦܪܝܩܐܢܝܐ	Afrikansa lingvo
Β	Beto (litero)
Γ	Gamo (litero)
Δ	Delto (litero)
Ε	Epsilono
Ζ	Zeto
Η	Eto (litero)
Θ	Teto
Ι	Joto
Κ	Kapo (litero)
Ν	Nuo (litero)
Ξ	Ksio
Ο	Omikrono
Ρ	Roto (litero)
Σ	Sigmo
Τ	Taŭo (litero)
Υ	Upsilono
Χ	Ĥio (litero)
Ψ	Psio (litero)
ܐܬܐ	Flago
ܟܪܦܬܐ	Meblo
ܟܘܪܣܝܐ	Seĝo
ܣܦܬܐ	Lipo
ܦܣܡܐ	Lipharoj
ܥܩܠܐ	Piedo
1000000000 (ܡܢܝܢܐ)	Miliardo
ܓܪܡܐ ܕܨܕܥܐ	Temporalo
ܩܠܝܕܐ (ܓܪܡܐ)	Klaviklo
ܟܬܦܐ	Ŝultro
ܦܟܐ ܬܚܬܝܐ	Mandiblo
ܩܠܒܐ:Link FA	Ŝablono:LigoElstara
ܥܠܡܐ (ܐܪܥܐ)	Mondo
ܘܝܩܝܦܕܝܐ:ܬܪܥܐ ܕܟܢܫܐ	Vikipedio:Diskutejo
ܒܝܪܡܘܢܬ	Vermonto
ܩܘܣܛܢܛܝܢܘܦܘܠܝܣ	Konstantinopolo
ܒܝܬ ܟܪܝܗܐ	Malsanulejo
ܥܕܬܐ	Kirko
ܕܝܬܝܩܝ ܚܕܬܐ	Nova testamento
9 (ܡܢܝܢܐ)	9 (nombro)
1002	1002
ܦܘܕܘܠܣܟ	Podolsk
ܦܐܦܐ	Papo
5	5
4	4
ܢܝܒܐ	Kanino
3	3
2	2
ܒܝܬ ܥܬܩܐ ܕܠܘܒܪ	Luvro
ܓܒܐ ܕܚܐܪܘܬܐ ܕܦܘܐܪܛܘ ܪܝܩܘ	Partio de la Sendependeco de Porto-Riko
6	6
ܕܝܬܝܩܝ ܥܬܝܩܬܐ	Malnova testamento
ܥܐܕܐ ܕܒܝܬ ܝܠܕܐ	Kristnasko
ܠܫܢܐ ܪܘܡܐܢܣܝܐ	Latinida lingvaro
ܡܬܠܬܐ	Triangulo
ܫܢܬܐ ܟܒܝܫܬܐ	Superjaro
ܡܘܥܡܪ ܐܠܩܕܐܦܝ	Muamar Kadafi
ܥܐܕܐ ܕܩܝܡܬܐ	Pasko
ܢܝܘ ܝܘܪܩ	New York
ܢܦܛܐ	Nafto
ܣܐܘܢܐ	Ŝuo
ܒܝܬ ܥܘܪܦܢܐ	Banko
ܟܪܡܐ	Vitejo
ܐܝܪܠܢܕ (ܓܙܪܬܐ)	Irlando (insulo)
1	1
ܠܘ ܫܘܢ	Lu Xun
10	10
20	20
9	9
7	7
8	8
7 (ܡܢܝܢܐ)	7 (nombro)
8 (ܡܢܝܢܐ)	8 (nombro)
12	12
ܡܠܐܐ ܘܬܘܒܐ	Tajdo
ܫܒܘܥܐ	Semajno
ܓܠܝܕܐ	Glacio
ܨܠܘܬܐ ܡܪܢܝܬܐ	Patro nia
ܝܡܬܐ	Lago
ܝܡܐ ܣܘܡܩܐ	Ruĝa Maro
13	13
ܩܛܘܬܐ (ܝܥܝܬܐ)	Kukumo
ܓܙܪܬܐ	Insulo
ܚܘܪܐ	Blanko
ܐܘܟܡܐ	Nigro
6 (ܡܢܝܢܐ)	6 (nombro)
ܠܫܢܐ ܪܘܫܡܝܐ	Oficiala lingvo
11	11
15	15
14	14
17	17
ܣܦܪ ܡܠܐ	Vortaro
18	18
19	19
16	16
21	21
ܦܠܣܛܝܢ	Palestino
10 (ܡܢܝܢܐ)	10 (nombro)
ܡܣܘܪܩܐ (ܡܐܢܐ)	Kombilo
ܠܝܠܐ ܕܘܢܤ	Lila Downs
ܝܡܐ ܕܡܠܚܐ	Morta Maro
ܫܘܚܠܦܐ ܕܫܢܬܐ	Sezono
ܠܝܒܪܦܘܠ	Liverpool
ܩܘܦܬܐ (ܛܝܪܐ)	Strigoformaj birdoj
ܫܥܬܐ	Horo
ܢܐܘܝ ܕܘܪ ܟܪܘܠܣܟܝ	Nowy Dwór Królewski
ܐܪܙܦܬܐ	Martelo
ܝܘܢܫܘܦܝܢ	Jönköping
ܥܘܠܐ ܚܝܐ	Feto
ܐܠܦܒܝܬ ܣܘܪܝܝܐ	Siria alfabeto
ܐܠܦܒܝܬ ܐܪܡܝܐ	Aramea skribo
ܐܣܝܐ ܡܥܪܒܝܬܐ	Okcidenta Azio
ܙܡܪܐ	Kantado
ܫܓܠܐ	Marelo
ܩܠܦܬܐ ܕܒܣܡܐ	Cinamo
ܡܙܬܐ	Haro
ܠܫܢܐ ܐܪܡܝܐ	Aramea lingvo
ܨܦܪܐ (ܛܝܪܐ)	Paseredoj
ܐܦܣܩܘܦܐ	Episkopo
ܨܝܢ (ܐܪܥܐ)	Ĉinio
ܓܒܐ ܕܝܡܘܩܪܛܝܐ (ܐܘܚܕܢܐ ܡܚܝܕܐ)	Demokrata Partio (Usono)
ܒܝܐܛܪܝܟܣ ܕܒܝܬ ܗܘܠܢܕܝܐ	Beatrikso (Nederlando)
ܡܠܟܘܬܐ ܕܗܘܠܢܕܐ	Reĝlando de Nederlando
ܐܒܪܝܠ ܠܐܒܝܢ	Avril Lavigne
ܪܝܫ ܩܘܛܢܝܘܬܐ	Prezidanto
ܐܪܒܝܐ	Arabio
ܡܪܩܘܣ ܐܘܢܓܠܣܛܐ	Sankta Marko la evangeliisto
ܥܘܠܐ	Embrio
ܠܫܢܐ ܕܗܟܐ	Hakaa lingvo
ܫܘܫܡܢܝܬܐ (ܝܥܝܬܐ)	Kardamomo
ܠܫܢܐ ܕܓܐܢ	Gana lingvo
ܒܝܬ ܥܬܩܐ	Muzeo
ܐܠܦܒܝܬ ܥܒܪܝܐ	Hebrea alfabeto
ܠܫܢܐ ܣܘܪܝܝܐ	Siria lingvo
ܒܪܩܐ	Fulmo
ܐܝܕܐ	Mano
ܫܡܥܘܢ ܟܐܦܐ	Sankta Petro
ܬܠ ܐܒܝܒ	Tel-Avivo
ܒܐܠܦܐܪܐܝܣܘ	Valparaiso
ܠܫܢܐ ܫܝܡܝܐ	Semida lingvaro
ܚܘܣܢܝ ܡܘܒܐܪܟ	Hosni Mubarak
ܘܐܟܐܩܐ	Oaxaca
ܚܐܘܬܐ	Butero
ܐܘܢܓܠܝܘܢ	Evangelio
ܠܫܢܐ ܕܘܘ	Vua lingvo
ܪܘܛܪܕܐܡ	Roterdamo
ܩܪܛܐ	Kreto (insulo)
ܐܘܪܚܐ	Vojo
ܩܘܪܨܐ ܚܠܝܨܐ	Kompakta disko
ܨܒܥܐ	Fingro
ܦܪܬ	Eŭfrato
ܩܝܘܛܘ	Kioto
ܥܣܪܐ ܦܘܩܕܢܐ	La Dekalogo
ܒܪܩܩܐ ܦܪܣܝܐ	Persa Golfo
ܚܠܐ (ܕܚܝܚܐ)	Sablo
ܘܪܕܐ	Rozo
ܓܙܪܬܐ ܝܒܫܢܝܬܐ	Duoninsulo
ܐܘܪܝܬܐ	Leĝo de Moseo
ܟܘܘܝܬ (ܡܕܝܢܬܐ)	Kuvajturbo
ܡܚܙܝܬܐ	Spegulo
ܥܡܐ ܥܪܒܝܐ	Araboj
ܟܘܬܐ	Fenestro
ܠܫܢܐ ܝܘܢܝܐ ܥܬܝܩܐ	Antikva greka lingvo
ܠܫܢܐ ܐܟܕܝܐ	Akada lingvo
ܕܩܠܬ	Tigriso
ܐܬܪܘܬܐ ܕܐܬܪܘܬܐ ܡܚܝܕܐ ܕܐܡܪܝܩܐ	Usona ŝtato
ܡܥܡܘܕܝܬܐ	Bapto
ܩܘܢܓܘ	Kongo
ܐܝܢܛܪܠܝܢܓܘܐ	Interlingvao
ܐܘܪܟܐ	Longo
ܚܠܡܐ	Sonĝo
ܠܫܢܐ ܩܪܕܘܝܐ	Kurda lingvo
ܩܡܚܐ	Faruno
ܕܢ ܗܐܟ	Hago
ܠܫܢܐ ܦܘܢܝܩܝܐ	Fenica lingvo
ܣܝܢܝ (ܓܙܪܬܐ ܝܒܫܢܝܬܐ)	Sinajo
ܟܪܘܙܘܬܐ ܕܝܘܚܢܢ	Evangelio laŭ Johano
ܬܪܥܐ (ܒܒܐ)	Pordo
ܪܝܗܐܢܐ	Rihanna
ܛܦܪܐ	Ungo
ܐܦܐ	Vizaĝo
ܨܨܐ (ܨܢܥܬܐ)	Najlo
ܙܝܬܐ	Olivarbo
ܬܠܝܬܝܘܬܐ	Sankta Triunuo
ܓܠܠܐ	Ondo
ܟܬܒܬܐ	Skribo
ܪܘܚܐ ܕܩܘܕܫܐ	Sankta Spirito
100 (ܡܢܝܢܐ)	100 (nombro)
ܒܘܪܟܐ	Genuo
ܫܘܩܐ (ܬܐܓܪܘܬܐ)	Merkato
ܒܠܛܝ	Bălți
1000000 (ܡܢܝܢܐ)	Miliono
ܐܫܬܐ (ܐܣܝܘܬܐ)	Febro
ܩܫܬܐ ܓܪܒܝܝܬܐ ܕܐܪܥܐ	Norda duonglobo
ܡܡܘܢܐ ܕܡܝܟܪܐ	Mikroekonomiko
ܠܝܕܣ	Leeds
ܥܘܩܒܪܐ	Muso (besto)
ܦܘܪܬܩܠܐ	Oranĝkolora
ܒܪܩܩܐ	Golfo
ܒܝܬ ܩܒܘܪܐ	Tombejo
ܐܣܝܐ (ܫܕܬܐ)	Kuracisto
ܡܩܕܘܢܝܐ	Makedonio
ܦܢܛܝܩܘܣܛܝ	Pentekosto
ܫܓܕܬܐ	Migdalujo
ܟܪܘܙܘܬܐ ܕܠܘܩܐ	Evangelio laŭ Luko
ܩܘܢܣܦܣܝܘܢ (ܗܘܦܪܟܝܐ)	Koncepciono (provinco)
ܢܗܪܐ ܕܝܘܪܕܢܢ	Jordano
ܣܦܪ ܝܡܐ	Strando
ܐܢܛܐܠܝܐ (ܗܘܦܪܟܝܐ)	Provinco Antalya
ܦܪܟܣܝܣ ܕܫܠܝܚܐ	Agoj de la Apostoloj
ܥܪܘܒܬܐ ܕܚܫܐ	Granda vendredo
ܚܒܘܫܝܐ	Malliberejo
ܐܕܢܐ (ܗܘܦܪܟܝܐ)	Provinco Adana
ܝܘܚܢܢ ܡܥܡܕܢܐ	Johano la Baptisto
ܚܙܒܐܠܠܗ	Hizbulaho
ܒܝܬ ܓܒܝܢܐ	Frunto
ܡܙܡܘܪܐ	Psalmo
ܐܬܘܪ	Asirio
ܒܢܝܢܐ	Konstruaĵo
ܚܠܒ (ܡܕܝܢܬܐ)	Alepo
ܩܫܬܐ ܬܝܡܢܝܬܐ ܕܐܪܥܐ	Suda duonglobo
ܚܠܐ (ܚܡܪܐ)	Vinagro
ܒܝܬ ܕܝܢܐ	Tribunalo (juro)
ܚܝܦܐ	Ĥajfo
ܪܡܕܐܢ	Ramadano
ܫܛܪܐ ܬܐܒܝܠܝܐ ܕܓܝܢܝܣ	Guinness-libro de rekordoj
ܟܘܕܢܝܐ	Mulo
ܒܪܩܩܐ ܕܥܕܢ	Adena Golfo
ܓܠܝܢܐ ܕܝܘܚܢܢ	Apokalipso de Johano
ܐܫܬܐ (ܝܘܠܦܢ ܨܪܘܝܘܬܐ)	Pugo
ܨܠܘܬܐ ܡܪܝܡܝܬܐ	Ave Maria
ܝܩܕܐ	Brulaĵo
ܝܨܝܠܐ	Kubuto
ܟܗܢܐ	Pastro
ܕܩܢܐ	Barbo
ܢܒܝܐ	Profeto
ܐܘܪܟܝܣܛܪܐ	Orkestro
1000 (ܡܢܝܢܐ)	1000 (nombro)
ܣܘܦܝܐ ܪܘܛܐܪܘ	Sofia Rotaru
ܬܫܢܝܬܐ	Asekuro
ܛܘܟܣܐ	Organizaĵo
ܣܦܪܓܠܐ	Cidonio
ܐܢܕܪܐܘܣ ܫܠܝܚܐ	Sankta Andreo
ܬܪܥܣܪ ܫܠܝܚܐ	Apostolo
ܢܩܒܬܐ	Ina sekso
ܕܪܥܐ (ܗܕܡܐ)	Brako
ܡܬܝ ܡܟܣܐ	Sankta Mateo
ܬܐܘܡܐ ܫܠܝܚܐ	Sankta Tomaso
ܦܝܠܝܦܘܣ ܫܠܝܚܐ	Sankta Filipo (Apostolo)
ܒܘܪܨܐ (ܗܘܦܪܟܝܐ)	Provinco Bursa
ܐܝܘܐܢܢܝܣ ܦܘܡܐ ܕܕܗܒܐ	Johano Krizostomo
ܒܢܝܡܝܢ ܢܬܢܝܗܘ	Benjamin Netanjahu
ܐܪܬܒܝܢ (ܗܘܦܪܟܝܐ)	Provinco Artvin
ܓܒܝܢܐ	Brovo
ܫܘܪܬܐ	Umbiliko
ܐܕܝܐܡܐܢ (ܗܘܦܪܟܝܐ)	Provinco Adıyaman
ܝܗܘܕܐ ܫܠܝܚܐ	Judaso Tadeo
ܒܪܬܘܠܡܝ ܫܠܝܚܐ	Apostolo Bartolomeo
ܝܥܩܘܒ ܒܪ ܙܒܕܝ	Jakobo la pli aĝa
ܡܬܝܐ ܫܠܝܚܐ	Sankta Matiaso
ܝܥܩܘܒ ܒܪ ܚܠܦܝ	Jakobo la pli juna
ܕܟܪܐ	Vira sekso
ܐܝܓܢܐܛܝܘܣ ܢܘܪܢܐ	Ignaco el Antioĥio
ܪܕܝܘܗܕ	Radiohead
ܒܫܐܪ ܐܠܐܣܕ	Baŝar al-Asad
ܪܚܝܐ	Muelejo
ܨܘܡܐ	Fasto
ܕܝܪܐ	Monaĥejo
ܠܡܐܢܐ	Haveno
ܡܠܚܐ (ܢܘܛܐ)	Maristo
ܐܦܝܘܢ (ܗܘܦܪܟܝܐ)	Provinco Afyonkarahisar
ܡܝܟܐܝܠ (ܡܠܐܟܐ)	Ĉefanĝelo Miĥaelo
ܒܝܠܓܝܟ (ܗܘܦܪܟܝܐ)	Provinco Bilecik
ܒܝܬ ܥܬܩܐ ܕܐܣܪܐܝܠ	Muzeo de Israelo
ܒܐܠܝܟܣܝܪ (ܗܘܦܪܟܝܐ)	Provinco Balıkesir
ܒܝܬ ܝܠܕܐ	Naskiĝtago
ܬܘܠܥܐ	Vermo
ܬܘܩܢ ܓܝܕܝܐ ܩܢܛܪܘܢܝܐ	Centra nerva sistemo
ܛܘܪܐ ܕܓܠܝܕܐ	Glacimonto
ܡܫܠܡܢܐ	Islamano
ܢܢܥܐ	Mento
ܩܠܒܐ:Commonscat	Ŝablono:Commonscat
ܒܨܪܐ (ܡܕܝܢܬܐ)	Basra
ܐܓܪܬܐ ܕܠܘܬ ܪܗܘܡܝܐ	Epistolo al la romanoj
ܬܡܪܐ ܕܥܝܢܐ	Palpebro
ܗܘܦܪܟܝܣ ܕܛܘܪܩܝܐ	Provincoj de Turkio
ܡܪܝ ܓܝܘܪܓܝܣ ܣܗܕܐ	Sankta Georgo
ܐܣܘܬܐ ܕܠܐ ܬܚܘܡܐ	Kuracistoj sen landlimoj
ܐܪܙܐ (ܡܫܝܚܝܘܬܐ)	Sakramento
ܐܓܪܬܐ ܕܠܘܬ ܦܝܠܝܦܣܝܐ	Epistolo al la filipianoj
ܐܢܛܘܠܝܐ	Anatolio
ܡܫܝܚܐ	Mesio
ܚܫܡܝܬܐ ܐܚܪܝܬܐ	Lasta Vespermanĝo
ܩܢܘܢܐ ܕܗܝܡܢܘܬܐ	Symbolum Apostolorum
ܒܢܝ ܐܝܣܪܐܝܠ	Izraelidoj
ܡܓܘܫܐ ܬܠܬܐ	Tri reĝoj
ܝܘܚܢܢ ܕܪܡܣܘܩܝܐ	Johano de Damasko
ܣܕܪܐ:ܡܠܟܐ	Kategorio:Reĝoj
ܣܕܪܐ:ܪܘܟܒ ܫܘܠܛܢܘܬܐ	Kategorio:Reĝimoj
ܥܘܪܡܫܐ	Poluo
ܒܒܠ (ܗܘܦܪܟܝܐ)	Gubernio Babil
ܫܘܡܪܐ	Fulgo
ܐܫܩܠܘܢ	Aŝkelon
ܕܘܢܒܐ	Vosto
ܩܐܕܣܝܐ (ܗܘܦܪܟܝܐ)	Gubernio Kadisija
ܡܪܝܡ ܡܓܕܠܝܬܐ	Maria Magdala
ܡܪܪܬܐ	Gala veziko
ܥܕܬܐ ܟܠܕܝܬܐ ܩܬܘܠܝܩܝܬܐ	Ĥaldea katolika Eklezio
ܥܕܬܐ ܡܪܘܢܝܬܐ	Maronita eklezio
ܡܪܬܐ	Galo
ܩܘܪܒܢܐ	Komunio
ܐܕܡ	Adamo (Biblio)
ܕܡܥܬܐ	Larmo
ܟܘܬܝܢܐ	Ĉemizo
ܝܘܗܐܢ ܐܠܙܪ	Georg Elser
ܒܝܢܓܘܠ (ܗܘܦܪܟܝܐ)	Provinco Bingöl
ܥܡܐ ܐܪܡܢܝܐ	Armenoj
ܐܝܕܝܢ (ܗܘܦܪܟܝܐ)	Provinco Aydın
ܩܛܠܥܡܐ ܐܪܡܢܝܐ	Armena genocido
ܐܡܐܣܝܐ (ܗܘܦܪܟܝܐ)	Provinco Amasya
ܦܪܝܙܘܢ ܒܪܝܟ	Prison Break
ܐܓܪܝ (ܗܘܦܪܟܝܐ)	Provinco Ağrı
ܒܘܪܕܘܪ (ܗܘܦܪܟܝܐ)	Provinco Burdur
ܐܓܪܬܐ ܩܕܡܝܬܐ ܕܠܘܬ ܩܘܪܢܬܝܐ	1-a epistolo al la korintanoj
ܝܗܘܕܐ ܣܟܪܝܘܛܐ	Judaso Iskarioto
ܐܒܪܐ	Plumo
ܡܚܪܐ	Inĝeniero
ܚܪܛܘܡܢܐ	Kikero
ܐܬܪܘܬܐ ܕܫܐܡ	Levantenio
ܬܪܘܕܐ	Kulero
ܓܒܪܐܝܠ (ܡܠܐܟܐ)	Ĉefanĝelo Gabrielo
ܓܪܡܦܝܠܐ	Eburo
ܨܘܪ	Tiro (urbo)
ܒܘܠܘ (ܗܘܦܪܟܝܐ)	Provinco Bolu
ܙܢܩܐ	Mentono
ܨܘܡܐ ܕܐܪܒܥܝܢ	Karesmo
ܐܓܪܐ ܕܒܢܝܢܐ	Tegmento
ܒܝܛܠܝܣ (ܗܘܦܪܟܝܐ)	Provinco Bitlis
ܓܠܝܠܐ	Galileo (regiono)
ܪܥܡܐ	Tondro
ܡܘܨܠ	Mosulo
ܟܪܬܐ	Dikfingro
ܥܡܐ ܛܘܪܩܝܐ	Turkoj
ܦܐܦܐ ܫܢܘܕܐ ܬܠܝܬܝܐ	Ŝenudo la 3-a
ܒܝܬ ܓܘܣܐ	Bunkro
ܒܝܥܬܐ	Kokina ovo
ܒܣܕܝܐ	Kuseno
ܙܓܐ (ܢܩܘܫܐ)	Sonorilo
ܫܒܬܐ (ܝܗܘܕܝܘܬܐ)	Ŝabato
ܫܡܝܪܡ	Semiramiso
ܫܝܓܪܐ	Gingivo
ܝܗ	Biblia Tetragramo
ܡܫܝܚܝܐ	Kristano
ܟܪܘܙܘܬܐ ܕܡܪܩܘܣ	Evangelio laŭ Marko
ܐܓܪܬܐ ܕܠܘܬ ܩܘܪܢܬܝܐ ܕܬܪܬܝܢ	2-a epistolo al la korintanoj
ܫܥܘܬܐ (ܡܠܘܐܐ)	Vakso
ܛܥܡܐ	Gusto
ܓܢܬ ܫܒܪܐ	Infanĝardeno
ܝܡܬܐ ܕܓܠܝܠܐ	Maro Kineret
ܕܝܘܬܐ	Inko
ܡܪܝ ܝܘܣܦ	Sankta Jozefo
ܠܘܩܐ ܐܘܢܓܠܣܛܐ	Sankta Luko
ܐܓܪܬܐ ܕܠܘܬ ܥܒܪܝܐ	Epistolo al la hebreoj
ܐܓܪܬܐ ܕܠܘܬ ܓܠܛܝܐ	Epistolo al la galatoj
Ϝ	Digamo
Ϙ	Kuoppo
ܥܛܡܐ	Femuro
ܬܢܢܐ	Fumo
ܡܘܚܘܢܐ	Cerbeto
ܐܓܪܬܐ ܕܠܘܬ ܩܘܠܣܝܐ	Epistolo al la koloseanoj
ܐܓܪܬܐ ܕܝܥܩܘܒ	Epistolo de Jakobo
ܐܓܪܬܐ ܩܕܡܝܬܐ ܕܝܘܚܢܢ	1-a epistolo de Johano
ܐܓܪܬܐ ܕܠܘܬ ܦܝܠܡܘܢ	Epistolo al Filemono
ܐܓܪܬܐ ܕܠܘܬ ܬܣܠܘܢܝܩܝܐ ܕܬܪܬܝܢ	2-a epistolo al la tesalonikanoj
ܐܓܪܬܐ ܩܕܡܝܬܐ ܕܠܘܬ ܬܣܠܘܢܝܩܝܐ	1-a epistolo al la tesalonikanoj
ܐܓܪܬܐ ܩܕܡܝܬܐ ܕܦܛܪܘܣ	1-a epistolo de Petro
ܐܓܪܬܐ ܕܬܪܬܝܢ ܕܦܛܪܘܣ	2-a epistolo de Petro
ܐܓܪܬܐ ܩܕܡܝܬܐ ܕܠܘܬ ܛܝܡܬܐܘܣ	1-a epistolo al Timoteo
Ϛ	Stigmo (litero)
ܡܪܕܝܢ (ܗܘܦܪܟܝܐ)	Provinco Mardin
ܚܡܨ (ܡܕܝܢܬܐ)	Homs
Ͳ	Sampio
ܐܓܪܬܐ ܕܬܪܬܝܢ ܕܝܘܚܢܢ	2-a epistolo de Johano
ܐܓܪܬܐ ܕܬܠܬ ܕܝܘܚܢܢ	3-a epistolo de Johano
ܐܓܪܬܐ ܕܝܗܘܕܐ	Epistolo de Judaso
ܐܓܪܬܐ ܕܠܘܬ ܛܝܡܬܐܘܣ ܕܬܪܬܝܢ	2-a epistolo al Timoteo
ܐܓܪܬܐ ܕܠܘܬ ܛܛܘܣ	Epistolo al Tito
ܫܝܪܢܐܟ (ܡܕܝܢܬܐ)	Şırnak
ܐܟܪܐ	Terkultivisto
ܓܘܣܢܐ	Rifuĝinto
Ϻ	Sano (litero)
ܩܠܝܕܐ (ܡܐܢܐ)	Ŝlosilo
ܥܕܥܐܕܐ	Festivalo
ܐܪܒܝܠ (ܡܕܝܢܬܐ)	Arbil
ܪܓܠܐ	Kruro
ܚܨܐ	Dorso
ܐܠܝܐ ܢܒܝܐ	Elija
ܙܚܘܪܝܬܐ (ܬܘܠܥܬܐ)	Silkraŭpo
ܚܘܦܝܐ	Eklipso
ܡܚܛܐ	Kudrilo
ܥܠܡܐ ܥܪܒܝܐ	Araba mondo
ܩܛܡܐ	Cindro
ܢܘܗܕܪܐ (ܡܕܝܢܬܐ)	Dihok
ܨܒܥܐ ܕܪܓܠܐ	Piedfingro
ܢܓܪܘܬܐ	Ĉarpentisto
ܠܘܚܐ (ܚܫܘܒܬܐ)	Tabulkomputilo
ܪܒܝܬܐ	Uzuro
ܡܟܝܪܘܬܐ	Fianĉiĝo
ܫܘܪܡܐ	Rektumo
ܐܪܡܝܐ (ܢܒܝܐ)	Jeremia (profeto)
ܬܐܡܐ	Ĝemelo
ܫܥܬܐ ܕܐܪܥܐ	Horo por la Tero
ܦܪܡܝܬܐ	Butono
ܟܘܟܒܐ ܕܕܘܝܕ	Stelo de Davido
ܡܪܝ ܐܣܛܦܢܘܣ	Sankta Stefano
ܡܫܡܫܢܐ	Diakono
ܢܓܒ	Negevo
ܟܢܥܢ	Kanaano
ܢܘܨܦܐ	Krepusko
ܒܝܢܐ	Tamariko
ܬܓܪܝܬ	Tikrit
ܬܪܥܐ ܕܕܡܐ	Hemoragio
ܥܪܒܐ ܕܫܡܫܐ	Sunsubiro
ܡܨܥܝܬܐ (ܨܒܥܐ)	Mezfingro
ܩܘܪܨܠܐ	Maleolo
ܒܪ ܐܝܕܐ	Ganto
ܢܫܒܐ ܕܥܝܢܐ	Retino
ܬܘܩܢ ܓܝܕܝܐ ܡܚܕܘܪܝܐ	Periferia nerva sistemo
ܛܝܢܐ	Ŝlimo
ܓܓܘܠܬܐ	Golgoto
ܗܢܝܢܐ (ܡܡܫܚܘܬܐ)	Interezo
ܐܫܘܪ ܒܢܐܦܠ	Asurbanipal
ܓܕܫܐ	Akcidento
ܦܛܪܝܪܟܐ	Patriarko
ܚܟܐ	Palato
ܪܓܫܐ	Senso
ܟܪܟ ܣܠܘܟ (ܡܕܝܢܬܐ)	Kirkuk
ܒܒܬܐ	Pupilo
ܩܒܪܐ	Tombo
ܠܒܘܢܬܐ	Olibano
ܚܡܬ (ܡܕܝܢܬܐ)	Hamao
ܝܫܛܐ	Ezofago
ܟܝܣܐ ܕܐܫܟܐ	Skroto
ܕܒܪܐ	Ruro
ܚܪܘܫܬܐ	Traĥeo
ܓܪܡܐ ܕܥܛܡܐ	Femurosto
ܒܪܐ (ܒܝܬܝܘܬܐ)	Filo
ܫܚܘܪܐ	Lignokarbo
ܐܘܟܡܐ ܕܥܝܢܐ	Iriso
ܫܦܠܘܗܝ ܕܢܝܠܘܣ	Nildelto
ܐܘܪܡܝܐ	Urmia
Ϸ	Ŝo (litero)
ܓܙܪܬܐ ܐܝܘܠܝܬܐ	Liparaj insuloj
ܓܒܐ ܕܒܥܬ	Baazo
ܦܩܪܐ	Vertebro
ܒܪ ܩܠܐ	Eĥo
ܟܝܡܪܐ	Ĥimero
ܠܘܓܡܐ	Maksilo
ܛܪܘܢܐ	Diktatoro
ܬܝܒܘܬܐ	Konfeso
ܡܛܘܚܬܐ	Montrofingro
ܩܒܠܘܬܐ	Akuŝistino
ܐܪܙܝܪܐ	Sturnedoj
ܣܦܪܐ (ܩܢܘܢܝܐ)	Juristo
Ͱ	Heto
ܥܡܐ ܐܪܡܝܐ	Arameoj
ܟܢܘܢܬܐ (ܫܪܝܬܐ)	Pojno
ܐܒܐ (ܐܠܗܐ)	Dio Patro
ܐܢܒܐܪ (ܗܘܦܪܟܝܐ)	Gubernio Anbar
ܡܪܕܝܢ (ܡܕܝܢܬܐ)	Mardin
ܣܪܛܢܐ	Kancero (apartigilo)
ܡܘܪܘܢ	Konfirmacio
ܚܠܡܬܐ	Mampinto
ܢܘܠܐ ܕܓܘܓܝ	Aranereto
ܐܫܥܝܐ	Profeto Jesaja
ܒܝܬ ܟܬܒܐ ܐܬܪܝܐ ܕܐܣܪܐܝܠ	Nacia Librejo de Israelo
ܥܪܫܐ	Vangodento
ܢܝܢܘܐ (ܗܘܦܪܟܝܐ)	Gubernio Ninivo
ܢܘܗܕܪܐ (ܗܘܦܪܟܝܐ)	Gubernio Dahuk
ܘܐܣܛ (ܗܘܦܪܟܝܐ)	Gubernio Ŭasit
ܨܠܐܚ ܐܠܕܝܢ (ܗܘܦܪܟܝܐ)	Gubernio Saladino
ܟܢܘܫܝܐ ܕܠܫܢܐ ܥܒܪܝܐ	Akademio de la Hebrea Lingvo
ܥܘܕ	Al-Udo
ܒܓܕܐܕ (ܗܘܦܪܟܝܐ)	Gubernio Bagdado
ܣܪܓܐ	Selo
ܒܨܪܐ (ܨܒܥܐ)	Ringofingro
ܩܛܝܣܦܘܢ	Seleŭkio-Ktesifono
ܟܒܘܫܐ	Premsonĝo
ܢܓܦ (ܗܘܦܪܟܝܐ)	Gubernio Naĝaf
ܟܪܟ ܣܠܘܟ (ܗܘܦܪܟܝܐ)	Gubernio Kirkuk
ܕܢܚܐ ܕܫܡܫܐ	Sunleviĝo
ܬܐܪܬܐ	Morala konscienco
ܒܨܪܐ (ܗܘܦܪܟܝܐ)	Gubernio Basra
ܡܫܚܐ ܕܟܪܝܗܐ	Unkto
ܦܠܫܬ	Filiŝtoj
ܐܠܥܐ (ܝܘܠܦܢ ܨܪܘܝܘܬܐ)	Ripo
ܥܕܬܐ ܐܝܓܘܦܛܝܬܐ	Kopta Ortodoksa Eklezio de Aleksandrio
ܐܢܛܝܘܟܝܐ	Antioĥio
ܐܝܙܝܕܝܐ	Jezidoj
ܪܝܫܘܢ ܠܬܣܝܘܢ	Riŝon-Le-Ciono
ܟܢܪܐ	Liro (muzikilo)
ܥܕܬܐ ܕܡܕܢܚܐ ܕܐܬܘܪܝܐ	Asiria Eklezio de la Oriento
ܡܘܪܐ	Mirho
ܦܕܪܠܝܐ	Federismo
ܗܟܐܪܝ (ܡܕܝܢܬܐ)	Hakkâri
ܣܢܚܪܝܒ	Sanĥerib
ܩܘܪܝܐܠܝܣܘܢ	Kyrie
ܟܢܘܫܝܐ ܕܐܣܪܐܝܠ ܕܝܘܠܦܢܐ ܘܐܢܫܝܬܐ	Israela Akademio de Sciencoj kaj Beletroj
ܣܘܟܢܐ	Rudro
ܥܕܬܐ ܣܘܪܝܝܬܐ ܐܪܬܘܕܟܣܝܬܐ	Siria Ortodoksa Eklezio
ܟܣܬܐ	Furaĝo
ܩܡܫܠܝ	Al-Kamiŝli
ܡܘܬܢܐ (ܗܘܦܪܟܝܐ)	Gubernio Muthana
ܡܝܫܢ (ܗܘܦܪܟܝܐ)	Gubernio Majsan
ܣܘܠܝܡܐܢܝܐ (ܗܘܦܪܟܝܐ)	Gubernio Sulajmanija
ܐܪܒܝܠ (ܗܘܦܪܟܝܐ)	Gubernio Arbil
ܚܠܒ (ܗܘܦܪܟܝܐ)	Gubernio Alepo
ܟܪܒܠܐܐ (ܗܘܦܪܟܝܐ)	Gubernio Karbala
ܦܪܨܘܦܐ	Persono
ܕܝ ܩܐܪ (ܗܘܦܪܟܝܐ)	Gubernio Dhi Kar
ܐܢܕܪܢܝܩ ܡܐܪܓܐܪܝܐܢ	Andranik Markarjan
ܡܡܠܠܘܬ ܐܠܗܘܬܐ	Kristana teologio
ܕܝܐܠܐ (ܗܘܦܪܟܝܐ)	Gubernio Dijala
ܟܒܒ	Ĥabab
ܩܪܫܬܐ	Plafono (arkitekturo)
ܚܨܪܐ	Etfingro
ܚܡܬ (ܗܘܦܪܟܝܐ)	Gubernio Hama
ܟܢܘܢܬܐ ܕܐܝܕܐ	Karpeo
ܡܠܐܟܐ	Anĝelo
ܡܠܟܘܬܐ ܕܒܝܬ ܥܣܪ ܥܝܢܐ	Osroeno
ܕܪܥܐ (ܡܕܝܢܬܐ)	Daraa
ܨܕܥܐ	Tempio
ܣܘܣܝܐ ܐܝܣܠܢܕܝܐ	Islanda ĉevalo
ܩܠܐ	Muziknoto
ܛܘܘܝܐ	Kradrostaĵo
ܓܪܡܐ	Osto
ܒܪܝܐܢܝ	Birjano
ܠܒܠܒܬܐ	Uvulo
ܒܪܬܐ (ܒܝܬܝܘܬܐ)	Filino
ܚܣܟܗ (ܡܕܝܢܬܐ)	Al-Hasaka
ܛܐܪܩ ܥܙܝܙ	Tariq Aziz
ܡܣܘܪܩܐ ܕܪܓܠܐ	Metatarso
ܥܪܩ	Arako
ܫܠܦܐ	Klingo
ܛܘܪ ܠܒܢܢ	Lebanono (montaro)
ܐܘܛܪܝܟܛ	Utrecht (apartigilo)
ܪܗܘܡܐ	RUM
ܩܝܒܩ	Québec
ܥܡܐ ܐܬܘܪܝܐ/ܣܘܪܝܝܐ	Asirianoj
ܛܘܪܐ ܕܣܝܢܝ	Monto Sinajo
ܦܘܪܬܥܢܐ	Pulo
ܟܪܘܙܘܬܐ ܕܡܬܝ	Evangelio laŭ Mateo
ܐܓܪܬܐ ܕܠܘܬ ܐܦܣܝܐ	Epistolo al la efesanoj
ܒܢܦܫܐ	Viola
ܢܨܪܬ	Nazareto
ܟܬܒܐ ܕܡܘܪܡܘܢ	Libro de Mormon
ܥܡܘܕܐ ܦܩܪܝܐ	Vertebraro
ܒܝܬ ܫܥܝܐ	Stadiono
ܒܪ ܨܘܪܐ	Kolumo
ܚܣܚܘܣܐ	Kartilago
ܐܝܣܛܢܒܘܠ (ܗܘܦܪܟܝܐ)	Provinco İstanbul
ܝܘܢܝܐ	Grekoj
ܓܗܢܐ	Geheno
ܝܥܩܘܒ ܒܘܪܕܥܢܐ	Jakobo Baradai
ܬܐܓܘܪܬܐ	Komerco
ܡܬܐ	Hejmo (regiono)
ܫܝܪܢܐܟ (ܗܘܦܪܟܝܐ)	Provinco Şırnak
ܥܘܩܣܐ	Pikilo
ܟܗܢܘܬܐ	Ordino
ܚܒܘܪ	Ĥabur
ܗܕܡܐ ܓܘܝܐ	Organo
ܡܥܠܘܠܐ	Maalula
ܐܘܪܘܦܐ	Eŭropo (apartigilo)
ܥܕܬܐ ܣܘܪܝܝܬܐ ܩܬܘܠܝܩܝܬܐ	Siria katolika eklezio
ܡܦܩܬܐ ܦܫܝܛܬܐ	Peshitta
ܫܪܓܐ ܕܢܦܛܐ	Olelampo
ܚܘܐ	Eva
ܒܝܬ ܟܬܒܐ ܕܐܫܘܪ ܒܢܐܦܠ	Biblioteko de Aŝurbanipal
ܒܕܘܩܐ	Skoltismo
ܥܘܕܪܢܐ:ܚܒܝܫܬ̈ܐ	Helpo:Enhavo
ܓܦܬܐ	Rebo
ܐܣܛܘܡܟܐ	Stomako
ܟܢܘܢܬܐ ܕܪܓܠܐ	Tarso
ܓܢܬܐ	Ĝardeno
ܕܪܓܘܫܬܐ	Lulilo
ܚܝܠܐ ܠܒܢܝܐ	Libanaj Fortoj
ܘܝܩܝܦܕܝܐ:ܐܝܙܓܕܘܬܐ	Vikipedio:Ambasadorejo
ܫܠܝܬܐ	Placento
ܒܝܬ ܛܘܣܐ	Flughaveno
ܒܝܬ ܫܡܪܝܐ	Samario (geografio)
ܐܓܢܣ ܡܘ	Agnes Monica
ܣܕܪܐ:ܓܪܡܢ	Kategorio:Germanio
ܣܕܪܐ:ܐܝܛܠܝܐ	Kategorio:Italio
ܣܕܪܐ:ܐܬܪܘܬܐ ܡܚܝܕܐ ܕܐܡܪܝܩܐ	Kategorio:Usono
ܣܕܪܐ:ܪܘܣܝܐ	Kategorio:Rusio
ܣܕܪܐ:ܩܢܕܐ	Kategorio:Kanado
ܣܕܪܐ:ܐܝܣܪܐܝܠ	Kategorio:Israelo
ܣܕܪܐ:ܛܘܪܩܝܐ	Kategorio:Turkio
ܣܕܪܐ:ܡܨܪܝܢ	Kategorio:Egiptio
ܣܕܪܐ:ܐܝܪܐܢ	Kategorio:Irano
ܥܐܕܐ	Festaj kaj feriaj tagoj
ܣܕܪܐ:ܥܝܪܐܩ	Kategorio:Irako
ܣܕܪܐ:ܗܘܠܢܕܐ	Kategorio:Nederlando
ܣܕܪܐ:ܦܘܠܢܕ	Kategorio:Pollando
ܣܕܪܐ:ܛܝܪܐ	Kategorio:Birdoj
ܣܕܪܐ:ܝܥܝܬܐ	Kategorio:Plantoj
ܣܕܪܐ:ܬܘܕܝܬܐ	Kategorio:Religio
ܣܕܪܐ:ܝܕܥܬܐ	Kategorio:Scienco
ܨܘܒܐ	Nusaybin
ܕܪܥܐ (ܗܘܦܪܟܝܐ)	Gubernio Daraa
ܩܠܒܐ:Box-footer	Portalo:Box-footer
ܡܪܝܡ (ܚܬܗ ܕܡܘܫܐ)	Mirjam
ܣܕܪܐ:ܬܘܚܡܐ ܐܚܪܢܐ	Kategorio:Apartigiloj
ܣܕܪܐ:ܡܫܝܚܝܘܬܐ	Kategorio:Kristanismo
ܣܕܪܐ:ܐܣܠܐܡ	Kategorio:Islamo
ܣܕܪܐ:ܝܗܘܕܝܘܬܐ	Kategorio:Judismo
ܠܩܐ ܕܣܦܝܢܬܐ	Remilo
ܬܪܢܓܠܐ	Virkoko
ܙܚܘܪܝܬܐ (ܓܘܢܐ)	Skarlata (koloro)
ܐܢܩܪܐ (ܗܘܦܪܟܝܐ)	Provinco Ankara
ܐܝܪܠܢܕ	Irlando (apartigilo)
ܝܘܢܢ	Jona (profeto)
ܫܡܐ ܕܝܠܝܕܘܬܐ	Naskonomo
ܐܨܪܐ	Kondimento
ܫܘܫܡܬܐ	Hindia sezamo
ܣܕܪܐ:ܘܝܩܝܦܕܝܐ	Kategorio:Kategorioj
ܣܕܪܐ:ܝܒܫܬܐ	Kategorio:Kontinentoj
ܝܙܦܬܐ	Ŝuldo
ܦܨܝܕܐ	Lageto
ܢܘܪܢܝܐ	Piramido (geometrio)
ܘܝܩܝܦܕܝܐ:HotCat	Vikipedio:VarmaKato
ܒܛܐ	Anaso
ܗܝܟܠܐ ܕܫܠܝܡܘܢ	Templo de Jerusalemo
ܩܠܒܐ:ܓܕܫܐ ܗܫܝܐ	Ŝablono:ĈefPaĝoMondAktualaĵo
ܣܕܪܐ:ܡܟܬܒܢܘܬܐ ܕܐܬܪܘܬܐ	Kategorio:Landoj
ܘܝܩܝܦܕܝܐ:ܡܕܒܪܢܐ	Vikipedio:Administrantoj
ܣܕܪܐ:ܫܕܬܐ	Kategorio:Profesioj
ܘܝܩܝܦܕܝܐ:ܒܘܬ̈ܐ	Vikipedio:Roboto
ܣܕܪܐ:ܙܒܢܐ	Kategorio:Tempo
ܣܕܪܐ:ܙܘܙܐ	Kategorio:Mono
ܣܕܪܐ:ܝܘܠܦܢ ܨܪܘܝܘܬܐ	Kategorio:Anatomio
ܣܕܪܐ:ܐܣܝܘܬܐ	Kategorio:Medicino
ܡܨܪܝܢ	Egiptujo
ܩܠܒܐ:Bot	Ŝablono:Bot
ܩܢܕܐ	Kanado
ܣܕܪܐ:ܝܘܢ	Kategorio:Grekio
ܣܕܪܐ:ܣܘܝܕ	Kategorio:Svedio
ܩܠܒܐ:ܐܫܛܪܘܬܐ	Ŝablono:Dok
ܣܕܪܐ:User languages	Kategorio:Vikipediistoj laŭ lingvo
ܦܘܠܚܢܐ	Profitcela organizaĵo
ܩܠܒܐ:Softredirect	Ŝablono:Intervikia plusendilo
ܩܠܒܐ:Delete	Ŝablono:Forigu tuj
ܣܕܪܐ:ܛܟܢܘܠܘܓܝܐ	Kategorio:Teknologio
ܓܒܪܐܝܠ (ܫܡܐ)	Gabrielo
ܣܕܪܐ:ܠܫܢܐ	Kategorio:Lingvoj
ܣܕܪܐ:ܩܢܘܢܐ ܕܠܥܙܐ	Kategorio:Gramatiko
ܘܝܩܝܦܕܝܐ:General disclaimer	Vikipedio:Malgarantio
ܣܕܪܐ:Noindexed pages	Kategorio:Neindeksitaj paĝoj
ܘܝܩܝܦܕܝܐ:ܕܘܒܪܐ	Vikipedio:Stilogvido
ܩܠܒܐ:Navbox	Ŝablono:Navigilo2
ܩܠܒܐ:!	Ŝablono:!
ܣܕܪܐ:ܩܠܒܐ ܐܬܘܬܐ ܕܐܝܣܘ	Kategorio:Ŝablonoj landonomoj kun flageto
ܩܠܒܐ:ܡܦܐܬܐ ܩܠܒܐ	Ŝablono:Tnavbar
ܘܝܩܝܦܕܝܐ:ܡܟܬܒܘܬܐ ܕܡܓܠܐ ܠܟܠ ܘܝܩܝܦܕܝܐ	Vikipedio:Listo de havendaj artikoloj
ܣܕܪܐ:ܐܠܝܩܛܪܘܢܝܘܬܐ	Kategorio:Elektroniko
ܣܕܪܐ:ܝܪܚܐ ܕܫܢܬܐ	Kategorio:Monatoj
ܩܠܒܐ:Babel	Ŝablono:Babelejo
ܩܠܒܐ:Commons	Ŝablono:Commons
ܩܠܒܐ:Reflist	Ŝablono:Referencoj
ܩܠܒܐ:User ar-1	Ŝablono:Vikipediisto ar-1
ܩܠܒܐ:See also	Ŝablono:Vidu ankaŭ
ܩܠܒܐ:User de	Ŝablono:Vikipediisto de
ܩܠܒܐ:User es	Ŝablono:Vikipediisto es
ܩܠܒܐ:User en-3	Ŝablono:Vikipediisto en-3
ܩܠܒܐ:User en-1	Ŝablono:Vikipediisto en-1
ܩܠܒܐ:User en-2	Ŝablono:Vikipediisto en-2
ܩܠܒܐ:User en-4	Ŝablono:Vikipediisto en-4
ܩܠܒܐ:User en-0	Ŝablono:Vikipediisto en-0
ܩܠܒܐ:User en	Ŝablono:Vikipediisto en
ܩܠܒܐ:User fa	Ŝablono:Vikipediisto fa
ܩܠܒܐ:User fr-1	Ŝablono:Vikipediisto fr-1
ܩܠܒܐ:User he-2	Ŝablono:Vikipediisto he-2
ܩܠܒܐ:User he-1	Ŝablono:Vikipediisto he-1
ܩܠܒܐ:User sk	Ŝablono:Vikipediisto sk
ܩܠܒܐ:User ja	Ŝablono:Vikipediisto ja
ܩܠܒܐ:User fr	Ŝablono:Vikipediisto fr
ܩܠܒܐ:User he	Ŝablono:Vikipediisto he
ܣܕܪܐ:ܐܣܝܐ	Kategorio:Azio
ܣܕܪܐ:ܕܪܐ ܕܥܣܪܝܢ ܘܚܕ	Kategorio:21-a jarcento
ܩܠܒܐ:Mod	Ŝablono:Mod
ܩܠܒܐ:Infobox language/codelist	Ŝablono:ISO639-3 ligilo
ܩܠܒܐ:User it	Ŝablono:Vikipediisto it
ܣܕܪܐ:ܝܘܡܐ ܕܫܒܘܥܐ	Kategorio:Tagoj de la semajno
ܩܠܒܐ:ܡܟܬܒܢܘܬܐ ܕܝܦܬܐ	Ŝablono:Kaŝebla listo
ܩܠܒܐ:Sidebar	Ŝablono:Flanka kesto2
ܩܠܒܐ:Ambox	Ŝablono:ArtikolaMesaĝokesto
ܩܠܒܐ:Navigation templates	Ŝablono:Navigilaro
ܩܠܒܐ:ܐܬܪܐ	Ŝablono:Informkesto lando
ܣܕܪܐ:User en	Kategorio:Vikipediisto en
ܣܕܪܐ:User zh	Kategorio:Vikipediisto zh
ܣܕܪܐ:User zh-N	Kategorio:Vikipediisto zh-D
ܩܠܒܐ:ܨܢܕܘܩ ܪܡܙܐ2	Ŝablono:Informkesto
ܩܠܒܐ:User zh	Ŝablono:Vikipediisto zh
ܩܠܒܐ:ܩܠܒܐ ܐܚܪܝܢܐ	Ŝablono:Ĉu ŝablono
ܩܠܒܐ:ܐܠܦܒܝܬ ܠܐܛܝܢܝܐ	Ŝablono:A-Z
ܣܕܪܐ:ܦܐܦܐ	Kategorio:Papoj
ܩܠܒܐ:Pp-template	Ŝablono:Pp-ŝablono
ܩܠܒܐ:User nl-1	Ŝablono:Vikipediisto nl-1
ܩܠܒܐ:User nl-2	Ŝablono:Vikipediisto nl-2
ܣܕܪܐ:ܪܝܫܝ ܩܘܛܢܝܘܬܐ	Kategorio:Prezidantoj
ܩܠܒܐ:User ru	Ŝablono:Vikipediisto ru
ܩܠܒܐ:IPA	Ŝablono:IFA
ܣܕܪܐ:ܗܪܘܡܐ	Kategorio:Spicoj
ܣܕܪܐ:ܦܠܫܬ	Kategorio:Palestino
ܣܕܪܐ:ܡܠܐܟܐ	Kategorio:Anĝeloj
ܣܕܪܐ:ܢܒܝܐ	Kategorio:Profetoj
ܩܠܒܐ:Rellink	Ŝablono:RilataLigilo
ܩܠܒܐ:Category redirect	Ŝablono:Kategoria alidirekto
ܩܠܒܐ:ܨܢܕܘܩ ܡܕܒܪܢܐ	Ŝablono:Informkesto politikisto
ܩܠܒܐ:Sortname	Ŝablono:Ordiginomo
ܩܠܒܐ:Border	Ŝablono:Bordero
ܩܠܒܐ:ܡܢܝܢܐ ܕܝܪܚܐ	Ŝablono:Nombro de monato
ܩܠܒܐ:GUA	Ŝablono:GTM
ܩܠܒܐ:User nl	Ŝablono:Vikipediisto nl
ܩܠܒܐ:ܨܢܕܘܩ ܐܡܢܐ	Ŝablono:Informkesto artisto
ܩܠܒܐ:ܡܦܠܚܢܐ	Ŝablono:Uzanto2
ܣܕܪܐ:ܬܘܢܣ	Kategorio:Tunizio
ܩܠܒܐ:Oppose	Ŝablono:Kontraŭ
ܩܠܒܐ:COL	Ŝablono:COL
ܩܠܒܐ:PER	Ŝablono:PER
ܩܠܒܐ:ܨܢܕܘܩ ܡܕܥܐ ܕܝܒܫܬܐ	Ŝablono:Informkesto kontinento
ܩܠܒܐ:User ar-2	Ŝablono:Vikipediisto ar-2
ܩܠܒܐ:User ar-3	Ŝablono:Vikipediisto ar-3
ܩܠܒܐ:ܝܘܡܐ ܕܫܒܘܥܐ	Ŝablono:Tagoj de la semajno
ܣܕܪܐ:ܡܕܝܢܬܐ ܒܐܘܚܕܢܐ ܡܚܝܕܐ	Kategorio:Urboj de Usono
ܩܠܒܐ:ܬ.ܐ.	Ŝablono:Apartigilo
ܩܠܒܐ:No	Ŝablono:Ne farita
ܣܕܪܐ:ܩܠܒܐ ܨܢܕܘܩܐ	Kategorio:Ŝablono:Informkesto
ܩܠܒܐ:Partial	Ŝablono:Parte
ܩܠܒܐ:ܩܘܕܝܟܘܣ ܕܣܕܪܐ	Ŝablono:Kategoria indekso
ܩܠܒܐ:?	Ŝablono:?
ܩܠܒܐ:User ar-5	Ŝablono:Vikipediisto ar-5
ܣܕܪܐ:User yue	Kategorio:Vikipediisto zh-yue
ܣܕܪܐ:User az	Kategorio:Vikipediisto az
ܣܕܪܐ:User sk	Kategorio:Vikipediisto sk
ܣܕܪܐ:User fr	Kategorio:Vikipediisto fr
ܣܕܪܐ:User ja	Kategorio:Vikipediisto ja
ܣܕܪܐ:User la	Kategorio:Vikipediisto la
ܣܕܪܐ:User pt	Kategorio:Vikipediisto pt
ܣܕܪܐ:User ro	Kategorio:Vikipediisto ro
ܣܕܪܐ:User sv	Kategorio:Vikipediisto sv
ܣܕܪܐ:User ko-N	Kategorio:Vikipediisto ko-D
ܣܕܪܐ:ܗܘܦܪܟܝܣ ܕܥܝܪܐܩ	Kategorio:Gubernioj de Irako
ܩܠܒܐ:Cat main	Ŝablono:PliPri
ܣܕܪܐ:User ar	Kategorio:Vikipediisto ar
ܣܕܪܐ:User da	Kategorio:Vikipediisto da
ܣܕܪܐ:User sk-N	Kategorio:Vikipediisto sk-D
ܣܕܪܐ:User de	Kategorio:Vikipediisto de
ܣܕܪܐ:User el	Kategorio:Vikipediisto el
ܣܕܪܐ:User en-N	Kategorio:Vikipediisto en-D
ܣܕܪܐ:User es	Kategorio:Vikipediisto es
ܣܕܪܐ:User fa	Kategorio:Vikipediisto fa
ܣܕܪܐ:User fi	Kategorio:Vikipediisto fi
ܣܕܪܐ:User he	Kategorio:Vikipediisto he
ܩܠܒܐ:N/a	Ŝablono:N/a
ܣܕܪܐ:ܠܫܢܐ ܥܒܪܝܐ	Kategorio:Hebrea lingvo
ܣܕܪܐ:ܡܕܝܢܬܐ ܒܐܝܣܪܐܝܠ	Kategorio:Urboj de Israelo
ܣܕܪܐ:User it	Kategorio:Vikipediisto it
ܣܕܪܐ:User ko	Kategorio:Vikipediisto ko
ܣܕܪܐ:ܒܬܫܪܝܢ ܐܚܪܝ	Kategorio:Novembro
ܣܕܪܐ:ܝܡܡܐ	Kategorio:Maroj
ܩܠܒܐ:ܐܠܦܒܝܬ ܝܘܢܝܐ	Ŝablono:Grekaj literoj
ܩܠܒܐ:No2	Ŝablono:Ne2
ܩܠܒܐ:Languages	Ŝablono:Babel-ligilaro
ܩܠܒܐ:Rh	Ŝablono:Rh
ܩܠܒܐ:ܡܢܝܢܐ ܕܡܡܪܐ ܦܪܝܫܐ	Ŝablono:Nombro da elstaraj artikoloj
ܩܠܒܐ:ܣܡܘܩܐ	Ŝablono:Ruĝa
ܩܠܒܐ:Yes2	Ŝablono:Jes2
ܩܠܒܐ:Yes-No	Ŝablono:Jes-Ne
ܣܕܪܐ:ܪܝܫܝ ܩܘܛܢܝܘܬܐ ܥܠ ܐܬܪܐ	Kategorio:Prezidantoj laŭ nacieco
ܣܕܪܐ:User ru	Kategorio:Vikipediisto ru
ܣܕܪܐ:User ru-3	Kategorio:Vikipediisto ru-3
ܣܕܪܐ:User templates ar	Kategorio:Babelaj ŝablonoj/ar
ܣܕܪܐ:User templates arc	Kategorio:Babelaj ŝablonoj/arc
ܣܕܪܐ:User templates en	Kategorio:Babelaj ŝablonoj/en
ܣܕܪܐ:User templates he	Kategorio:Babelaj ŝablonoj/he
ܣܕܪܐ:User tr	Kategorio:Vikipediisto tr
ܣܕܪܐ:ܙܡܪܐ	Kategorio:Muzikistoj
ܩܠܒܐ:Lang	Ŝablono:Lang
ܣܕܪܐ:ܪܫܘܡܐ	Kategorio:Pentristoj
ܩܠܒܐ:CHI	Ŝablono:CHL
ܣܕܪܐ:ܢܝܓܪ	Kategorio:Niĝero
ܩܠܒܐ:Infobox language/family-color	Ŝablono:Informkesto lingvo/Koloro
ܣܕܪܐ:ܣܥܪܐ	Kategorio:Hararanĝoj
ܩܠܒܐ:User ar-4	Ŝablono:Vikipediisto ar-4
ܣܕܪܐ:ܢܗܪܘܬܐ	Kategorio:Riveroj
ܩܠܒܐ:User he-0	Ŝablono:Vikipediisto he-0
ܩܠܒܐ:User he-3	Ŝablono:Vikipediisto he-3
ܩܠܒܐ:User he-4	Ŝablono:Vikipediisto he-4
ܩܠܒܐ:User ko	Ŝablono:Vikipediisto ko-D
ܩܠܒܐ:User pt	Ŝablono:Vikipediisto pt
ܣܕܪܐ:User nl	Kategorio:Vikipediisto nl
ܣܕܪܐ:User no	Kategorio:Vikipediisto no
ܣܕܪܐ:ܣܘܪܝܐ	Kategorio:Sirio
ܣܕܪܐ:ܕܪܐ ܩܕܡܝܐ	Kategorio:1-a jarcento
ܣܕܪܐ:ܓܙܪܬܐ ܝܒܫܢܝܬܐ	Kategorio:Duoninsuloj
ܣܕܪܐ:ܗܘܦܪܟܝܣ ܕܗܘܠܢܕܐ	Kategorio:Provincoj de Nederlando
ܣܕܪܐ:ܡܢܝܢܐ	Kategorio:Entjeroj
ܣܕܪܐ:ܡܕܝܢܬܐ ܕܥܝܪܐܩ	Kategorio:Urboj de Irako
ܣܕܪܐ:ܥܝܢܐ (ܨܪܘܝܘܬܐ)	Kategorio:Okulo
ܣܕܪܐ:ܓܘܪܓܝܐ	Kategorio:Kartvelio
ܣܕܪܐ:ܟܘܘܝܬ	Kategorio:Kuvajto
ܣܕܪܐ:ܠܒܢܢ	Kategorio:Libano
ܣܕܪܐ:ܪܝܫܝ ܩܘܛܢܝܘܬܐ ܕܐܬܪܘܬܐ ܡܚܝܕܐ ܕܐܡܪܝܩܐ	Kategorio:Prezidantoj de Usono
ܣܕܪܐ:ܝܘܪܕܢܢ	Kategorio:Jordanio
ܣܕܪܐ:ܦܐܪܐ	Kategorio:Fruktoj
ܣܕܪܐ:ܝܘܠܦܢ ܟܘܪܗܢܐ	Kategorio:Patologio
ܣܕܪܐ:ܓܒܐ	Kategorio:Politikaj partioj
ܣܕܪܐ:ܕܝܬܝܩܝ ܚܕܬܐ	Kategorio:Nova testamento
ܣܕܪܐ:ܕܝܬܝܩܝ ܥܬܝܩܬܐ	Kategorio:Malnova Testamento
ܣܕܪܐ:ܐܘܩܝܢܘ	Kategorio:Oceanoj
ܣܕܪܐ:ܓܪܡܐ	Kategorio:Skeleta sistemo
ܣܕܪܐ:ܗܘܦܪܟܝܣ ܘܐܘܚܕܢܐ ܕܩܢܕܐ	Kategorio:Kanadaj provincoj
ܣܕܪܐ:ܚܝܘܬܐ	Kategorio:Bestoj
ܣܕܪܐ:ܛܘܪܐ	Kategorio:Montaroj
ܣܕܪܐ:ܣܘܥܪܢܐ	Kategorio:Eventoj
ܣܕܪܐ:ܟܘܪܗܢܐ	Kategorio:Malsanoj
ܣܕܪܐ:User pl	Kategorio:Vikipediisto pl
ܣܕܪܐ:ܩܣܪ	Kategorio:Imperiestroj
ܣܕܪܐ:ܡܕܒܪܐ	Kategorio:Dezertoj
ܣܕܪܐ:ܝܡܡܬܐ	Kategorio:Lagoj
ܩܠܒܐ:ܨܢܕܘܩ ܪܡܙܐ ܕܠܫܢܐ	Ŝablono:Informkesto lingvo
ܣܕܪܐ:ܩܛܠܥܡܐ	Kategorio:Masakroj
ܨܝܢ	Ĉinio (apartigilo)
ܛܪܘܝܐܢܝ	Trojany
ܣܕܪܐ:ܢܒܝܐ ܕܕܝܬܝܩܝ ܥܬܝܩܬܐ	Kategorio:Profetoj de la Malnova Testamento
ܣܕܪܐ:ܦܛܪܝܪܟܘ	Kategorio:Patriarkoj
ܣܕܪܐ:ܒܝܬ ܟܬܒܐ	Kategorio:Bibliotekoj
ܣܕܪܐ:ܫܢܬܐ ܥܕܬܢܝܬܐ	Kategorio:Liturgia jaro
ܣܕܪܐ:ܐܪܙܐ	Kategorio:Sakramentoj
ܣܕܪܐ:ܒܝܬ ܢܗܪܝܢ	Kategorio:Mezopotamio
ܣܕܪܐ:ܓܘܢܐ	Kategorio:Koloroj
ܣܕܪܐ:ܦܣܩܐ ܕܝܘܡܐ	Kategorio:Partoj de tago
ܣܕܪܐ:ܛܪܘܢܐ	Kategorio:Diktatoroj
ܣܕܪܐ:ܩܠܒܐ	Kategorio:Ŝablono:laŭ funkcio
ܕܒܘܪܐ (ܪܚܫܐ)	Vespo
ܩܠܒܐ:ܣܘܪܓܕܐ ܚܘܫܒܢܐ	Ŝablono:Jaro en la aliaj kalendaroj
ܣܕܪܐ:ܩܕܝܫܐ	Kategorio:Sanktuloj
ܩܪܕܐ (ܪܚܫܐ)	Iksodo
ܩܠܒܐ:User nl-4	Ŝablono:Vikipediisto nl-4
ܩܠܒܐ:User nl-3	Ŝablono:Vikipediisto nl-3
ܕܝܠܢܝܐ:ܫܘܚܠܦ̈ܐ ܚܕ̈ܬܐ	Specialaĵo:Lastaj ŝanĝoj
