Hĭ-ciŭ	Afriko
Nĭk-buōng	Japanio
Nàng Mī-ciŭ	Sudameriko
Nò̤-ŭi	Norvegio
Ĭng-gáik-làng	Anglio
Sŭ-gáik-làng	Skotlando
Ŭi-ī-sê̤ṳ	Kimrio
Báe̤k Ái-ī-làng	Nord-Irlando
Ái-ī-làng	Irlando
Hungary	Hungario
Să̤-băng-ngà	Hispanio
Mī-guók	Usono
Bī-lé-sì	Belgio
Luxembourg	Luksemburgo (lando)
Ṳ̄-dêu	Universo
Dê-giù	Tero
Sĕng-mêng	Vivo
Sī	Morto
Nè̤ng	Homo
Huăng-hī	Feliĉo
George Washington	George Washington
Wikidata	Vikidatumoj
Hŭng-làng	Finnlando
Sôi-diēng	Svedio
Dăng-măk	Danio
Pŏ̤-làng	Pollando
Lithuania	Litovio
É-dâi-lé	Italio
Sô̤i-sê̤ṳ	Svislando
Ó̤-dê-lé	Aŭstrio
Hĭ-lé-nà̤	Grekio
Tū-ī-gì	Turkio
Bì-ciū	Biero
Può-dò̤-ngà	Portugalio
Ĕu-ciŭ	Eŭropo
Ā-ciŭ	Azio
Báe̤k Mī-ciŭ	Nordameriko
Nàng-gĭk-ciŭ	Antarkto
Wikipedia	Vikipedio
Hò̤-làng	Nederlando
Ĭng-gĕng	Peniso
PHP	PHP
Niū-iók-chê	Novjorko
Washington, D.C.	Vaŝingtono
Gô-gĭng-săng	San-Francisko
Báik-lìng	Berlino
Los Angeles	Los-Anĝeleso
Diêng-nō̤	Komputilo
Sŭ-là̤-sié	Zuriko
Barack Obama	Barack Obama
Uruguay	Urugvajo
MediaWiki	MediaVikio
Lùng-dŭng	Londono
Bìng-guō	Pomo
Bă-là̤	Parizo
Mĕ̤k-să̤-gŏ̤	Meksiko
Dâi-să̤-iòng	Atlantika Oceano
Tái-bìng-iòng	Pacifika Oceano
California	Kalifornio
Boston	Bostono
Lā̤-bái-ék	Lundo
Huōi-sĭng	Marso
Kenya	Kenjo
Ethiopia	Etiopio
Ghana	Ganao
Lā̤-bái-nê	Mardo
Lā̤-bái-săng	Merkredo
Lā̤-bái-sé	Ĵaŭdo
Lā̤-bái-ngô	Vendredo
Lā̤-bái-lĕ̤k	Sabato
Lā̤-bái-nĭk	Dimanĉo
Săi (mà-kuŏ dông-ŭk)	Leono
Huák-guók	Francio
Kēng	Hundo
Ĭng-guók	Unuiĝinta Reĝlando
Mà	Hejma kato
Dṳ̆ng-huà Ìng-mìng Gê̤ṳng-huò-guók	Ĉina Popola Respubliko
Huák-ngṳ̄	Franca lingvo
Wiktionary	Vikivortaro
Ngṳ̀	Fiŝoj
Ciū	Alkoholaĵo
Bă-să̤	Brazilo
Ngò̤-lò̤-sṳ̆	Rusio
Hāi	Maro
Alabama	Alabamo
Wikimedia	Fondaĵo Vikimedio
Jimmy Wales	Jimmy Wales
Dáik-guók	Germanio
Belarus	Belorusio
Dáik-ngṳ̄	Germana lingvo
Bĭng-dō̤	Islando
Estonia	Estonio
Tū-sĭng	Saturno (planedo)
Hĭ-gĭ	Aviadilo
Ciéng-cĕng	Milito
1	1 (nombro)
2	2 (nombro)
3	3 (nombro)
4	4 (nombro)
5	5 (nombro)
0	Nulo
George W. Bush	George W. Bush
Latvia	Latvio
Ukraine	Ukrainio
Ciék-káik	Ĉeĥio
Slovakia	Slovakio
Slovenia	Slovenio
Moldova	Moldava Respubliko
Romania	Rumanio
Bulgaria	Bulgario
Lò̤-mā	Romo
Macedonia Gê̤ṳng-huò-guók	Respubliko Makedonio
Albania	Albanio
Croatia	Kroatio
Bosnia gâe̤ng Herzegovina	Bosnio kaj Hercegovino
Azerbaijan	Azerbajĝano
Andorra	Andoro
Cyprus	Kipro
Georgia (guók-gă)	Kartvelio
Kazakhstan	Kazaĥio
Malta	Malto
Monaco	Monako
Montenegro	Montenegro
Vaticano	Vatikano
San Marino	San-Marino
Gū-bă	Kubo
Belize	Belizo
Barbados	Barbado
Java	Java (programlingvo)
Éng-dô-nà̤-să̤-ā	Indonezio
Tū-ī-gì-ngṳ̄	Turka lingvo
Nàng-hĭ	Sud-Afriko
Algeria	Alĝerio
Wiki Dù-cṳ̆-guāng	Vikifontaro
Uzbekistan	Uzbekujo
Huà-să	Varsovio
Può-dò̤-ciū	Vino
Cūi	Akvo
Chà	Ligno
Diêng-sê	Televido
Chile	Ĉilio
Ià-sŭ	Jesuo Kristo
Galileo Galilei	Galilejo
Cūi-sĭng	Merkuro (planedo)
Lĭk-sṳ̄	Historio
Gĭng-sĭng	Venuso (planedo)
Ngṳ̄-ngiòng	Lingvo
Ái	Amo
Mŭk-sĭng	Jupitero (planedo)
Ngṳ̀ng-ò̤	Lakta vojo
Tiĕng-uòng-sĭng	Urano (planedo)
Hāi-uòng-sĭng	Neptuno (planedo)
Tiĕng-ùng	Astronomio
Sĭng-gă-pŏ̤	Singapuro
Kuŏ-hŏk	Scienco
Mìng-uòng-sĭng	Plutono
Ciŏng-lài	Estonteco
Séng-mū Mā-lé-ā	Maria (patrino de Jesuo)
Liechtenstein	Liĥtenŝtejno
Adolf Hitler	Adolf Hitler
Dâ̤-nê-ché̤ṳ Sié-gái Dâi-ciéng	Dua mondmilito
Wiki Gáu-kuŏ-cṳ̆	Vikilibroj
Wiki Ngṳ̄-liŏh	Vikicitaro
Wiki Dâi-hŏk	Vikiversitato
Cṳ̆ng	Horloĝo
Ubuntu	Ubuntu (linukso)
Linux	Linukso
Só-hŏk	Matematiko
Lá-dĭng-ngṳ̄	Latina lingvo
Bahrain	Barejno
Armenia	Armenio
Serbia	Serbio
Nguŏk-giù	Luno
Istanbul	Istanbulo
Ó̤-ciŭ	Aŭstralio
Ŭk-lī	Fiziko
Argentina	Argentino
Peru	Peruo
Dièu-siēng Mìng-ciō-ciō-ngiê Ìng-mìng Gê̤ṳng-huò-guók	Nord-Koreio
Gāng-puŏ-câi	Kamboĝo
Gū-làng-gĭng	Korano
Kṳ̄ng-lṳ̀ng	Dinosaŭro
Ĭ-sṳ̆-làng-gáu	Islamo
Lì	Pirarbo
Lùng-lùng	Rado
Huò-bìng	Paco
Nṳ̄-gái	Virino
Gū-chiŏng-kĕ̤ng	Anuso
Nìng-mùng	Citrono
Bă-ciĕu	Banano
Huă	Floro
Napoléon Bonaparte	Napoleono Bonaparte
Sĕng-lī	Fiziologio
Hèng-sĭng	Stelo
Nĭk-tàu	Suno
Victor Hugo	Victor Hugo
Dâi-iòng-ciŭ	Oceanio
Tái-iòng-hiê	Sunsistemo
Ngāi	Dento
Kĭng	Hidrogeno
Wiki Gê̤ṳng-hiōng	Vikimedia Komunejo
Cṳ̆	Libro
Nĭk	Tago
Dĕ̤ng Timor	Orienta Timoro
Màng-buŏ	Nokto
Nièng	Jaro
Ó̤-sṳ̆-lṳ̆k	Oslo
Lī-sṳ̆-buōng	Lisbono
Táng	Karbono
Dâng	Nitrogeno
Iōng	Oksigeno
Giàng-sĭng	Planedo
Kleopatra 7-sié	Kleopatra
Ĭng-ngŏk	Muziko
É-dâi-lé-ngṳ̄	Itala lingvo
Séng Peterburg	Sankt-Peterburgo
Chad	Ĉado
Lé̤ṳ	Aluminio
Sĭng-să̤-làng	Nov-Zelando
Éng-dô	Barato
Tuvalu	Tuvalo
Tiék	Fero
Tonga	Tongo
Samoa	Samoo
Solomon Gùng-dō̤	Salomonoj
Vanuatu	Vanuatuo
Papua New Guinea	Papuo-Nov-Gvineo
William Shakespeare	William Shakespeare
Palau	Palaŭo
Nauru	Nauro
Micronesia Lièng-băng	Federacio de Mikronezio
Iòng (gĭng-sṳ̆k)	Plumbo
Marshall Gùng-dō̤	Marŝala Insularo
Kiribati	Kiribato
Mūng-gū	Mongolio
Fiji	Fiĝioj
Venezuela	Venezuelo
Guók-cié chiông-gì	Ŝako
Genghis Khan	Ĝingis-Ĥano
Maine	Majno
Mā	Ĉevalo
Ū-ké	Armilo
Dông-ŭk	Bestoj
Suriname	Surinamo
Paraguay	Paragvajo
Guyana	Gujano
Ecuador	Ekvadoro
Colombia	Kolombio
Hŭk-gáu	Budhismo
Bolivia	Bolivio
Dè̤ng	Kupro
Trinidad gâe̤ng Tobago	Trinidado kaj Tobago
Sĭk-ŭk	Plantoj
Séng Vincent gâe̤ng Grenadines	Sankta Vincento kaj Grenadinoj
New Hampshire	Nov-Hampŝiro
Séng Lucia	Sankta Lucio
Séng Kitts gâe̤ng Nevis	Sankta-Kito kaj Neviso
Cĭng-kṳ̄ng	Fungoj
Jamaica	Jamajko
Grenada	Grenado (lando)
Massachusetts	Masaĉuseco
Guatemala	Gvatemalo
Bahamas	Bahamoj
Connecticut	Konektikuto
Giĕ	Koko
Antigua gâe̤ng Barbuda	Antigvo-Barbudo
Hawaii	Havajo
Honduras	Honduro
Dominica	Dominiko
Dominica Gê̤ṳng-huò-guók	Domingo
Dṳ̆	Porko
Báe̤k-bĭng-iòng	Arkta Oceano
Haiti	Haitio
El Salvador	Salvadoro
Ĭ-lāng	Irano
Iraq	Irako
Alaska	Alasko
Costa Rica	Kostariko
Ī-sáik-liĕk	Israelo
Panama	Panamo
Yemen	Jemeno
Bâng-dŭk	Viruso (biologio)
Pŏ̤-làng-ngṳ̄	Pola lingvo
Jordan	Jordanio
Nicaragua	Nikaragvo
Florida	Florido
Kyrgyzstan	Kirgizio
Arizona	Arizono
Kuwait	Kuvajto
Lō̤-kuŏ	Laoso
Lebanon	Libano
Oregon	Oregono
Maldives	Maldivoj
Mī-ciŭ	Ameriko
Utah	Utaho
Ngù	Bovo
Mā-lài-să̤-ā	Malajzio
Miēng-diêng	Birmo
Nepal	Nepalo
Oman	Omano
Pakistan	Pakistano
Qatar	Kataro
Saudi Ā-lá-báik	Sauda Arabio
Sri Lanka	Sri-Lanko
Joseph Stalin	Josif Stalin
Syria	Sirio
Platon	Platono
Tajikistan	Taĝikio
Dṳ̆ng-huà Mìng-guók	Respubliko Ĉinio
Aristoteles	Aristotelo
Tái-guók	Tajlando
Huōi-chiă	Trajno
Turkmenistan	Turkmenio
Ā-lá-báik Lièng-hăk Dâi-gŭng-guók	Unuiĝintaj Arabaj Emirlandoj
Băh-gĭng	Plateno
Uŏk-nàng	Vjetnamio
Dâi-hàng Mìng-guók	Sud-Koreio
Afghanistan	Afganio
Gĭng	Oro
Suez Ông-ò̤	Sueza Kanalo
Bangladesh	Bangladeŝo
Mali	Malio
Sokrates	Sokrato
Angola	Angolo
Bhutan	Butano
Ùng-lài	Brunejo
Tanzania	Tanzanio
Cūi-ngṳ̀ng	Hidrargo
Hĭ-lĭ-pĭng	Filipinoj
Dṳ̆ng-hĭ Gê̤ṳng-huò-guók	Centr-Afrika Respubliko
Isaac Newton	Isaac Newton
Albert Einstein	Albert Einstein
Uòng-sáik	Flava
Togo	Togolando
Tunisia	Tunizio
Zambia	Zambio
Zimbabwe	Zimbabvo
Báe̤k-gĭng	Pekino
Nàng Sudan	Sud-Sudano
Benin	Benino
Botswana	Bocvano
Wiki Sĭng-ùng	Vikinovaĵoj
Burkina Faso	Burkino
Burundi	Burundo
Comoros	Komoroj
Congo Gê̤ṳng-huò-guók	Respubliko Kongo
Congo Mìng-ciō Gê̤ṳng-huò-guók	Demokratia Respubliko Kongo
Djibouti	Ĝibutio
Chiáh-dô̤ Guinea	Ekvatora Gvineo
Eritrea	Eritreo
Gabon	Gabono
Gambia	Gambio
Guinea	Gvineo
Guinea-Bissau	Gvineo Bisaŭa
Côte d'Ivoire	Ebur-Bordo
Cameroon	Kameruno
Cabo Verde	Kaboverdo
Lesotho	Lesoto
Liberia	Liberio
Libya	Libio
Madagascar	Madagaskaro
Malawi	Malavio
Mauritania	Maŭritanio
Mauritius	Maŭricio
Morocco	Maroko
Mozambique	Mozambiko
Namibia	Namibio
Niger	Niĝero
Nigeria	Niĝerio
Charles Darwin	Charles Darwin
Uganda	Ugando
Rwanda	Ruando
Séng Tomé gâe̤ng Príncipe	Sao-Tomeo kaj Principeo
Senegal	Senegalo
Seychelles	Sejŝeloj
Carl Linnaeus	Karolo Lineo
Sierra Leone	Siera-Leono
Somalia	Somalio
Julius Caesar	Julio Cezaro
Sudan	Sudano
Swaziland	Svazilando
Kê̤ṳng	Ĉielarko
Lièng-hăk-guók	Unuiĝintaj Nacioj
Dê-cék	Geologio
Dê-lī	Geografio
Sĭng-câung	Koro
Puòi-hŭ	Haŭto
Ngàng-sáik	Koloro
Làng-sáik	Blua
Ngṳ̀ng	Arĝento
Sék	Stano
Michigan	Miĉigano
Illinois	Ilinojso
North Dakota	Norda Dakoto
South Dakota	Suda Dakoto
Montana	Montano
Wyoming	Vajomingo
Idaho	Idaho
Washington	Vaŝingtonio
Nevada	Nevado
Éng-dô-iòng	Hinda Oceano
Kosovo	Kosovo
Colorado	Koloradio
分類:Hŭng-lôi	Kategorio:Ĉio
Chicago	Ĉikago
Dĕ̤ng-tiĕng	Vintro
Chŭng-tiĕng	Printempo
Hâ-tiĕng	Somero
Chiŭ-tiĕng	Aŭtuno
Saddam Hussein	Saddam Hussein
Osama bin Laden	Usama bin Laden
Să̤-băng-ngà-ngṳ̄	Hispana lingvo
Philadelphia	Filadelfio (Pensilvanio)
Tĭ-tṳ̆	Araneuloj
Guō-sĭk	Frukto
Gàu	Simio
Cièng	Mono
Virginia	Virginio (ŝtato)
West Virginia	Okcidenta Virginio
Niū-iók-ciŭ	Nov-Jorkio
Rhode Island	Rod-Insulo
Kŏng-tṳ̀ng	Insekto
Maryland	Marilando
Delaware	Delavaro
Vladimir Lenin	Lenin
Ohio	Ohio
Pennsylvania	Pensilvanio
Augustus	Aŭgusto Cezaro
Microsoft Windows	Microsoft Windows
New Jersey	Nov-Ĵerzejo
Hŭng-làng-ngṳ̄	Finna lingvo
Indiana	Indianio
Ké-chiă	Aŭtomobilo
Georgia	Georgio
Texas	Teksaso
North Carolina	Norda Karolino
South Carolina	Suda Karolino
Manila	Manilo
Dĕ̤ng-gĭng	Tokio
Uòng-lì	Ananaso
Mississippi	Misisipio
Tennessee	Tenesio
New Mexico	Nov-Meksiko
Ngà-diēng	Ateno
Minnesota	Minesoto
Baghdad	Bagdado
Wisconsin	Viskonsino
Iowa	Iovao
Nebraska	Nebrasko
Kansas	Kansaso
Hŏng-giāng	Cigaredo
Missouri	Misurio
Louisiana	Luiziano
Kentucky	Kentukio
Arkansas	Arkansaso
Oklahoma	Oklahomo
Madonna	Madonna
Aceh	Aceho
Séng-gĭng	Biblio
Phnom Penh	Pnom-Peno
Hù Cé-mìng Chê	Ho-Ĉi-Min-urbo
Ò̤-nô̤i	Hanojo
Cĭng Ià-sŭ Gáu-huôi	Vera Eklezio de Jesuo
Ĭng-ngṳ̄	Angla lingvo
Màng-gók	Bankoko
Kuala Lumpur	Kuala-Lumpuro
Bangka Belitung Gùng-dō̤	Bangka-Belitungo
Dài-báe̤k	Tajpeo
Concepción	Koncepciono
Bengkulu	Bengkuluo
Końskowola	Końskowola
Nê-iōng-huá-táng	Karbona dioksido
Jambi	Ĝambio
Siè	Serpento
Lampung	Lampungo
Guŏng-sók	Lumrapido
Riau	Riauo
Riau Gùng-dō̤	Riau-insuloj
Nàng Sumatra	Suda Sumatro
Lò̤-mā Dá̤-guók	Romia Imperio
Mì-niōng	Microsoft
Kó-lū-hŭ	Kurów
Huá-hŏk	Kemio
Sièng-sŏng	Klorida acido
Ôi-sĭng	Natura satelito
Kă-giù	Futbalo
Să̤ Sumatra	Okcidenta Sumatro
Mā-dáik-lī	Madrido
Michael Jackson	Michael Jackson
Cê̤ṳ-iù	Libereco
Cṳ̆-niòng-giāng	Knabino
Sék-nà̤	Sidnejo
Liŏh-sáik	Verdo
È̤ng-sáik	Ruĝa
Huōi	Fajro
Sĭng Nàng Wales	Novsudkimrio
Nile Ò̤	Nilo
Banten	Provinco Banteno
Dṳ̆ng Jawa	Centra Javo
Chēng-chiū-sĭng	Kometo
Dĕ̤ng Jawa	Orienta Javo
Jakarta	Ĝakarto
Ăng-kā-lá	Ankaro
Să̤ Jawa	Okcidenta Javo
Dṳ̆ng Kalimantan	Centra Kalimantano
Dĕ̤ng Kalimantan	Orienta Kalimantano
Báe̤k Kalimantan	Norda Kalimantano
Nàng Kalimantan	Suda Kalimantano
Hŏk-hâu	Lernejo
Să̤ Kalimantan	Okcidenta Kalimantano
Dâi-hŏk	Universitato
Wikipedia:Să-buàng	Vikipedio:Provejo
Chió	Domo
Dê-dù	Mapo
Ò̤	Rivero
Osasco	Osasco (San-Paŭlo)
Chiĕng-lī-giáng	Teleskopo
分類:Dài-uăng lĭk-sṳ̄	Kategorio:Historio de Tajvano
Curitiba	Kuritibo
Sĕng-lìng	Arbaro
分類:Uŏk-nàng lĭk-sṳ̄	Kategorio:Historio de Vjetnamio
Iók-báik-cṳ̆	Libro de Ijob
Cĭng-ngiòng	Sentencoj de Salomono
Kūng-cṳ̄	Konfuceo
分類:Só-hŏk	Kategorio:Matematiko
Bali	Balio
Ĕu-nguòng	Eŭro
Mī-gĭng	Usona dolaro
Hòng-ciŭ	Hangĝoŭo
Gĭ-dók-gáu	Kristanismo
Dĕ̤ng Nusa Tenggara	Orientaj sudorientaj insuloj
Să̤ Nusa Tenggara	Okcidentaj sudorientaj insuloj
Dṳ̆ng Sulawesi	Centra Sulaveso
Gorontalo	Gorontalo
Báe̤k Sulawesi	Norda Sulaveso
Dĕ̤ng-nàng Sulawesi	Sudorienta Sulaveso
Nàng Sulawesi	Suda Sulaveso
Să̤ Sulawesi	Okcidenta Sulaveso
Seattle	Seattle
Dêu	Rizo
Maluku	Molukoj (provinco)
Báe̤k Maluku	Nordaj Molukoj
Papua	Papuo
Să̤ Papua	Okcidenta Papuo
Cēu	Birdoj
Siū-dŭ	Ĉefurbo
Può-dò̤-ngà-ngṳ̄	Portugala lingvo
Nguŏk	Monato
Uòng Hiêng-huàng	Huang Senfan
Cōng	Diamanto
Nĭk-buōng-ngṳ̄	Japana lingvo
Báik-kuŏ-ciòng-cṳ̆	Enciklopedio
Tàu Hiĕk	Vikipedio:Ĉefpaĝo
模板:Ô-lī-kó̤	Ŝablono:Leginda
Saratov	Saratov
Làng-giù	Korbopilkado
Olympic Ông-dông-huôi	Olimpiaj ludoj
Diòng-gĕ̤ng	Jangzio
Che Guevara	Che Guevara
Mò̤ Dĕk-dŭng	Mao Zedong
Să̤-ăng	Ŝjiano
Lá-sák	Lasao
Séng-gău	Amoro
Ĭng-dô̤	Vagino
Diék-hŏk	Filozofio
分類:Ché̤ṳk-káik chēng-dṳ̀	Kategorio:Tujforigendaj artikoloj
Gáung-kìng	Piano
Dà	Teo
Marco Polo	Marko Polo
Hebe Camargo	Hebe Camargo
Gê̤ṳng-sāng-ciō-ngiê	Komunismo
Cṳ̆-buōng-ciō-ngiê	Kapitalismo
Guók-gă	Lando
Mìng-cŭk	Nacio
Carthago	Kartago
Uōng-hiĕk liù-lāng-ké	TTT-legilo
Siù-cūi	Naĝado
分類:Tiĕng-ùng	Kategorio:Astronomio
Hŭk	Budho
Lī Bĕk	Li Bai
Dù-cṳ̆-guāng	Librarejo
Sĕng-tái	Ekologio
Céng-dê	Politiko
Mìng-ciō	Demokratio
Cìng-dièu	Dinastio Qin
Nobel Ciōng	Nobel-premio
Cìng Sṳ̄-huòng	Qin Shihuangdi
Dṳ̆ng-dĕ̤ng	Mezoriento
Háng-dièu	Dinastio Han
Làu Băng	Liu Bang
Háng Ū-dá̤	Wu Di
Sĕng-ŭk	Organismo
Rabindranath Tagore	Rabindranath Tagore
Gŭng-ciō-cié-dô	Monarkio
Siâ-huôi-ciō-ngiê	Socialismo
Cṳ̆ng-chói	Kiso
Nguòng-dièu	Dinastio Yuan
Nazi Dáik-guók	Nazia Germanio
Christopher Columbus	Kristoforo Kolumbo
Dâng Huò	Ĉeng He
Panama Ông-ò̤	Panama kanalo
Nàng-bĭng-iòng	Suda Oceano
Uòng-ò̤	Flava Rivero
Ngê	Orelo
Pé	Nazo (organo)
Mĕ̤k-ciŭ	Okulo
Hŭng-muòng	Moskito
Săi-ngṳ̀	Ŝarko
Lŏk-dò̤	Kamelo
Chiông	Elefanto
Mā-ngiê	Formiko
Sùi-dièu	Dinastio Sui
Hò̤-làng-ngṳ̄	Nederlanda lingvo
Să̤-hâ	Okcidenta Xia
Sóng-dièu	Dinastio Song
Sóng Hŭi-cŭng	Huizong
Kublai	Kublaj-Ĥano
Huă-chái	Florbrasiko
Giò (sĭk-ŭk)	Melongeno
Siók	Neĝo
Niè-giāng	Infano
Cā-tàu	Mateno
Hŭng-cṳ̆ng	Minuto
Ngò̤-lò̤-sṳ̆-ngṳ̄	Rusa lingvo
Huák-lŭk	Leĝo (jura)
Hièng-huák	Konstitucio
Háng-ngṳ̄	Ĉina lingvaro
Sá̤-bàu	Ĉelo (biologio)
Háik	Sango
Hié (ké-guăng)	Pulmo
Romania-ngṳ̄	Rumana lingvo
Bulgaria-ngṳ̄	Bulgara lingvo
Ṳ̄	Pluvo
Dê-cīng	Tertremo
Cūi-căi	Inundo
Hāi-lâung	Cunamo
Hùng	Nubo
Hŭng-tăi	Uragano
Hŭng	Vento
Georgia-ngṳ̄	Kartvela lingvo
Háng-cê	Ĉina skribo
Dièu-siēng-cê	Korea alfabeto
Lá-dĭng cê-mō̤	Latina alfabeto
Ùng-hŏk	Literaturo
分類:Ĭng-ngŏk	Kategorio:Muziko
分類:Ùng-hŏk	Kategorio:Literaturo
È̤ng-làu-máe̤ng	Ruĝdoma sonĝo
Hù-lì	Vulpo
Harry Potter	Harry Potter
Chiū-ìng	Sinmasturbado
Siâ-huôi	Socio
Gáu-ṳ̆k	Eduko
Nàng-gái	Viro
Ìng-guòng	Homaj rajtoj
Gŭng-sê̤ṳ	Militfortoj
Gă-pĭ	Kafo
Săng	Monto
Sŏng Dṳ̆ng-săng	Sun Jatsen
Hiŏng-gē̤ng	Honkongo
Miami	Miamo
Hàng Ciéng	Korea milito
Siū-ék	Seulo
Siông-hāi	Ŝanhajo
Ùng-huá Dâi-gáik-mêng	Kultura Revolucio
Chĭng-dièu	Dinastio Qing
Uŏk-nàng Ciéng-cĕng	Vjetnama milito
Thomas Edison	Thomas Alva Edison
Armenia-ngṳ̄	Armena lingvo
Ukraine-ngṳ̄	Ukraina lingvo
HTML	HTML
Steven Spielberg	Steven Spielberg
Mŏ̤h-ngiòng	Mo Yan
Sôi-diēng-ngṳ̄	Sveda lingvo
Dăng-măk-ngṳ̄	Dana lingvo
Nò̤-ŭi-ngṳ̄	Norvega lingvo
Luxembourg-ngṳ̄	Luksemburga lingvo
Ciék-káik-ngṳ̄	Ĉeĥa lingvo
Karl Marx	Karl Marx
Nĕng-nĕng	Mamo
Guŏng	Lumo
Hĭ-lé-nà̤-ngṳ̄	Greka lingvo
Ái-ī-làng-ngṳ̄	Irlanda lingvo
Kié-ngò̤	Pingveno
Pŏ̤-sṳ̆-ngṳ̄	Persa lingvo
Cŭng-gáu	Religio
Hàng-guók-ngṳ̄	Korea lingvo
Cháung-sié-gé	Genezo
Chók-Ăi-gĭk-gé	Eliro
Háng-ngṳ̄ Guăng-uâ	Nordĉina dialektaro
Uŏk-nàng-ngṳ̄	Vjetnama lingvo
Sigmund Freud	Sigmund Freud
Tái-guók-ngṳ̄	Siama lingvo
Mā-lài-ngṳ̄	Malaja lingvo
Mūng-gū-ngṳ̄	Mongola lingvo
Bandar Seri Begawan	Bandar-Seri-Begavano
Hĭ-báik-lài-ngṳ̄	Hebrea lingvo
Ŭi-ī-sê̤ṳ-ngṳ̄	Kimra lingvo
Sŭ-gáik-làng-ngṳ̄	Skotgaela lingvo
Vientiane	Vjentiano
Lō̤-cṳ̄	Laozio
Găng-câung	Hepato
Sṳ̆-mā Chiĕng	Sima Qian
Tó	Kuniklo
Ciŏ Hĭ	Zhu Xi
Cìng-gāng	Emocio
Dâi-iòng	Oceano
Victoria Nṳ̄-uòng	Viktoria (Britio)
Sék-giă-mèu-nà̤	Sidarto Gotamo
Mŭk-hâng-mĕk-dáik	Mohamedo
Hŭ-ngék	Spirado
Ṳ̀-gă	Konfuceismo
Bók-lō̤	Ventro
Dô̤-gáu	Taoismo
Chói-siĕk	Lango (anatomio)
Dâiu-gáuk	Kolo
Chói	Buŝo
Elizabeth 2-sié	Elizabeto la 2-a (Britio)
Dòng-dièu	Dinastio Tang
Cê-mō̤	Litero
Mìng-dièu	Dinastio Ming
Ciŏ Nguòng-ciŏng	Ĵu Juanĵang
Ronald Reagan	Ronald Reagan
Īng-lŏk Huòng-dá̤	Jongle
Uâng-lĭk Huòng-dá̤	Ŭan Li
Gĭng Céng-nĭk	Kim Ĝong-il
Nguòng-só ciŭ-gĭ-biēu	Perioda tabelo
Chăng-màng	Blindeco
Sá̤-kṳ̄ng	Bakterioj
Chéu	Arbo
Può-dò̤	Vinbero
Huăng-giāng-sṳ̀	Terpomo
Tòng	Sukero
Uòng-dâu	Sojfabo
Séng-sék	Informo
Bó̤-cāi	Gazeto
Diêng-uâ	Telefono
Ùng-huá	Kulturo
Huáng-ngṳ̄	Sanskrito
Dâi-diòng	Dika intesto
Siēu-diòng	Maldika intesto
Ĭ-hŏk	Medicino
Sièng	Salo
Huá-hŏk nguòng-só	Kemia elemento
Unix	Unikso
Ùi-gì	Goo
Káh-dièu-nó̤h	Ludilo
Diêng-īng	Filmo
Gĭng-sṳ̆k	Metalo (fiziko)
Kă-dăk-chiă	Biciklo
Mièng-huă	Kotono
Sók-dô	Vektora rapido
Sì-găng	Tempo
Cāi	Papero
Só-lâiu	Plasto
Miêng-cék	Areo
Gŭng-chióh	Metro
Iù-diĕng-bău	Maizo
Duâi-măk	Ordinara hordeo
Dĕ̤ng-nàng-ā	Sud-Orienta Azio
Sīng-iòng	Ŝenjango
Tṳ̀ng-kéng	Ĉongĉingo
Tiĕng-cĭng	Tjanĝino
Ū-háng	Vuhano
Gū Ăi-gĭk	Antikva Egiptio
Gū Hĭ-lé-nà̤	Antikva Grekio
Hṳ̀ng	Urso
Britney Spears	Britney Spears
Ngàng	Kancero
Măk	Tritiko
Cié-sē̤	Sorgo
Pó̤-sióng	Malkapablo
Lĭk-huák	Kalendaro
Sìng-gĭng-bâng	Psika malsano
Gregorius Lĭk-huák	Gregoria kalendaro
Tutankhamun	Tutanĥamono
Nguŏk-gĭng	Menstruo
Mà-chiók	Maĝango
Ông-ò̤	Kanalo (akvovojo)
Detroit	Detrojto
Diòng-siàng	Granda Ĉina Muro
Gĭng-cê-ták	Piramido
Osman Dá̤-guók	Otomana Imperio
Guók-nô̤i sĕng-sāng cūng-dĭk	Malneta enlanda produkto
Diêng	Elektro
Ché̤ṳng	Pafarmilo
Lòng-gĭ-ché̤ṳng	Maŝinpafilo
Sáung-buàng	Abako (meĥanika kalkulilo)
Tāng-káik	Tanko
Liĕk-chiĕ	Liĉio
Ià-cī	Kokoso
Tò̤	Persiko
Cáung-ngṳ̄	Ĝŭanga lingvo
Mì-ngù-ī-ngṳ̄	Ujgura lingvo
Lâung-gŏ̤	Kuko
Wiki Ŭk-cṳ̄ng	Vikispecioj
Nĕng-dáe̤k	Mamzono
Ā-lá-báik-ngṳ̄	Araba lingvo
Páuk Céng-hĭ	Park JungHee
Siĕng-ìng-ciōng	Kakto
Siŏh-tàu-lâung	Ŝtoneto
Iòng-bék	Krajono
Gă-sĭ	Meblo
Dó̤h	Tablo
Ó̤-muòng	Makao
Iē-giāng	Seĝo
Hù Gīng-dò̤	Hu Jintao
Sĭk Gê̤ṳng-bìng	Xi Jinping
Dòng-gêng-lĕ̤k	Ĝirafo (specio)
Chĭng-dáung	Ŝenĵeno
Guōng-dĕ̤ng	Gŭangdongo
Guōng-să̤	Gŭangŝjio
Sŭ-lièng	Sovetunio
Kiák-sióng-gĭ	Fotilo
Kagoshima-gâing	Gubernio Kagoŝimo
C ngṳ̄-ngiòng	C (programlingvo)
Kă	Piedo
Ciēng	Geko
Dô-dâing	Lacertuloj
Giĕng-tàu	Ŝultro
Wikipedia:Bō̤-ciéng hō̤ ùng	Vikipedio:Elstaraj artikoloj
模板:Link FA	Ŝablono:LigoElstara
Sié-gái	Mondo
Wikipedia:Duâi chéu â	Vikipedio:Diskutejo
Busan	Pusano
Lèng-huă	Hinda lotuso
Vermont	Vermonto
Denver	Denvero (Koloradio)
Guōng-ciŭ	Kantono (Ĉinio)
Ciōng Gái-sĭk	Ĉiang Kai-ŝek
Gŏng Dĕk-mìng	Jiang Zemin
Nàng-gĭng	Nankingo
Báe̤k-gĭng Dâi-hŏk	Pekina Universitato
Ŭ-lū-mŭk-cà̤	Urumĉio
Gŏng-sŭ	Ĝjangsuo
Ciék-gŏng	Ĝeĝjango
Dâing Siēu-bìng	Deng Xiaoping
Lò̤-mā Gê̤ṳng-huò-guók	Romia Respubliko
Să̤-câung	Tibeto
Ciŭ Ŏng-lài	Zhou Enlai
Dṳ̆ng-guók Gê̤ṳng-sāng-dōng	Komunista Partio de Ĉinio
Chiū-gĭ	Poŝtelefono
Dò̤-nēu	Struto
Dièu-siēng	Koreio
Gŏ̤ Hèng-giông	Gao Xingjian
Ciŏ Ṳ̀ng-gĭ	Ĵu Ronĝi
Lòng	Lupo
Bìng-iōng	Pjongjango
Sĭng-iók Séng-gĭng	Nova testamento
9	9 (nombro)
Kiék	Skorpio
Dṳ̆ng-guók Dâi-lṳ̆k	Ĉeftera Ĉinio
Háik-lṳ̀ng-gĕ̤ng-sēng	Hejlongĝjango
Mā Ĭng-gāu	Ma Ying-jeou
Lè̤	Azeno
Wikipedia:Cék-liông ô-lī-kó̤ gì ùng-ciŏng	Vikipedio:Legindaj artikoloj
Sé-chiŏng	Siĉuano
Gô-iók Séng-gĭng	Malnova testamento
Séng-dáng-cáik	Kristnasko
Săng-gáe̤k-hìng	Triangulo
Muammar Gaddafi	Muamar Kadafi
Lâu-hū	Tigro
Daejeon	Deĝon
Daegu	Teguo
Incheon	Inĉono
Bô-uăk-cáik	Pasko
Ò̤-báe̤k	Hebejo
GNU Cê̤ṳ-iù Ùng-dáung Hṳ̄-kō̤-céng	Permesilo de GNU por Liberaj Dokumentoj
Dài-uăng	Tajvano
À̤	Ŝuo
Ngṳ̀ng-hòng	Banko
Lū Séng	Lu Xun
7	7 (nombro)
8	8 (nombro)
Lĕ̤k	Cervedoj
Hù	Lago
Sáung-tàu	Ajlo
Chái-guă	Kukumo
Dō̤	Insulo
Băh-sáik	Blanko
Ŭ-sáik	Nigro
6	6 (nombro)
Moshchena	Moŝĉena
Huăng-kê	Tomato
George H. W. Bush	George H. W. Bush
Quảng Bình	Provinco Quang Binh
Atlanta	Atlanta (Georgio)
Benito Mussolini	Benito Mussolini
Sṳ̀-diēng	Vortaro
Tàu	Kapo
Hiê-lìng-dóng	Velingtono
Dâi Bók-liĕk-diĕng Dō̤	Britio (insulo)
Las Vegas	Lasvegaso
10	10 (nombro)
Alfred Nobel	Alfred Nobel
Tàu-sĕ̤	Kombilo
Guòng-lĭk	Potenco (filozofio)
Mà-hùng-cēu	Strigoformaj birdoj
Dēng-cṳ̆ng	Horo
Ké-chiông	Meteologio
Đà Nẵng	Da Nang
Káh-chiók	Eŭropa pigo
Làng-huă	Orkidacoj
Gă-săk	Blato
Ngáuk-ngṳ̀	Krokodilulo
Lā-lì	Maniso
Holocene	Holoceno
Bà̤-bá-cēu	Troglodito
Ciáh-giāng	Kampopasero
Niccolò Cusano Dâi-hŏk	Università degli Studi Niccolò Cusano
Herodotus	Herodoto
Othello	Otelo
Nĭk-buōng-hāi	Japana Maro
Dĕ̤ng-ā	Orienta Azio
Dĕ̤ng-ĕu	Orienta Eŭropo
Liù-giù-guók	Rjukju-reĝlando
Dièu-siēng uòng-dièu	Joseon-Dinastio
Gŏ̤-gău-là̤	Kogurjo
Bì-bà-dâu-giék	Kiropteroj
Báik-cá̤	Baekje
Sĭng-lò̤	Silla
Tàu-huók	Haro
Hàng Hĭ	Han Fei
Diéu-ngṳ̀-dài Liĕk-dō̤	Senkaku-insuloj
Gê̤ṳng-huò-dōng (Mī-guók)	Respublikana Partio (Usono)
Dṳ̆ng-guók	Ĉinio
Mìng-ciō-dōng (Mī-guók)	Demokrata Partio (Usono)
Cūi-tiák	Lutra lutra
Sìng-dŭ	Ĉengduo
Buò-gŭng-ĭng	Taraksako
Tá	Meduzo
Dâng-ciŭ	Ĝengĝoŭo
Cūng-tūng	Prezidanto
Muāng-ciŭ-guók	Manĉukuo
Gù-cŭi	Turtoj
Dṳ̆ng-guók Guók-mìng-dōng	Kuomintango
Ngâng	Cigna ansero
Ĕng-gŏ̤	Papagoformaj
Gă-huák	Adicio
Dài-uăng-sēng	Provinco Tajvano
Dŏ̤	Tranĉilo
Băng-mā	Zebro
Guók-cié biĕu-cūng cṳ̆-hô̤	ISBN
Káh-gă-ngṳ̄	Hakaa lingvo
Huŏng-ngiòng	Dialekto
Lev Trotsky	Lev Trockij
Gáng-ngṳ̄	Gana lingvo
Mà-hṳ̀ng	Granda pando
Muāng-ngṳ̄	Manĉura lingvo
Chiū	Mano
Dô Hū	Du Fu
Gùng-dō̤	Insularo
Niŏh-niŏh	Folio
Bŭk-buó	Akvofalo
Yasser Arafat	Jaser Arafat
Chṳ̆ng-sìng-ngṳ̄	Okinava lingvo
Câung-ngṳ̄	Tibeta lingvo
Ngù-ngṳ̄	Vua lingvo
Tasmania	Tasmanio
Ì-cô̤	Sapo
Hŭk-săng	Foŝan
Ciĕu-huò Tiĕng-huòng	Hirohito
Al-Qaeda	Al-Kaida
Mò̤-táuk-chiă	Motorciklo
Ò̤-mā	Amfibia hipopotamo
Anastacia	Anastacia
Sĕk Gái	La Dekalogo
Huă-báu	Leopardo
Să̤-ngiù	Rinoceredoj
Lò̤-buàng	Kompaso
Buáng-dō̤	Duoninsulo
Sĭng-giŏng	Ŝinĝjango
Mŭk-guă	Papajo
Mì-sĕng-só	Vitamino
Gái-làng-chái	Blanka brasiko
Giáng	Spegulo
Ciŭ-dièu	Dinastio Zhou
Kāng-muòng-giāng	Fenestro
Băh Gṳ̆ng	Blanka Domo (Vaŝingtono)
Gīng-chák	Polico
Báe̤k-hāi-dô̤	Hokajdo
Giŏng	Zingibro
Nobel Huò-bìng Ciōng	Nobel-premio pri paco
Sáu	Tuso
Káung-mìng	Dormo
Gèng-hāi	Aralo
Dé̤ṳk	Bambuo
Hù Cé-mìng	Ho Chi Minh
Sŭ Sék	Su Ŝi
Queensland	Kvinslando
Tù	Grundo
Dòng-dô	Longo
Máe̤ng	Sonĝo
Mìng-dĕ̤ng-ngṳ̄	Min-donga lingvo
Hannibal	Hanibal Barka
Mìng-nàng-ngṳ̄	Minnana lingvo
Duâi-sĭng-sĭng	Gorilo
Cáung-cŭk	Ĝŭangoj
Iók-hâng Hók Ĭng	Evangelio laŭ Johano
Dài-uăng-uâ	Hokla lingvo
Muòng	Pordo
Chiēng-gák	Ungo
Sìng-lṳ̀ng	Jackie Chan
Méng	Vizaĝo
Ùng-ngiòng-ùng	Klasika ĉina lingvo
Gāng-lāng	Olivarbo
Săng-ôi-ék-tā̤	Sankta Triunuo
Sŏng-cṳ̄	Sun Tzu
Sĭng-săng	Instruisto
Cleveland	Klevlando
Dăk-lâi Lā-mà	Dalai-lamao
Huă-sĕng	Ternukso
100	100 (nombro)
Kă-kók-tàu	Genuo
Hâing	Abrikotarbo
Ngāng-giáng	Okulvitro
Cê̤ṳ-lài-huōi	Alumeto
Chê-diòng	Merkato
Nàng Dṳ̆ng-guók Hāi	Sudĉina Maro
Dièu-siēng Sié-cŭng	Seĝong
Hăk-gĭng	Alojo
Bĭng-siŏng	Fridujo
Nobel Ùng-hŏk Ciōng	Nobel-premio pri literaturo
Huăng-sṳ̀	Batato
Uòng-hāi	Flava Maro
Akihito	Akihito
Newton ông-dông-hŏk dêng-lŭk	Leĝoj de Newton pri movo
Să̤-guă	Akvomelono
Biobío Dâi-hŏk	Universidad del Bío-Bío
Huòng-dá̤	Imperiestro
Ìng-mìng-bê	Renminbio
Tā̤-cék	Volumeno
Cèng-sáik	Oranĝkolora
Gă-sĭ-huă	Laborilo
Ĭ-sĕng	Kuracisto
Iéng (cēu)	Hirundo
Kó	Pantalono
Lô-gă Hók Ĭng	Evangelio laŭ Luko
Mìng-ciō-dōng	Demokrata Partio
Ciŏng-tàu	Briko
Tiō-uòng	Elipso (matematiko)
Sìng-huák	Multipliko
Sé̤ṳ-dù Hèng-diông	Agoj de la Apostoloj
Uòng-dô̤ Sĕk-nê Sĭng-cô̤	Zodiako
Huá-siŏh	Fosilio
Gēng-huák	Subtraho
Cī-cī	Semo (planto)
Chiĕk	Krabo
Gă-dŏ̤	Tondilo
Niêu	Urino
Ăng-hŭi	Anhujo
Ngiăh	Frunto
Sĭ-piĕng	Psalmo
Nô̤i Mūng-gū	Interna Mongolio
Gĭng Nĭk-sìng	Kim Il-sung
Jeju Dĕk-biék Cê̤ṳ-dé-dô̤	Jeju-do
Huăng-cièng-giāng	Monero
Bă-biĕk-ták	Babela turo
Ulsan	Ulsan
Gwangju	Kŭangĵuo
Chó	Vinagro
Kangwŏn Dô̤ (Dièu-siēng Mìng-ciō-ciō-ngiê Ìng-mìng Gê̤ṳng-huò-guók)	Kangŭon (Nord-Koreio)
Michael Jordan	Michael Jordan
Lé-ê-gé	Levidoj
Gṳ̆ng-gṳ̆ng	Radiko (planto)
Bì-bà (cūi-guō)	Mespilarbo
Hamlet	Hamleto
Huà Guók-hŭng	Hua Guofeng
Sāng	Ombrelo
Làu Hiēu-pŏ̤	Liu Xiaobo
Hók-gióng	Fuĝjano
Mūng-gū-cŭk	Mongoloj
Mĕk-sê Liŏh	Apokalipso de Johano
Hièng-câung	Xuanzang
Gū-chiŏng	Pugo
Mìng-chòng	Lito
Hāi-nàng	Hajnano
Háng-ngṳ̄ Pĭng-ĭng	Hanyu Pinyin
Uōng-dĕ̤ng	Fora Oriento
Băh-gák	Kolombo
Găng-sé̤ṳk	Gansuo
Taliban	Talibano
Huŏi-sáik	Griza
Sĭng-mêng-gé	Readmono
Sŭ-ciŭ	Suĝoŭo
Ŭng-ciŭ	Venĝou
Háng-cŭk	Hanoj
Nìng-pŏ̤	Ningbo
Chói-chiŭ	Barbo
Cāi-iêu	Kajto
Hăk-ī-bĭng	Harbino
Mā-kì	Hirudo
1000	1000 (nombro)
Mìng-só-gé	Nombroj
Cáu-sèng	Kuirejo
Hùng-nàng	Junano
Lō̤-uă	Korvo
Săng-dĕ̤ng	Ŝandongo
È̤ng-ĕ̤ng	Centpieduloj
Ò̤-nàng	Henano
Mì-mò̤	Brovo
Bók-sài	Umbiliko
Lièu-nìng	Ljaŭningo
Hióng-liông	Vektoro
Cretaceous	Kretaceo
Tochigi-gâing	Gubernio Toĉigi
Chói-mò̤-cēu	Alcededoj
Dàu	Ĵetpluredro
Cūi-nà̤	Cemento
Gék-lìng	Ĝilinio
Dĕ̤ng Dṳ̆ng-guók Hāi	Orientĉina Maro
Gūi	Fantomo
Bóng-dó̤	Rubo
Hù-nàng	Hunano
Jurassic	Ĵurasio
Chĭng-hāi	Ĉinghajo
Mì-ngù-ī-cŭk	Ujguroj
Ă-piéng	Opio
Chiū-cī	Fingroringo
Hù-báe̤k	Hubejo
Săng-să̤	Ŝanŝio
Cĕ̤ng-sáik	Bruna
Giòng-găng	Seksatenco
Gói-ciŭ	Gŭiĝoŭo
Triassic	Triaso
Sék-sáuk	Grilo
Cāi-piéu	Monbileto
SQL	SQL
Iók-cṳ̆-ā-gé	Josuo (libro)
Cŏng-cṳ̄	Ĝuangzio
Cṳ̀-hĭ Tái-hâiu	Ciŝji
Kan Naoto	Kan Naoto
Miyagi-gâing	Gubernio Mijagi
模板:Commons category	Ŝablono:Commonscat
Lò̤-mā Cṳ̆	Epistolo al la romanoj
Pău-ŭk-siáng	Parabolo (matematiko)
Dô̤-dáik	Moralo
Iwate-gâing	Gubernio Iŭate
Ĭ-siòng-chiă	Kudromaŝino
Dièu-siēng Lò̤-dông-dōng	Korea Laborista Partio
Chái Ĭ-lìng	Jolin Tsai
Pì-lĭk-bī Cṳ̆	Epistolo al la filipianoj
Ngā-gŏ-cṳ̆	Alta Kanto de Salomono
Mā-lăk-gĭ-cṳ̆	Libro de Malaĥi
模板:Taxobox	Ŝablono:Taksonomio
分類:Guók-uòng	Kategorio:Reĝoj
分類:Gŭng-ciō	Kategorio:Monarkoj
Diŏng Ngiê-mèu	Zhang Yimou
模板:Dṳ̆ng-guók lĭk-sṳ̄	Ŝablono:Historio de Ĉinio
Gĭng Céng-ŏng	Kim Ĝong-un
Céng-ngṳ̄	Ĵina lingvo
Gŏng-să̤	Ĝjangŝio
Nìng-hâ	Ningŝjao
Noda Yoshihiko	Joŝihiko Noda
Yingluck Shinawatra	Jinglak Ĉinaŭat
Siŏh-gă-cŏng	Ŝiĝjaĝŭango
Ciŏ-hāi	Ĝuhaj
Sáng-tàu	Ŝantoŭo
Dâng-gŏng	Ĝanczjan
Dĕ̤ng-uāng	Dongguan
Dièu-ciŭ	Ĉaoĝou
Tàng-táik	Katfiŝo
Gé̤ṳk-huă	Krizantemo
Sofie gì Sié-gái	La Mondo de Sofia
Ordovician	Ordovicio
Silurian	Silurio
Dāng-nòng	Gala veziko
Devonian	Devonio
Hók-ciŭ	Fuĝoŭo
Â-muòng	Sjamen
Ciŏng-ciŭ	Ĝanĝou
Să̤-nìng	Sinino
Să̤-iù-gé	Pilgrimado al la Okcidento
Săng-guók Iēng-ngiê	Tri regnoj
Cūi-hū	Ĉe akvorando
Ā-dŏng	Adamo (Biblio)
Aomori-gâing	Gubernio Aomori
Fukushima-gâing	Gubernio Fukuŝima
Tái-nguòng	Tajuano
Hải Phòng	Hai Phong
Dâi-lièng	Dalian
Hĭ-Pŏ̤ Ciéng-cĕng	Grek-persaj militoj
Permian	Permio
Cambrian	Kambrio
Iòng-ciók	Kandelo
Chiba-gâing	Gubernio Ĉiba
Pău	Pampelmuso
Lô-dáik-gé	Libro de Rut
Dáng-ī-lī	Libro de Danielo
Páuk-káik	Pokero
Mô̤	Ĉapelo
Gŏ̤-lìng-dŏ̤ Cièng Cṳ̆	1-a epistolo al la korintanoj
Aichi-gâing	Gubernio Ajĉi
Lī-ngṳ̀	Karpo
Muāng-ciŭ	Manĉurio
Sê̤ṳ-sṳ-gé	Juĝistoj (libro)
Pŏ̤-lìng-chái	Legoma spinaco
Akita-gâing	Gubernio Akita
Pièu-gĕng	Kulero
Dê̤ṳ	Manĝobastonetoj
Mĕ̤k-lê	Jasmeno
Gié-tiàng-chiă	Taksio
Â-hài	Mentono
Ibaraki-gâing	Gubernio Ibaraki
Lài-gŭng	Tondro
Siĕu-sŏng	Nitrata acido
Ngù-giāng-kó	Ĝinzo
Bō̤-siŏh	Gemo
Gáu-kuŏ-cṳ̆	Lernolibro
Chāu-māng	Lokusto
Diòng-chŭng	Ĉangĉuno
Milan Kundera	Milan Kundera
Lâung	Kokina ovo
Lĕ̤k-sé Sê̤ṳ-giông	Protestoj sur placo Tian An Men
Hù Iêu-băng	Hu Yaobang
Fukuda Yasuo	Fukuda Yasuo
Sṳ̀ng-chéu (Sṳ̀ng-báh)	Pinacoj
Gī-hò̤-chiă	Cirkelo
Táng-sŏng	Karbonata acido
Liòng-chióh	Liniilo
Chăng-màng-chṳ̄	Talpedoj
Dṳ̆ng-hâ Iâ cĭ Máe̤ng	Somermeznokta sonĝo
Mā-kō̤ Hók Ĭng	Evangelio laŭ Marko
Diê (dông-ŭk)	Ostro
Hwanghae Báe̤k-dô̤	Nord-Hŭanghae
P'yŏng'an Báe̤k-dô̤	Nord-Pjongan
Hamgyŏng Báe̤k-dô̤	Nord-Hamgjong
Hamgyŏng Nàng-dô̤	Sud-Hamgjong
P'yŏng'an Nàng-dô̤	Sud-Pjongan
Ryanggang Dô̤	Rjanggang
Nguòng-siĕu-uòng	Tangjŭano
Gĭng-dŭ	Gubernio Kioto
Ōsaka-hū	Gubernio Osaka
Cék-ngṳ̀	Orfiŝo (fiŝo)
Fukuoka-gâing	Gubernio Fukuoka
Ehime-gâing	Gubernio Ehime
Gŏ̤-lìng-dŏ̤, Hâiu Cṳ̆	2-a epistolo al la korintanoj
Gàu-ūng	Tervermo
Sā̤-ĭ-gĭ	Lavmaŝino
Gék	Mandarinujo
Gé̤ṳ	Segilo
Yamagata-gâing	Gubernio Jamagata
Éu-dê-huòng	Infanĝardeno
Lù-guói	Aloo
Yamaguchi-gâing	Gubernio Jamaguĉi
Kanagawa-gâing	Gubernio Kanagaŭa
Nagano-gâing	Gubernio Nagano
Iĕng-huă	Artfajraĵo
Mì-pŏ̤-lù	Mikroondilo
Saitama-gâing	Gubernio Sajtama
Mie-gâing	Gubernio Mie
Hĭ-báik-lài Cṳ̆	Epistolo al la hebreoj
Gă-lăk-tái Cṳ̆	Epistolo al la galatoj
Siŏng-dièu	Dinastio Shang
Gunma-gâing	Gubernio Gunma
Hyōgo-gâing	Gubernio Hjogo
Miyazaki-gâing	Gubernio Mijazaki
Kumamoto-gâing	Gubernio Kumamoto
Ă-cì	Cikadedoj
Koizumi Jun'ichirō	Koizumi Ĝuniĉiro
Liĕk-uòng-gé-liŏk Siông	1-a libro de la Reĝoj
Ī-sê̤ṳ-táik-cṳ̆	Libro de Ester
Diòng-dô-cṳ̆	Kohelet
Hatoyama Yukio	Hatojama Jukio
Gŏ̤-lò̤-să̤ Cṳ̆	Epistolo al la koloseanoj
Ngā-gáuk Cṳ̆	Epistolo de Jakobo
Iók-hâng Ék Cṳ̆	1-a epistolo de Johano
Pì-lé-muòng Cṳ̆	Epistolo al Filemono
Táik-sák-lò̤-nà̤-giă, Hâiu Cṳ̆	2-a epistolo al la tesalonikanoj
Táik-sák-lò̤-nà̤-giă Cièng Cṳ̆	1-a epistolo al la tesalonikanoj
Bī-dáik Cièng Cṳ̆	1-a epistolo de Petro
Bī-dáik Hâiu Cṳ̆	2-a epistolo de Petro
Tì-mò̤-tái Cièng Cṳ̆	1-a epistolo al Timoteo
Gifu-gâing	Gubernio Gifu
Ishikawa-gâing	Gubernio Iŝikaŭa
Nara-gâing	Gubernio Nara
Wakayama-gâing	Gubernio Ŭakajama
Shizuoka-gâing	Gubernio Ŝizuoka
Shiga-gâing	Gubernio Ŝiga
Iók-hâng Nê Cṳ̆	2-a epistolo de Johano
Ī-suói-ā-cṳ̆	Libro de Jesaja
Iók-hâng Săng Cṳ̆	3-a epistolo de Johano
Iù-dâi Cṳ̆	Epistolo de Judaso
Tì-mò̤-tái Hâiu Cṳ̆	2-a epistolo al Timoteo
Tì-dŏ̤ Cṳ̆	Epistolo al Tito
Nùng-mìng	Terkultivisto
Ià-lé-mī-cṳ̆	Libro de Jeremia
Ī-sê̤ṳ-lá-cṳ̆	Libro de Ezra
Nà̤-hĭ-mī-cṳ̆	Libro de Neĥemja
Iók-ngī-cṳ̆	Libro de Joel
Băh-lô	Malgranda egretardeo
Chŭng-cáik	Ĉina novjara festo
Sō-siè	Ŝlosilo
Abe Shinzō	Abe Shinzo
Asō Tarō	Aso Taro
Séng-cṳ̆-tā̤	Hieroglifoj
Niigata-gâing	Gubernio Niigata
Yamanashi-gâing	Gubernio Jamanaŝi
Shimane-gâing	Gubernio Ŝimane
Toyama-gâing	Gubernio Tojama
Okayama-gâing	Gubernio Okajama
Kă-tōi	Kruro
Piăng	Dorso
Piĕ	Letero
Sáik-màng	Kolorblindeco
Carboniferous	Karbonio
Fukui-gâing	Gubernio Fukui
Ōita-gâing	Gubernio Oita
Tottori-gâing	Gubernio Tottori
Nùng-lĭk	Ĉina kalendaro
Kōchi-gâing	Gubernio Koĉi
Chèng-gēng	Silkraŭpo
Páuk Gê̤ṳng-hiê	Park Geun-hye
Dài-nàng	Tajnan
Cĕng	Kudrilo
Muāng-cŭk	Manĉuroj
Kìng-giāng	Pinĉilo
Anna Karenina	Anna Karenina
Tiè-mà	Ploro
Swadesh hŏk-sĭng-sṳ̀ liĕk-biēu	Listo Swadesh
Dŭng-nìng-guók	Reĝlando de Tungning
Kă-cāi	Piedfingro
Lāng	Salivo
Diò-să-hô	Kuiristo
Bĭng-lòng	Kateĉuareko
Băng-sièng Lā-mà	Panĉen-lamao
Muòi-huă	Umeo
Muòi-kṳ̄ng	Ŝimo
Gĭng-cá̤	Ekonomio
Sĕ̤ng-săng-giāng	Ĝemelo
Nguòng-cṳ̄-bék	Globkrajono
Norodom Sihanouk	Norodom Sianuk
Saga-gâing	Gubernio Saga
Tokushima-gâing	Gubernio Tokuŝima
Lòng-dâung	Nigra hiskiamo
Lòi-sĭ-gā	Ŝraŭboturnilo
Sĭk-sĭk	Flugilo
Kagawa-gâing	Gubernio Kagaŭa
Thaksin Shinawatra	Taksin Ĉinaŭat
Kê	Diospiro
Săng-guók (Dièu-siēng)	Tri Antikvaj Regnoj de Koreio
Bék	Plumo (skribilo)
Huăng-siŏh-liù	Psidium guajava
Duâi-tàu-giáng	Lupeo
Puái-dáu	Tagmezo
Huōi-căi	Incendio
Chiū-ló̤h	Ganto
Nagasaki-gâing	Gubernio Nagasaki
Hâ-dièu	Dinastio Xia
Cá̤-nàng	Ĝinano
Dṳ̆ng-guók Káung-nĭk Ciéng-cĕng	Dua japana-ĉina milito
Sarawak	Saravako
Hŭng-cūi	Fengŝuo
Chiéu	Rido
Oda Nobunaga	Oda Nobunaga
Dăng-hù	Koralo
Lī Sìng-uāng	Ji Sung-man
Iòng-bék-chó̤	Skrapogumo
Nàng-chiŏng	Nanĉano
Tokugawa Ieyasu	Tokugawa Ieyasu
Bók-séu-gáung	Rustorezista ŝtalo
Sáu-chiū	Balailo
Kŭng-dièu	Klimatizilo
Diòng-să	Ĉangŝa
Pèng	Farbo
Kă-âu-dăng	Kalkano
Ā-mò̤-sê̤ṳ-cṳ̆	Libro de Amos
Ŏ̤-bă-dī-ā-cṳ̆	Libro de Obadja
Itō Hirobumi	Ito Hirobumi
Nguŏh	Jado
Dâu-hô	Tofuo
Mì-hèu	Makako
Mī-giă-cṳ̆	Libro de Miĥa
Bù-sák	Bodhisatvo
Hăk-gĭ-cṳ̆	Libro de Ĥagaj
Ī-să̤-giék	Libro de Jeĥezkel
Chiū-biēu	Brakhorloĝo
Iók-nā-cṳ̆	Libro de Jona
Sabah	Sabaho
Ià-lé-mī-ăi-gŏ̤	Libro de la Plorkanto
Tái-gáng	Eŭnuko
Nàng-nìng	Naningo
Ê-só	Ununatria glutamato
Nā-ŭng-cṳ̆	Libro de Naĥum
Hăk-bă-gók-cṳ̆	Libro de Ĥabakuk
Sák-gā-lé-ă-cṳ̆	Zeĥarja (libro)
Guók-gê̤ṳng Nô̤i-ciéng	Ĉina enlanda milito
Uŏk-nàng Gê̤ṳng-huò-guók	Vjetnama respubliko
Chiĕu-chê	Superbazaro
Ciŏng Cṳ̄-ì	Zhang Ziyi
Lák-tàu	Kalveco
Gulliver Lṳ̄-hèng-gé	La vojaĝoj de Gulivero
Gŏ̤-hṳ̀ng	Kaoŝiung
Naha-chê	Naha
Buŏk-hāi	Bohaj-maro
Báh-chói	Oscedo
Putrajaya	Putraĝajo
Kŏng-mìng	Kunmingo
Jane Eyre	Jane Eyre
Johor	Ĝohoro
Ngâung	Intelekta malkapablo
Huòi-cŭk	Hujoj
Làng-ciŭ	Lanĝoŭo
Hŏ̤-să̤-cṳ̆	Libro de Hoŝea
Tiék-cĭng	Rusto
Săng-guók	Tri reĝlandoj
Ciéng-guók Sì-dâi	Militŝtata periodo
Puō-ngì	Pu Ji
Mā-lăk-gă	Malako
Oracle	Oracle
Hăk-bùi	Hefejo
Huák-lùng-gŭng	Falun Gong
Kelantan	Kelantano
Lŏk-iòng	Lŭojango
Toyotomi Hideyoshi	Toyotomi Hideyoshi
Câung-cŭk	Tibetanoj
Pulau Pinang	Penango
Să̤-huăng-ngā-cṳ̆	Libro de Cefanja
Dâi-nĭk-buōng Dá̤-guók	Japana Imperio
Hṳ̆ng-nù	Ŝiungnuoj
Mâing-cṳ̄	Menceo
Kedah	Kedaho
Perak	Perako
Hŏk-ôi	Akademia titolo
Gié-lìng	Gujlin
Terengganu	Terengganuo
Selangor	Selangoro
Iòng (dông-ŭk)	Kaprenoj
Hāi-kāu	Hajkoŭo
Chāu-buōng sĭk-ŭk	Herbo
Pahang	Pahango
Chiông-gì	Ĉina ŝako
Yun Chi-ho	Yun Chi-ho
Gói-iòng	Gŭijango
Ngù Dìng-iēng	Ngô Đình Diệm
Gô-dā̤	Pasinteco
Miêng	Nudelo
Hiêng-câi	Estanteco
Lèng-gēng	Dimocarpus longan
Mì-lĕk-hŭk	Majtrejo
Guăng-ĭng	Avalokiteŝvaro
Gēu-gī	Lycium barbarum
Lĕ̤k-dèu-gáuk	Ripo
Nguŏk-biāng	Lunkuko
Ció-ĭng Hù-hô̤	Bopomofo
Pàng-hù-gâing	Penghuoj
Tù-kēng	Talpogrilo
Dṳ̆ng-guók Ìng-mìng Gāi-huóng-gŭng	Popola Liberiga Armeo
Sìng-ū Tiĕng-huòng	Ĝimmu
Ciē-chái	Nori
Dennis Rodman	Dennis Rodman
È̤ng-dà	Nigra teo
Cò̤ Chó̤	Cao Cao
Tài-tàu	Senkapigo
Buŏi	Flugo
Ŭi-nà̤-sṳ̆ Sĕng-lī-nè̤ng	La venecia komercisto
Ŭ-sŭ-lī-gĕ̤ng	Ussuri
Dĕ̤ng-cé	Vintra solstico
Tiĕng-huòng	Imperiestro de Japanio
Kăi-hŭng	Kaifeng
Sĭng-dài-bê	Nova tajvana dolaro
Sák-mū-ngī-gé-hâiu-cṳ̆	2-a libro de Samuel
Lăk-dâi-cé-liŏk Hâ	2-a libro de la Kroniko
Liĕk-uòng-gé-liŏk Hâ	2-a libro de la Reĝoj
John Wesley	John Wesley
Perlis	Perliso
Negeri Sembilan	Negeri-Sembilano
Labuan	Labuano
Iòng-iù-gàu	Kerosena lampo
Gĭng-cŭk	Vjetnamoj
Uōng-dâi Cièng-tiàng	Grandaj Anticipoj
Niōng-bēng	Plafono (arkitekturo)
Rasŏn	Rason
Ŭ-gŭi	Testuduloj
Tá̤	Tirkesto
Gê̤ṳng-huò-dōng	Respublika partio
Bō̤-dâi Huòng-dá̤	Bảo Đại
Siê-iù	Sojsaŭco
Ŭ-lṳ̀ng-dà	Ŭulong-teo
Huōi-lṳ̀ng-guō	Drakofrukto
Gê̤ṳng-sāng-dōng	Komunista partio
Băh-cṳ̄ng-nè̤ng	Blankulo
Ciŭ Giĕk-lùng	Jay Chou
Orhan Pamuk	Orhan Pamuk
Carpineto Romano	Carpineto Romano
Cō̤	Jujubarbo
Sĭng-báe̤k	Novtajpeo
Dài-dṳ̆ng	Tajĉung
Ngiè	Bredansero
Dièu-siēng Gŏ̤-cŭng	Goĝong de Koreio
Gáuk-gáuk	Osto
Diêng-tù	Pilo
Gê̤ṳ-gê̤ṳ	Lambastono
Hù-lì-mà	Kolonoko
Gŏ̤-ák-guŏ	Premmarmito
Chagang Dô̤	Ĉagang
Băh-cŭk	Bajoj
Siông Cĭng	Ŝo Ŝin
Ngù-mō̤-ngù-giāng	Heliko
Takeshi Kaneshiro	Kaneshiro Takeshi
Uòng Mì	Wang Wei
Dŭng-huòng	Dunhuang
Hiŏng-iòng-guă	Ĉajoto
Dài-uăng Mìng-ciō-guók	Respubliko de Tajvano (1895)
Seo Jae-pil	Philip Jaisohn
Guók-ngṳ̄	Nacia lingvo
Hiŏng-gŭ	Ŝitako
Mŭk-ngī	Judasorelo
Sā̤-tŏng	Bano
Páuk Hièng-īng	Park Heon-young
Dièu-siēng Sié-cū	Sejo de Joseon
Gĭng-kiŏk	Pekina opero
Hŭng-sṳ̆k	Konvencio
Biék	Molkarapacaj testudoj
Báik-nguŏk-cáik	Luna Festo
Liŏh-chiông-gĭ	Magnetoskopo
Gā-cō̤	Pulo
Mā-tái Hók Ĭng	Evangelio laŭ Mateo
Sĕk-cê-gá	Kristana kruco
Tè̤ng-chō̤	Ophiocordyceps sinensis
Ī-hók-sū Cṳ̆	Epistolo al la efesanoj
Dṳ̆ng-huà Mìng-guók Guók-gŭng	Armeo de la Respubliko de Ĉinio
Sṳ̀ng-chéu (Hók-ciŭ chê-chéu)	Banjano
Cṳ̀-ciŏng	Kahelo
Ók-dāu	Gladilo
Liŏh-dà	Verda teo
Liŏh-dâu	Mungfabo
Dièu-siēng-cŭk	Koreoj
Yu Kil-chun	Yu Gil-jun
Kŭmgang-săng Guăng-guŏng Dê-kṳ̆	Turisma Regiono Kumgangsan
Páuk Dṳ̀ng-iòng	Park Jung-yang
Hòng-ciŭ Să̤-hù	Okcidenta Lago (Hangĝoŭo)
Hŭ-huò-hô̤-dĕk	Hoĥoto
Hà-iù	Fiŝsaŭco
Băh-ngiê	Termito
Ngièng Hók	Yan Fu
Hṳ̆ng-dòng	Torako
Ìng-cṳ̄	Filo de homo
Hiroshima-gâing	Gubernio Hiroŝima
Hwanghae Nàng-dô̤	Sud-Hŭanghae
Dùng-cé	Kamarado
Hŭng-tiŭ	Bicikla pumpilo
Bâng-ā	Muteco
Cò̤ Sĭk	Cao Zhi
Mìng-nàng-nè̤ng	Hokloj
Dièu-siēng Buáng-dō̤ lĭk-sṳ̄	Historio de Koreio
Cáe̤ng	Zongzio
Sinŭiju Dĕk-biék Hèng-céng-kṳ̆	Speciala Administra Regiono Sinuiju
Dìng Gīng-ê̤ṳng	Chen Jingrun
ISO 639-1	ISO 639-1
Huá-huá	Kresta akridotero
Mī-hūng	Riznudeloj
Hók-gióng tū-làu	Tulou
Chĭng-mìng	Qingming
Nê-hù	Erhuo
Pū-tŭng-uâ	Norma ĉina lingvo
Mĭk-pŭng	Abeledoj
Okinawa-gâing	Gubernio Okinavo
Nàng-ā	Suda Azio
Ŭ-cṳ̄ng-nè̤ng	Nigrulo
Nàng-uŏk-guók	Nanjueo
Hâ-uă	Eva
Chèng-chṳ̄	Arvikolenoj
Kiŏng-cŭk	Ĉiangoj
Chèng	Plugebla tero
Wiki Bô-lâung-diòng	Vikimedia Kovilo
Wikipedia:Sū-iū ngṳ̄-ngiòng bēng-buōng gì Wikipedia	Vikipedio:Internacia Vikipedio
À̤-liák	Pantoflo
Ôi	Stomako
Hāi-gēu	Felfoko
Cṳ̆-dó̤h	Skribotablo
Cáik-ké	Suna Periodo
Dṳ̀-huák	Divido
Hù-lù	Lagenario
分類:Dáik-guók	Kategorio:Germanio
分類:É-dâi-lé	Kategorio:Italio
分類:Mī-guók	Kategorio:Usono
分類:Ngò̤-lò̤-sṳ̆	Kategorio:Rusio
分類:Dṳ̆ng-guók	Kategorio:Ĉinio
分類:Nĭk-buōng	Kategorio:Japanio
分類:Ó̤-ciŭ	Kategorio:Aŭstralio
分類:Éng-nà̤	Kategorio:Indonezio
分類:Hàng-guók	Kategorio:Sud-Koreio
分類:Tái-guók	Kategorio:Tajlando
分類:Uŏk-nàng	Kategorio:Vjetnamio
分類:Buô-ṳ̄ dông-ŭk	Kategorio:Mamuloj
分類:Bà-hèng dông-ŭk	Kategorio:Reptilioj
分類:Cēu	Kategorio:Birdoj
分類:Cĭng-kṳ̄ng	Kategorio:Fungoj
分類:Sĭk-ŭk	Kategorio:Plantoj
分類:Ŭk-lī	Kategorio:Fiziko
分類:Huá-hŏk	Kategorio:Kemio
分類:Lĭk-sṳ̄	Kategorio:Historio
分類:Dê-lī	Kategorio:Geografio
分類:Siâ-huôi	Kategorio:Socio
分類:Mī-sŭk	Kategorio:Vidaj artoj
分類:Cŭng-gáu	Kategorio:Religio
分類:Tā̤-ṳ̆k	Kategorio:Sporto
分類:Kuŏ-hŏk	Kategorio:Scienco
分類:Gióng-dé̤ṳk-ŭk	Kategorio:Konstruaĵoj
Gū Lò̤-mā	Romio
Regina Duarte	Regina Duarte
Cūi-kì	Limako
分類:Sĕng-tái	Kategorio:Ekologio
Sák-mū-ngī-gé-cièng-cṳ̆	1-a libro de Samuel
分類:Disambig	Kategorio:Apartigiloj
分類:Diék-hŏk	Kategorio:Filozofio
分類:Sĭng-lī	Kategorio:Psikologio
分類:Hŭk-gáu	Kategorio:Budhismo
分類:Gĭ-dók-gáu	Kategorio:Kristanismo
分類:Ĭ-sṳ̆-làng-gáu	Kategorio:Islamo
分類:Iù-tái-gáu	Kategorio:Judismo
Hô-dê̤ṳ	Jubo
Gùng	Jupo
Iraq gâe̤ng Levant Ĭ-sṳ̆-làng-guók	Islama Ŝtato de Irako kaj Sirio
Dâu-mò̤-chái	Mungidoj
Hèu Dáik-bōng	Hoŭ Debang
Tău-dò̤-nó̤h	Ŝtelo
Ciĕ-muài	Hindia sezamo
分類:Ùng-huá	Kategorio:Kulturo
分類:Dê-cék	Kategorio:Geologio
模板:Tái-iòng-hiê	Ŝablono:Sunsistemo
Gâng	Ŝvito
Ià-huò-huà	Jehovo
Sók-lŭk	Rapido
Ák	Anaso
Duâi-tàu-chái	Rapo
Huăng-siông	Mangarbo
分類:Dáik-guók ìng-ŭk	Kategorio:Germanoj
分類:Mī-guók ìng-ŭk	Kategorio:Usonanoj
分類:Iēng-uòng	Kategorio:Aktoroj
分類:Ĭng-guók ìng-ŭk	Kategorio:Britoj
分類:Huák-guók ìng-ŭk	Kategorio:Francoj
模板:Chess diagram	Ŝablono:Ŝakdiagramo
模板:Tl	Ŝablono:Ŝ
分類:Guók-gă	Kategorio:Landoj
Wikipedia:Hèng-céng Ìng-uòng	Vikipedio:Administrantoj
分類:Dṳ̆ng-guók mìng-cŭk	Kategorio:Etnoj en Ĉinio
分類:Ìng-ŭk	Kategorio:Personoj
分類:Cék-ngiĕk	Kategorio:Profesioj
Wikipedia:Gĭ-ké-nè̤ng	Vikipedio:Roboto
分類:Sì-găng	Kategorio:Tempo
分類:Gĕ̤ng-tiàng	Kategorio:Inĝenierarto
分類:Cài-lâiu	Kategorio:Materialoj
分類:Ĭ-hŏk	Kategorio:Medicino
分類:Céng-dê	Kategorio:Politiko
分類:Gáu-ṳ̆k	Kategorio:Edukado
Ăi-gĭk	Egiptujo
模板:Bot	Ŝablono:Bot
Gă-nā-dâi	Kanado
分類:Iù-hié	Kategorio:Ludoj
分類:Ĕu-ciŭ guók-gă	Kategorio:Eŭropaj landoj
分類:Ĕu-ciŭ	Kategorio:Eŭropo
模板:Documentation	Ŝablono:Dok
分類:Ê̤ṳng-hô	Kategorio:Vikipediistoj laŭ lingvo
Sìng Câi-gĭ	Sung Jae-gi
模板:Softredirect	Ŝablono:Intervikia plusendilo
Wikipedia:維基數據	Vikipedio:Vikidatumoj
模板:Chēng	Ŝablono:Forigu tuj
分類:Ngṳ̄-ngiòng	Kategorio:Lingvoj
分類:Lĭk-huák	Kategorio:Kalendaro
分類:Wikipedia	Kategorio:Vikipedio
Wikipedia:Mò̤ hô-cáik sĭng-mìng	Vikipedio:Malgarantio
分類:未索引其頁面	Kategorio:Neindeksitaj paĝoj
Dâi-chṳ̄	Kanguruo
模板:!	Ŝablono:!
模板:!-	Ŝablono:!-
模板:Smallcaps	Ŝablono:Etmajuskloj
模板:Nowrap	Ŝablono:Nrsp
Wikipedia:Ék-chiék Wikipedia dŭ găi-dŏng ô gì ùng	Vikipedio:Listo de havendaj artikoloj
分類:Hĭ-ciŭ	Kategorio:Afriko
模板:Wikisource	Ŝablono:Vikifontaro
模板:Babel	Ŝablono:Babelejo
模板:Commons	Ŝablono:Commons
模板:Reflist	Ŝablono:Referencoj
Wikipedia:列明來源	Vikipedio:Citi fontojn
模板:Stub	Ŝablono:Ĝermo
模板:User eo-1	Ŝablono:Vikipediisto eo-1
模板:User eo-3	Ŝablono:Vikipediisto eo-3
模板:User de	Ŝablono:Vikipediisto de
模板:User de-1	Ŝablono:Vikipediisto de-1
模板:User es	Ŝablono:Vikipediisto es
模板:User de-3	Ŝablono:Vikipediisto de-3
模板:User en-3	Ŝablono:Vikipediisto en-3
模板:User en-1	Ŝablono:Vikipediisto en-1
模板:User en-2	Ŝablono:Vikipediisto en-2
模板:User eo-2	Ŝablono:Vikipediisto eo-2
模板:User en-4	Ŝablono:Vikipediisto en-4
模板:User en	Ŝablono:Vikipediisto en
模板:User de-2	Ŝablono:Vikipediisto de-2
模板:User es-1	Ŝablono:Vikipediisto es-1
模板:User fr-1	Ŝablono:Vikipediisto fr-1
模板:User it-3	Ŝablono:Vikipediisto it-3
模板:User ja	Ŝablono:Vikipediisto ja
模板:User ja-1	Ŝablono:Vikipediisto ja-1
模板:User it-1	Ŝablono:Vikipediisto it-1
模板:User fr	Ŝablono:Vikipediisto fr
分類:Ā-ciŭ	Kategorio:Azio
分類:Nàng Mī-ciŭ	Kategorio:Sudameriko
分類:Mā-lài-să̤-ā	Kategorio:Malajzio
模板:Mod	Ŝablono:Mod
模板:SIL	Ŝablono:ISO639-3 ligilo
模板:User it	Ŝablono:Vikipediisto it
模板:User es-2	Ŝablono:Vikipediisto es-2
模板:Huăng-ngìng	Ŝablono:Bonvenon
模板:Click	Ŝablono:Ligo el bildo
分類:User fr-1	Kategorio:Vikipediisto fr-1
模板:Image label	Ŝablono:Marko sur bildo
模板:Wiki gĕ̤ng-tiàng	Ŝablono:Vikimedia fondaĵo
模板:Steady	Ŝablono:Sama
模板:Guók-gă	Ŝablono:Informkesto lando
模板:Cite journal	Ŝablono:Citaĵo el gazeto
模板:Infobox 公司	Ŝablono:Informkesto firmao
模板:Wikibooks	Ŝablono:Vikilibroj
模板:Hō̤ gì ùng-ciŏng	Ŝablono:Elstara
分類:User en-4	Kategorio:Vikipediisto en-4
分類:User en	Kategorio:Vikipediisto en
分類:User zh	Kategorio:Vikipediisto zh
分類:User zh-M	Kategorio:Vikipediisto zh-D
分類:User en-2	Kategorio:Vikipediisto en-2
模板:Infobox	Ŝablono:Informkesto
模板:User eo	Ŝablono:Vikipediisto eo
模板:User zh	Ŝablono:Vikipediisto zh
分類:Gáuk-guók gì lĭk-sṳ̄	Kategorio:Historio laŭ landoj
模板:Legend	Ŝablono:Priskribo
模板:Cite web	Ŝablono:Citaĵo el la reto
分類:Īng-sĭk	Kategorio:Kuirarto
分類:Săng	Kategorio:Montoj
模板:IPA	Ŝablono:IFA
分類:Céng-dê-gă	Kategorio:Politikistoj
分類:Mī-ciŭ	Kategorio:Ameriko
分類:Gáuk-guók gì ìng-ŭk	Kategorio:Homoj laŭ nacioj
模板:Wiki-huá	Ŝablono:Vikiigenda
分類:Gŭng-sê̤ṳ	Kategorio:Armitaj fortoj
模板:Increase	Ŝablono:Kresko
模板:User nl	Ŝablono:Vikipediisto nl
模板:Infobox 網站	Ŝablono:Informkesto retejo
模板:Decrease	Ŝablono:Falo
模板:User no-2	Ŝablono:Vikipediisto no-2
模板:Image label end	Ŝablono:Marko sur bildo fino
模板:Documentation subpage	Ŝablono:Ŝablona navigado
模板:Lang-la	Ŝablono:Lang-la
分類:Cìng-gāng	Kategorio:Emocioj
模板:Userpage	Ŝablono:Uzula paĝo
模板:Non-free logo	Ŝablono:Emblemo
模板:User	Ŝablono:Uzanto2
模板:Image label small	Ŝablono:Marko sur bildo malgranda
模板:User fr-3	Ŝablono:Vikipediisto fr-3
模板:Gô-dā̤ gì guók-gă	Ŝablono:Informkesto pereinta ŝtato
Wikipedia:Tiăng-dŏng	Vikipedio:Diskutejo/Neesperanto
分類:User ja-M	Kategorio:Vikipediisto ja-D
模板:Gì-ngiê	Ŝablono:Apartigilo
分類:Dièu-siēng lĭk-sṳ̄	Kategorio:Historio de Koreio
模板:User no-3	Ŝablono:Vikipediisto no-3
模板:User nan	Ŝablono:Vikipediisto zh-min-nan
模板:User nan-1	Ŝablono:Vikipediisto zh-min-nan-1
模板:Lang-grc	Ŝablono:Lang-grc
模板:User ksh	Ŝablono:Vikipediisto ksh
模板:AUS	Ŝablono:AUS
模板:Lifetime	Ŝablono:Vivtempo
模板:Lang-en	Ŝablono:Lang-en
分類:Sĕng-ŭk	Kategorio:Vivaĵoj
模板:User la-1	Ŝablono:Vikipediisto la-1
分類:User fr	Kategorio:Vikipediisto fr
分類:User ja	Kategorio:Vikipediisto ja
分類:User la	Kategorio:Vikipediisto la
分類:User fr-3	Kategorio:Vikipediisto fr-3
分類:User it-3	Kategorio:Vikipediisto it-3
分類:User ja-3	Kategorio:Vikipediisto ja-3
分類:User fr-2	Kategorio:Vikipediisto fr-2
分類:User it-2	Kategorio:Vikipediisto it-2
分類:User ja-2	Kategorio:Vikipediisto ja-2
分類:User la-2	Kategorio:Vikipediisto la-2
分類:User ko-M	Kategorio:Vikipediisto ko-D
分類:User fr-M	Kategorio:Vikipediisto fr-D
分類:User it-M	Kategorio:Vikipediisto it-D
分類:User nl-M	Kategorio:Vikipediisto nl-D
分類:Ùng-cê	Kategorio:Skribsistemoj
分類:Dô̤-gáu	Kategorio:Taoismo
分類:Dō̤	Kategorio:Insuloj
分類:User de	Kategorio:Vikipediisto de
分類:User de-2	Kategorio:Vikipediisto de-2
分類:User de-3	Kategorio:Vikipediisto de-3
分類:User de-M	Kategorio:Vikipediisto de-D
分類:User en-3	Kategorio:Vikipediisto en-3
分類:User en-M	Kategorio:Vikipediisto en-D
分類:User es	Kategorio:Vikipediisto es
分類:User es-1	Kategorio:Vikipediisto es-1
分類:User es-2	Kategorio:Vikipediisto es-2
分類:User es-3	Kategorio:Vikipediisto es-3
分類:User es-M	Kategorio:Vikipediisto es-D
分類:Chió	Kategorio:Domo
分類:User it	Kategorio:Vikipediisto it
分類:User it-1	Kategorio:Vikipediisto it-1
分類:User ja-1	Kategorio:Vikipediisto ja-1
分類:User ko	Kategorio:Vikipediisto ko
分類:Mī-guók gì ciŭ	Kategorio:Usonaj ŝtatoj
分類:User ko-1	Kategorio:Vikipediisto ko-1
分類:User ko-2	Kategorio:Vikipediisto ko-2
分類:User ko-3	Kategorio:Vikipediisto ko-3
分類:User ksh	Kategorio:Vikipediisto ksh
分類:User ksh-M	Kategorio:Vikipediisto ksh-D
分類:User la-1	Kategorio:Vikipediisto la-1
分類:User la-3	Kategorio:Vikipediisto la-3
模板:Distinguish	Ŝablono:Ne konfuzu
模板:Information	Ŝablono:Informo por dosiero
分類:Huâng-cô̤i	Kategorio:Kriminaleco
Sáik-mō̤	Laŭso
分類:Séng-sék	Kategorio:Informadiko
分類:Hāi	Kategorio:Maroj
Hŭng-siéng	Ventolilo
分類:Guōng-dĕ̤ng	Kategorio:Gŭangdongo
分類:Hók-gióng	Kategorio:Fuĝjano
分類:Gĭng-cá̤	Kategorio:Ekonomio
分類:Ciék-ciĕ dông-ŭk	Kategorio:Artropodoj
分類:User nan	Kategorio:Vikipediisto zh-min-nan
分類:Hĭ-ciŭ guók-gă	Kategorio:Afrikaj landoj
分類:Gáuk-guók gì gáu-ṳ̆k	Kategorio:Edukado laŭ landoj
模板:User ja-2	Ŝablono:Vikipediisto ja-2
模板:User ja-3	Ŝablono:Vikipediisto ja-3
分類:User vi	Kategorio:Vikipediisto vi
分類:User vi-M	Kategorio:Vikipediisto vi-D
分類:Ĭng-ngŏk-gă	Kategorio:Muzikistoj
模板:Lang	Ŝablono:Lang
分類:Hŏk-sŭk	Kategorio:Universitato
Bì-bà (ngŏk-ké)	Ĉinbivo (Pipa)
分類:Wikimedia gĕ̤ng-tiàng	Kategorio:Projektoj de la Fondaĵo Vikimedio
分類:Gì-lôi	Kategorio:Abstraktaj tabulludoj
模板:Infobox Language/family-color	Ŝablono:Informkesto lingvo/Koloro
分類:Ò̤	Kategorio:Riveroj
模板:User no-1	Ŝablono:Vikipediisto no-1
模板:User zh-1	Ŝablono:Vikipediisto zh-1
模板:User zh-2	Ŝablono:Vikipediisto zh-2
模板:User zh-3	Ŝablono:Vikipediisto zh-3
分類:Dâi-hàng Mìng-guók ìng-ŭk	Kategorio:Sudkoreanoj
分類:Sôi-diēng ìng-ŭk	Kategorio:Svedoj
分類:Nĭk-buōng ìng-ŭk	Kategorio:Japanoj
分類:Dài-uăng ìng-ŭk	Kategorio:Tajvananoj
分類:User nl	Kategorio:Vikipediisto nl
分類:User zh-1	Kategorio:Vikipediisto zh-1
分類:User zh-3	Kategorio:Vikipediisto zh-3
分類:User zh-2	Kategorio:Vikipediisto zh-2
分類:Cāi	Kategorio:Paperoj
分類:Ông-ò̤	Kategorio:Kanaloj
分類:Uŏk-nàng ìng-ŭk	Kategorio:Vjetnamoj
分類:Ngò̤-lò̤-sṳ̆ ìng-ŭk	Kategorio:Rusoj
分類:Ciĕk-káik ìng-ŭk	Kategorio:Ĉeĥoj
分類:Tái-guók ìng-ŭk	Kategorio:Tajlandanoj
分類:Sáng	Kategorio:Familiaj nomoj
分類:Dièu-siēng Mìng-ciō-ciō-ngiê Ìng-mìng Gê̤ṳng-huò-guók	Kategorio:Nord-Koreio
分類:Dṳ̆ng-guók ìng-ŭk	Kategorio:Ĉinoj
分類:Dièu-siēng	Kategorio:Koreio
分類:Dài-uăng	Kategorio:Tajvano
分類:Dièu-siēng Mìng-ciō-ciō-ngiê Ìng-mìng Gê̤ṳng-huò-guók ìng-ŭk	Kategorio:Nordkoreanoj
分類:Liù-giù-guók	Kategorio:Rjukju-reĝlando
分類:Dâi-iòng-ciŭ guók-gă	Kategorio:Oceaniaj landoj
分類:Báe̤k Mī-ciŭ guók-gă	Kategorio:Nordamerikaj landoj
分類:Ngṳ̀	Kategorio:Fiŝoj
分類:Cūi-guō	Kategorio:Fruktoj
分類:Niōng-tā̤ dông-ŭk	Kategorio:Moluskoj
分類:Só-cê	Kategorio:Nombrosistemoj
分類:Gióng-dé̤ṳk cài-lâiu	Kategorio:Konstrumaterialoj
分類:Dông-ŭk	Kategorio:Bestoj
分類:Ciáh-tùi dông-ŭk	Kategorio:Vertebruloj
分類:Guòng-lé	Kategorio:Rajtoj
分類:Ìng-guòng	Kategorio:Homaj rajtoj
分類:Ū-ké	Kategorio:Armiloj
分類:Nàng Mī-ciŭ guók-gă	Kategorio:Sudamerikaj landoj
分類:Gă-sĭ	Kategorio:Mebloj
分類:Ké-chiông	Kategorio:Meteologio
分類:Dṳ̆ng Mī-ciŭ	Kategorio:Mezameriko
分類:Hiŏng-gē̤ng	Kategorio:Honkongo
分類:Ĭ-siòng	Kategorio:Vestoj
分類:Cáik-nĭk	Kategorio:Festivaloj
分類:Kuàng-ciék dông-ŭk	Kategorio:Anelidoj
分類:Bâng	Kategorio:Malsanoj
分類:Kiŏng-diòng dông-ŭk	Kategorio:Kniduloj
分類:Gùng-dō̤	Kategorio:Insularoj
分類:Káh-dièu-nó̤h	Kategorio:Ludiloj
分類:Gă-dìng	Kategorio:Familio
分類:Dṳ̆ng-guók huòng-dá̤	Kategorio:Imperiestroj de Ĉinio
分類:Huòng-dá̤	Kategorio:Imperiestroj
分類:Báe̤k Mī-ciŭ	Kategorio:Nordameriko
分類:Gŏ̤-chiū	Kategorio:Kantistoj
分類:Hù	Kategorio:Lagoj
分類:Só-hŏk-gă	Kategorio:Matematikistoj
模板:Infobox ngṳ̄-ngiòng	Ŝablono:Informkesto lingvo
分類:Dâi-iòng-ciŭ	Kategorio:Oceanio
分類:Tiĕng-căi	Kategorio:Naturkatastrofoj
分類:Gô-dā̤ gì guók-gă	Kategorio:Pereintaj landoj
Cāi-puŏi	Kartono
分類:Giông-kŏng	Kategorio:Sano
分類:Sĕng-lī	Kategorio:Fiziologio
Trojany	Trojany
模板:Infobox color	Ŝablono:Informkesto koloro
分類:Ā-ciŭ guók-gă	Kategorio:Aziaj landoj
分類:Mī-ciŭ guók-gă	Kategorio:Amerikaj landoj
模板:User yue-2	Ŝablono:Vikipediisto zh-yue-2
模板:User nan-2	Ŝablono:Vikipediisto zh-min-nan-2
分類:Huák-lŭk	Kategorio:Leĝaro
分類:Dṳ̆ng Mī-ciŭ guók-gă	Kategorio:Centramerikaj landoj
分類:Ôi-sĕng	Kategorio:Higieno
分類:Dṳ̆ng-huà Mìng-guók	Kategorio:Respubliko Ĉinio
模板:Image label begin	Ŝablono:Marko sur bildo komenco
模板:Dṳ̆ng-huà Mìng-guók Hèng-céng-kṳ̆	Ŝablono:Administra divido de Tajvano
分類:Sĕng-uăk	Kategorio:Ĉiutaga vivo
Uòng-pŭng	Vespo
模板:User vi	Ŝablono:User vi
分類:User en-1	Kategorio:Vikipediisto en-1
分類:User de-1	Kategorio:Vikipediisto de-1
分類:Gă-sĭ-huă	Kategorio:Iloj
Lăk-dâi-cé-liŏk Siông	1-a libro de la Kroniko
分類:Mìng-cŭk	Kategorio:Etna identeco
Liù-giù	Rjukju-insularo
模板:User nan-3	Ŝablono:Vikipediisto zh-min-nan-3
Hāi-chái	Laminario
Hù-diĕk	Rhopalocera
Chái-tàu	Kultiva rafano
模板:Ping	Ŝablono:Respondo al
Yun Hyon-seok	Yun Hyon-seok
特殊:最近其改變	Specialaĵo:Lastaj ŝanĝoj
模組:TableTools	Modulo:TableTools
模組:HtmlBuilder	Modulo:HtmlBuilder
模組:Coordinates	Modulo:Coordinates
模組:Math	Modulo:Math
