Afraga	Afriko
An t-Seapan	Japanio
Aimearaga a Deas	Sudameriko
Nirribhidh	Norvegio
Sasainn	Anglio
Alba	Skotlando
A' Chuimrigh	Kimrio
Èirinn a Tuath	Nord-Irlando
Poblachd na h-Èireann	Irlando
An Ungair	Hungario
An Spàinn	Hispanio
Na Stàitean Aonaichte	Usono
A' Bheilg	Belgio
Lucsamburg	Luksemburgo (lando)
Saoghal	Tero
George Washington	George Washington
Tim Berners-Lee	Tim Berners-Lee
Suòmaidh	Finnlando
An t-Suain	Svedio
An Danmhairg	Danio
A' Phòlainn	Pollando
Liotuàinia	Litovio
An Eadailt	Italio
An Eilbheis	Svislando
An Ostair	Aŭstrio
A' Ghrèig	Grekio
An Tuirc	Turkio
Leann	Biero
A' Phortagail	Portugalio
An Roinn-Eòrpa	Eŭropo
Àisia	Azio
Aimearaga a Tuath	Nordameriko
Antargtaga	Antarkto
Uicipeid	Vikipedio
Na Tìrean Ìsle	Nederlando
Bod	Peniso
Eabhraig Nuadh (baile)	Novjorko
Washington, D.C.	Vaŝingtono
San Francisco	San-Francisko
Berlin	Berlino
Los Angeles	Los-Anĝeleso
Coimpiutair	Komputilo
Berne	Berno
Geneva	Ĝenevo
Zürich	Zuriko
Eadar-lìon	Interreto
Barack Obama	Barack Obama
Uruguaidh	Urugvajo
Basel	Bazelo
Lunnainn	Londono
Cairo	Kairo
Alexandria, Virginia	Alexandria (Virginio)
Ubhal	Pomo
Paris	Parizo
Abraham Lincoln	Abraham Lincoln
Meagsago	Meksiko
Cuan Siar	Atlantika Oceano
Cuan Sèimh	Pacifika Oceano
Calafòrnia	Kalifornio
Boston, Massachusetts	Bostono
Di-Luain	Lundo
Am Faoilleach	Januaro
An Gearran	Februaro
Am Màrt	Marto
Corg	Marso
A' Cheinia	Kenjo
An Aetiòp	Etiopio
Gàna	Ganao
An Giblean	Aprilo
An Cèitean	Majo
An t-Ògmhios	Junio
An t-Iuchar	Julio
An Lùnastal	Aŭgusto
An t-Sultain	Septembro
An Dàmhair	Oktobro
An t-Samhain	Novembro
An Dùbhlachd	Decembro
Di-Màirt	Mardo
Di-Ciadain	Merkredo
Di-Ardaoin	Ĵaŭdo
Di-haoine	Vendredo
Di-Sathairne	Sabato
Di-Dòmhnaich	Dimanĉo
Leòmhann	Leono
An Fhraing	Francio
Esperanto	Esperanto
Cù	Hundo
An Rìoghachd Aonaichte	Unuiĝinta Reĝlando
Cat	Hejma kato
Sluagh-Phoblachd na Sìne	Ĉina Popola Respubliko
Fraingis	Franca lingvo
Iasg	Fiŝoj
Braisil	Brazilo
Alcol	Alkoholo
François Hollande	François Hollande
An Ruis	Rusio
Muc-mhara	Cetacoj
Muir	Maro
Am Muir Dubh	Nigra Maro
Pi	Pio (litero)
Toronto	Toronto
Alabama	Alabamo
São Paulo	San-Paŭlo (urbo)
Quebec	Kebekio
Wikimedia	Fondaĵo Vikimedio
A' Ghearmailt	Germanio
A' Bhealaruis	Belorusio
Gearmailtis	Germana lingvo
Innis Tìle	Islando
Dia	Dio
Eastòinia	Estonio
David Cameron	David Cameron
Satarn	Saturno (planedo)
Teòclaid	Ĉokolado
Cogadh	Milito
Stephen Harper	Stephen Harper
George W. Bush	George W. Bush
An Laitbhe	Latvio
An Ucràin	Ukrainio
An t-Seic	Ĉeĥio
An t-Slòbhac	Slovakio
Sloibhìnia	Slovenio
Vilnius	Vilno
Moldàibhia	Moldava Respubliko
Romàinia	Rumanio
Bulgàiria	Bulgario
An Ròimh	Romo
Masadoinia	Respubliko Makedonio
Albàinia	Albanio
A' Ghraonlainn	Gronlando
Poblachd na Cròthaise	Kroatio
Bosna agus Hearsagobhana	Bosnio kaj Hercegovino
Asarbaideàn	Azerbajĝano
Andorra	Andoro
Cìopras	Kipro
A' Chairtbheil	Kartvelio
Casachstàn	Kazaĥio
Malta	Malto
Monaco	Monako
Am Monadh Neagrach	Montenegro
Cathair na Bhatacain	Vatikano
San Marino	San-Marino
A' Bhruiseal	Bruselo
Cùba	Kubo
Beilise	Belizo
Barbados	Barbado
An Innd-Innse	Indonezio
Wolfgang Amadeus Mozart	Wolfgang Amadeus Mozart
Ludwig van Beethoven	Ludwig van Beethoven
Turcais	Turka lingvo
Afraga a Deas	Sud-Afriko
Aildiria	Alĝerio
Usbagastàn	Uzbekujo
Poznań	Poznano
Tashkent	Taŝkento
Warszawa	Varsovio
Ìle	Islay
Eurovision	Eŭrovido-Kantokonkurso
Uisge-beatha	Viskio
Fìon	Vino
Uisge	Akvo
Fiodh	Ligno
Tours	Tours
Telebhisean	Televido
An t-Sile	Ĉilio
Ìosa Crìosd	Jesuo Kristo
Elvis Presley	Elvis Presley
Galileo Galilei	Galilejo
Mearcair	Merkuro (planedo)
Eachdraidh	Historio
An Rìbhinn (planaid)	Venuso (planedo)
Cànan	Lingvo
Gràdh	Amo
Am Bliogh	Jupitero (planedo)
Slighe Chloinn Uisnich	Lakta vojo
Urànus (planaid)	Urano (planedo)
A' Bhreatainn Bheag	Bretonio
Nicolas Sarkozy	Nicolas Sarkozy
Neiptiùn	Neptuno (planedo)
Reul-eòlas	Astronomio
Singeapòr	Singapuro
Saidheans	Scienco
Pliùtò	Plutono
Montreal	Montrealo
Kemper	Quimper
Tràth teachdail	Estonteco
Moire	Maria (patrino de Jesuo)
Liechtenstein	Liĥtenŝtejno
Spòrs	Sporto
Cambridge	Kembriĝo (Britio)
Adolf Hitler	Adolf Hitler
Wikileaks	WikiLeaks
An Cogadh Mòr	Unua mondmilito
An Dàrna Cogadh	Dua mondmilito
Köln	Kolonjo
Skopje	Skopjo
Szczecin	Szczecin
Matamataig	Matematiko
U2	U2
Laideann	Latina lingvo
Bachrain	Barejno
Airmeinia	Armenio
An t-Sèirb	Serbio
Gealach	Luno
Istanbul	Istanbulo
Astràilia	Aŭstralio
Fiosaig	Fiziko
An Argantain	Argentino
Cian-chonaltradh	Telekomunikado
Pearù	Peruo
Bith-eòlas	Biologio
Coirèa a Tuath	Nord-Koreio
Cambuidea	Kamboĝo
Ioslam	Islamo
Ljubljana	Ljubljano
Salvador Allende	Salvador Allende
Lech Wałęsa	Lech Wałęsa
Cuibhle	Rado
Lyon	Liono
An t-Aonadh Eòrpach	Eŭropa Unio
Star Wars	Star Wars
Rhône-Alpes	Rodano-Alpoj
Bean	Virino
Sofia	Sofio
Amar-uisge	Akvedukto
Bàrdachd	Poezio
Chernobyl	Nuklea akcidento de Ĉernobilo
Milano	Milano
Torino	Torino
Cac	Fekaĵo
Achlais	Akselo
Liomaid	Citrono
Stendhal	Stendhal
Banana	Banano
Émile Zola	Émile Zola
666	666
Blàth	Floro
Beinn Everest	Ĉomolungmo
Eòlas-bodhaig	Anatomio
Baile mòr	Urbo
Napoleon Bonaparte	Napoleono Bonaparte
Reul	Stelo
Grian	Suno
Adhar	Ĉielo
Louis Pasteur	Louis Pasteur
Clachan	Vilaĝo
Victor Hugo	Victor Hugo
Roinn a' Chuain Shèimh	Oceanio
An Crios-Grèine	Sunsistemo
Am Muir Baltach	Balta Maro
Haidridean	Hidrogeno
Ifrinn	Infero
Angela Merkel	Angela Merkel
Leabhar	Libro
Là	Tago
Tiomor an Ear	Orienta Timoro
Oidhche	Nokto
Bliadhna	Jaro
Linn (100 bliadhnaichean)	Jarcento
Łódź	Lodzo
Oslo	Oslo
Bonn (a' Ghearmailt)	Bonn
Katowice	Katowice
Toll Dubh	Nigra truo
Luís Vaz de Camões	Luís Vaz de Camões
Lisbon	Lisbono
Padova	Padovo
Nicolaus Copernicus	Koperniko
Ludwigsburg	Ludwigsburg
Gualan	Karbono
Naitridean	Nitrogeno
Bergamo	Bergamo
Ogsaidean	Oksigeno
Planaid	Planedo
Cleopatra	Kleopatra
Ceòl	Muziko
Venezia	Venecio
Roazhon	Rennes
Lille	Lille
Moscobha	Moskvo
Eadailtis	Itala lingvo
Sankt Peterburg	Sankt-Peterburgo
An t-Siad	Ĉado
Sodium	Natrio
Almain	Aluminio
Sealainn Nuadh	Nov-Zelando
Na h-Innseachan	Barato
Sileagan	Silicio
Tubhalu	Tuvalo
Rosg	Prozo
Iarann	Fero
Tonga	Tongo
Samoa (Dùthaich)	Samoo
Na h-Eileanan Sholaimh	Salomonoj
Bhanuatu	Vanuatuo
Delft	Delft
Gini Nuadh Phaputhach	Papuo-Nov-Gvineo
William Shakespeare	William Shakespeare
Zuid-Holland	Suda Holando
Palau	Palaŭo
Nauru	Nauro
Firefox	Mozilla Firefox
Noord-Holland	Norda Holando
Na Meanbh Eileanan	Federacio de Mikronezio
Zeeland	Zelando
Flevoland	Flevolando
Na h-Eileanan Mharshall	Marŝala Insularo
Kiribati	Kiribato
Mongòilia	Mongolio
Fìdi	Fiĝioj
A' Bheiniseala	Venezuelo
Tàileasg	Ŝako
Maine	Majno
Each	Ĉevalo
Amsterdam	Amsterdamo
Ball-airm	Armilo
Beathach	Bestoj
Suranam	Surinamo
Paraguaidh	Paragvajo
Guiana	Gujano
Ealain	Arto
Eacuador	Ekvadoro
Coloimbia	Kolombio
Bùdachas	Budhismo
Groningen	Groningen (urbo)
Boilibhia	Bolivio
Groningen (Roinn)	Groningen (provinco)
Copar	Kupro
Trianaid agus Tobago	Trinidado kaj Tobago
Lus	Plantoj
Naomh Bhionsant agus Eileanan Greanadach	Sankta Vincento kaj Grenadinoj
Hampshire Nuadh	Nov-Hampŝiro
Naomh Lùisia	Sankta Lucio
Leonardo Da Vinci	Leonardo da Vinci
Naomh Crìstean agus Nibheis	Sankta-Kito kaj Neviso
Fungas	Fungoj
Dario Fo	Dario Fo
Iaimeuca	Jamajko
Greanada	Grenado (lando)
Fryslân	Frislando
Massachusetts	Masaĉuseco
Drenthe	Drenthe
Overijssel	Overijssel
Guatamala	Gvatemalo
Gelderland	Gelderland
Utrecht (Roinn)	Utrecht (provinco)
Na h-Eileanan Bhathama	Bahamoj
Connecticut	Konektikuto
Cearc	Koko
Antigua agus Barbuda	Antigvo-Barbudo
Hawaii	Havajo
Hondùras	Honduro
Doiminicia	Dominiko
Jersey	Ĵersejo
Poblachd Dhoiminicia	Domingo
Muc	Porko
Cuan Argtach	Arkta Oceano
Haiti	Haitio
El Salbhador	Salvadoro
Zwolle	Zwolle
Ioràn	Irano
Ioràc	Irako
Alasca	Alasko
Assen	Assen
Costa Rica	Kostariko
Iosrael	Israelo
Utrecht	Utrecht
Panama	Panamo
Iemen	Jemeno
Lausanne	Laŭzano
Pòlais	Pola lingvo
Iòrdan (dùthaich)	Jordanio
Niocaragua	Nikaragvo
Florida	Florido
Cìorgastan	Kirgizio
Arizona	Arizono
Cubhait	Kuvajto
Làthos	Laoso
Leabanon	Libano
Oregon	Oregono
Na h-Eileanan Mhaladaibh	Maldivoj
Na h-Aimearagan	Ameriko
Utah	Utaho
Bò	Bovo
Malaidhsia	Malajzio
Valais (Canton)	Kantono Valezo
Mianmar	Birmo
Neapàl	Nepalo
Omàn	Omano
Pagastàn	Pakistano
Catar	Kataro
Aràibia nan Sabhd	Sauda Arabio
Sri Lanca	Sri-Lanko
Iosif Stalin	Josif Stalin
Siria	Sirio
Platon	Platono
Joseph Brodsky	Iosif Brodskij
Taidigeastàn	Taĝikio
Poblachd na Sìne	Respubliko Ĉinio
Aristoteles	Aristotelo
Dùthaich nan Tàidh	Tajlando
Trèana	Trajno
Rèidio	Radiofonio
Turcmanastàn	Turkmenio
Na h-Iomaratan Arabach Aonaichte	Unuiĝintaj Arabaj Emirlandoj
Bhiet-Nam	Vjetnamio
Charlie Chaplin	Charlie Chaplin
Coirèa a Deas	Sud-Koreio
Afganastan	Afganio
J.R.R. Tolkien	John Ronald Reuel Tolkien
Òr	Oro
Bangladais	Bangladeŝo
Franz Kafka	Franz Kafka
Màili	Malio
Sokrates	Sokrato
Angola	Angolo
Butàn	Butano
Brùnaigh	Brunejo
Tansania	Tanzanio
Roald Amundsen	Roald Amundsen
Na h-Eileanan Filipineach	Filipinoj
Poblachd Meadhan Afraga	Centr-Afrika Respubliko
Isaac Newton	Isaac Newton
Albert Einstein	Albert Einstein
Tògo	Togolando
Tuinisia	Tunizio
Saimbia	Zambio
Siombabue	Zimbabvo
Beijing	Pekino
Sudàn a Deas	Sud-Sudano
Beinin	Benino
Botsuana	Bocvano
Buirciona Faso	Burkino
Burundaidh	Burundo
Na h-Eileanan Chomoro	Komoroj
A' Chongo	Respubliko Kongo
Poblachd Dheamocrach na Congo	Demokratia Respubliko Kongo
San Antonio, Texas	San Antonio (Teksaso)
Diobùtaidh	Ĝibutio
Bayern	Bavario
Gini Mheadhan-Chriosach	Ekvatora Gvineo
Baden-Württemberg	Baden-Virtembergo
Eartra	Eritreo
New Delhi	Nov-Delhio
Pàpa Iain Pòl II	Johano Paŭlo la 2-a
Amersfoort	Amersforto
Tbilisi	Tbiliso
Naoidhean	Bebo
Gabon	Gabono
Pàipear-èibhinn	Bildliteraturo
A' Ghaimbia	Gambio
Gini	Gvineo
Gini-Bissau	Gvineo Bisaŭa
Costa Ìbhri	Ebur-Bordo
Camarun	Kameruno
Cape Verde	Kaboverdo
Leasoto	Lesoto
Libèiria	Liberio
Libia	Libio
Aachen	Aachen
Madagascar	Madagaskaro
Malabhaidh	Malavio
Stuttgart	Stutgarto
Moratainia	Maŭritanio
Na h-Eileanan Mhoiriseas	Maŭricio
Maroco	Maroko
Mòsaimbic	Mozambiko
Naimibia	Namibio
France Prešeren	France Prešeren
Nìgeir	Niĝero
Nìgeiria	Niĝerio
Biel/Bienne	Bielo
Charles Darwin	Charles Darwin
Uganda	Ugando
Rubhanda	Ruando
São Tomé agus Príncipe	Sao-Tomeo kaj Principeo
Karlsruhe	Karlsruhe
Seanagal	Senegalo
Na h-Eileanan Sheiseall	Sejŝeloj
Carl Linnaeus	Karolo Lineo
Siarra Leòmhann	Siera-Leono
Somàilia	Somalio
Iulius Caesar	Julio Cezaro
Sudan	Sudano
Dùthaich nan Suasaidh	Svazilando
Bogha-frois	Ĉielarko
Hamburg	Hamburgo
Loch Ontario	Ontario (lago)
Gnè-fhàs	Evoluismo
Loch Superior	Supra Lago
Dante Alighieri	Dante Alighieri
Geòlas	Geologio
Cruinn-eòlas	Geografio
Craiceann	Haŭto
Ainmear	Substantivo
Pràg	Prago
Airgead (meatailt)	Arĝento
Staoin	Stano
Noord-Brabant	Norda Brabanto
Bill Clinton	William J. Clinton
Lorraine	Loreno
Alsace	Alzaco
Auvergne	Aŭvernjo
Mumbai	Mumbajo
Michigan	Miĉigano
Loch Michigan	Miĉigano (lago)
Bourgogne	Burgonjo
Aquitaine	Akvitanio
Puerto Rico	Porto-Riko
Kerala	Keralao
Limousin	Limoĝio
Schleswig-Holstein	Ŝlesvigo-Holstinio
Mecklenburg-Vorpommern	Meklenburgo-Antaŭpomerio
Sagsainn Ìosail	Malsupra Saksio
Nordrhein-Westfalen	Nordrejn-Vestfalio
Hessen	Hesio
Rheinland-Pfalz	Rejnlando-Palatinato
Saarland	Sarlando
Sagsainn	Saksio
John Lennon	John Lennon
Illinois	Ilinojso
Thüringen	Turingio
Sagsainn-Anhalt	Saksio-Anhalto
Dakota a Tuath	Norda Dakoto
Brandenburg	Brandenburgio
Lombardia	Lombardujo
Dakota a Deas	Suda Dakoto
Montana	Montano
Wyoming	Vajomingo
Piemonte	Piemonto
Ierusalem	Jerusalemo
Giorgio Napolitano	Giorgio Napolitano
Idaho	Idaho
Valle d'Aosta	Aosta Valo
Washington (stàit)	Vaŝingtonio
Bruce Springsteen	Bruce Springsteen
Nevada	Nevado
Trentino-Alto Adige/Südtirol	Trentino-Alto Adige
Cuan Innseanach	Hinda Oceano
Veneto	Veneto
Am Muir Caraibeach	Kariba Maro
Friuli-Venezia Giulia	Friulo-Venecio Julia
Kofi Annan	Kofi Annan
Liguria	Ligurio
Colorado	Koloradio
Emilia-Romagna	Emilio-Romanjo
Frédéric Chopin	Frédéric Chopin
Toscana	Toskanio
Marche	Markio (Italio)
Umbria	Umbrio
Roinn-seòrsa:Categories	Kategorio:Ĉio
Lazio	Latio
Abruzzo	Abruco
Grenoble	Grenoblo
Dàmais	Damludo
Dortmund	Dortmund
Gent	Gento (urbo)
Chicago	Ĉikago
The Beatles	The Beatles
Maastricht	Maastricht
Arnhem	Arnhem
Spàinntis	Hispana lingvo
Friedrich A. von Hayek	Friedrich August von Hayek
Montevideo	Montevideo
Johann Sebastian Bach	Johann Sebastian Bach
Pittsburgh, Pennsylvania	Pittsburgh (Pensilvanio)
Opra	Opero
Philadelphia, Pennsylvania	Filadelfio (Pensilvanio)
Kolkata	Kolkato
Delhi	Delhio
Dhaka	Dako
Bangalore	Bengaluro
Damhan-allaidh	Araneuloj
Islamabad	Islamabado
Meas	Frukto
Muncaidh	Simio
Virginia	Virginio (ŝtato)
Virginia an Iar	Okcidenta Virginio
Matterhorn	Materhorno
Loch Huron	Lago Hurono
Eabhraig Nuadh (stàit)	Nov-Jorkio
Rhode Island	Rod-Insulo
Maryland	Marilando
Delaware	Delavaro
Vladimir Lenin	Lenin
Ohio	Ohio
Virgil	Vergilio
Pennsylvania	Pensilvanio
Luigi Pirandello	Luigi Pirandello
Uetersen	Uetersen
Jersey Nuadh	Nov-Ĵerzejo
Giobraltair	Ĝibraltaro
Fionnlannais	Finna lingvo
Indiana	Indianio
Vespasian	Vespasiano
Juventus	Juventus Football Club
Trajan	Trajano
Georgia (stàit)	Georgio
Marcus Aurelius	Marko Aŭrelio
Zagreb	Zagrebo
Campania	Kampanio
Texas	Teksaso
Molise	Molizo
Puglia	Apulio
Genova	Ĝenovo
Basilicata	Basilikato
Carolina a Tuath	Norda Karolino
Cromanachd	Herbohokeo
Carolina a Deas	Suda Karolino
Calabria	Kalabrio
Sicilia	Sicilio
Manila	Manilo
Sardainia	Sardio
Maurits Cornelis Escher	M. C. Escher
Bordeaux	Bordeaux
Buenos Aires	Bonaero
Meagsago (baile)	Meksik-urbo
Tokyo	Tokio
La Paz	La-Pazo
Barcelona	Barcelono
Anann	Ananaso
Mississippi	Misisipio
Fernão de Magalhães	Fernão de Magalhães
Mississippi (abhainn)	Misisipo (rivero)
Amar-snàmh	Banejo
Tennessee	Tenesio
Richard Wagner	Richard Wagner
Robert Louis Stevenson	Robert Louis Stevenson
Abidjan	Abiĝano
Abu Dhabi	Abu-Dabio
Astana	Astano
Meagsago Nuadh	Nov-Meksiko
An Àithne	Ateno
Minnesota	Minesoto
Baghdad	Bagdado
Caracas	Karakaso
Àm Coitcheann Co-òrdanaichte	UTC
Wisconsin	Viskonsino
Iowa	Iovao
Nebraska	Nebrasko
Baile Guatemala	Gvatemalurbo
Kansas	Kansaso
La Habana	Havano
Hindi	Hindia lingvo
Missouri	Misurio
Louisiana	Luiziano
Kentucky	Kentukio
Arkansas	Arkansaso
Neil Armstrong	Neil Armstrong
Édith Piaf	Édith Piaf
Oklahoma	Oklahomo
An Cuan a Tuath	Norda Maro
Kiel	Kilo (urbo)
Schwerin	Schwerin
Potsdam	Potsdamo
Hànobhar	Hanovro
Düsseldorf	Duseldorfo
Mainz	Majenco
Wiesbaden	Wiesbaden
Saarbrücken	Saarbrücken
München	Munkeno
Erfurt	Erfurto
Dresden	Dresdeno
Magdeburg	Magdeburgo
Innsbruck	Innsbruck
Vienna	Vieno
Copenhagen	Kopenhago
Stockholm	Stokholmo
Helsinki	Helsinko
Baile Átha Cliath	Dublino
Reykjavík	Rejkjaviko
Ella Fitzgerald	Ella Fitzgerald
Tallinn	Talino
Riga	Rigo
Bratislava	Bratislavo
Budapest	Budapeŝto
Gdańsk	Gdańsk
Frankfurt	Frankfurto ĉe Majno
Wrocław	Vroclavo
Lucsamburg (baile)	Luksemburgo
Vaduz	Vaduzo
Bìoball	Biblio
San Marino (baile)	San-Marino (urbo)
Phnom Penh	Pnom-Peno
Ho Chi Minh (baile)	Ho-Ĉi-Min-urbo
Hanoi	Hanojo
Eaglais Fhìor Ìosa	Vera Eklezio de Jesuo
Beurla	Angla lingvo
Bangkok	Bankoko
Andorra la Vella	Andoro Malnova
Kuala Lumpur	Kuala-Lumpuro
Taipei	Tajpeo
Đồng Hới	Dong Hoi
Concepción	Koncepciono
Bologna	Bolonjo
Kiev	Kievo
Ontario	Ontario
Ottawa	Otavo
Juba	Ĵubo
Manitoba	Manitobo
Alberta	Alberto
Alba Nuadh	Nov-Skotio
Yerevan	Erevano
Końskowola	Końskowola
Dar es Salaam	Daresalamo
Khartoum	Ĥartumo
Brunswick Nuadh	Nov-Brunsviko
Columbia Bhreatannach	Brita Kolumbio
Eilean Eòin	Insulo de Princo Eduardo
2000	2000
2003	2003
2002	2002
2001	2001
Saskatchewan	Saskaĉevano
2012	2012
2011	2011
2010	2010
2009	2009
Dà-ogsaid gualain	Karbona dioksido
2013	2013
2014	2014
2015	2015
An Talamh Ùr is Labrador	Novlando kaj Labradoro
2008	2008
Roinnean an Iar Thuath	Nordokcidentaj Teritorioj
Roinn an Iukon	Jukonio
2004	2004
2005	2005
2006	2006
Nunavut	Nunavuto
2007	2007
Iqaluit	Ikaluito
1900	1900
1901	1901
Livius	Tito Livio
Charles de Gaulle	Charles de Gaulle
1902	1902
Firenze	Florenco
1903	1903
1904	1904
1905	1905
1907	1907
1906	1906
1908	1908
1909	1909
Whitehorse	Whitehorse
1992	1992
Yellowknife	Yellowknife
1991	1991
1990	1990
1993	1993
1994	1994
1995	1995
1996	1996
1910	1910
1911	1911
1912	1912
Leipzig	Leipzig
1913	1913
Baile Naoimh Eòin, an Talamh Ùr	St. John's
1914	1914
1915	1915
1916	1916
1997	1997
1998	1998
Nürnberg	Nurenbergo
1999	1999
1917	1917
1918	1918
Biadh	Manĝaĵo
Edmonton	Edmontono
Nathair	Serpento
Bochum	Bochum
Regina, Saskatchewan	Regina
Baile Sheàrlot	Ĉarlotaŭno
Victoria, Columbia Bhreatannach	Viktorio
Winnipeg	Vinipego
Fredericton	Frederiktono
Halafacs	Halifakso
Quebec (baile)	Kebeko
1 am Faoilleach	1-a de januaro
2 am Faoilleach	2-a de januaro
1920	1920
3 am Faoilleach	3-a de januaro
1919	1919
1921	1921
1922	1922
Lund	Lund
4 am Faoilleach	4-a de januaro
1923	1923
1924	1924
Georges Pompidou	Georges Pompidou
Romulus agus Remus	Romulo kaj Remo
5 am Faoilleach	5-a de januaro
Malmö	Malmö
6 am Faoilleach	6-a de januaro
7 am Faoilleach	7-a de januaro
8 am Faoilleach	8-a de januaro
9 am Faoilleach	9-a de januaro
10 am Faoilleach	10-a de januaro
11 am Faoilleach	11-a de januaro
12 am Faoilleach	12-a de januaro
Buzz Aldrin	Buzz Aldrin
13 am Faoilleach	13-a de januaro
Birmingham	Birmingham
14 am Faoilleach	14-a de januaro
15 am Faoilleach	15-a de januaro
16 am Faoilleach	16-a de januaro
17 am Faoilleach	17-a de januaro
18 am Faoilleach	18-a de januaro
19 am Faoilleach	19-a de januaro
20 am Faoilleach	20-a de januaro
Tionndadh Gnìomhachais	Industria revolucio
21 am Faoilleach	21-a de januaro
22 am Faoilleach	22-a de januaro
23 am Faoilleach	23-a de januaro
Impireachd na Ròimhe	Romia Imperio
24 am Faoilleach	24-a de januaro
25 am Faoilleach	25-a de januaro
Minsk	Minsko
26 am Faoilleach	26-a de januaro
27 am Faoilleach	27-a de januaro
28 am Faoilleach	28-a de januaro
29 am Faoilleach	29-a de januaro
30 am Faoilleach	30-a de januaro
31 am Faoilleach	31-a de januaro
2 an Dùbhlachd	2-a de decembro
1 an Dùbhlachd	1-a de decembro
3 an Dùbhlachd	3-a de decembro
7 an Dùbhlachd	7-a de decembro
5 an Dùbhlachd	5-a de decembro
8 an Dùbhlachd	8-a de decembro
10 an Dùbhlachd	10-a de decembro
6 an Dùbhlachd	6-a de decembro
9 an Dùbhlachd	9-a de decembro
4 an Dùbhlachd	4-a de decembro
1 an Gearran	1-a de februaro
2 an Gearran	2-a de februaro
3 an Gearran	3-a de februaro
Kurów	Kurów
4 an Gearran	4-a de februaro
5 an Gearran	5-a de februaro
6 an Gearran	6-a de februaro
7 an Gearran	7-a de februaro
8 an Gearran	8-a de februaro
9 an Gearran	9-a de februaro
10 an Gearran	10-a de februaro
Ceimigeachd	Kemio
Led Zeppelin	Led Zeppelin
14 an Gearran	14-a de februaro
13 an Gearran	13-a de februaro
15 an Gearran	15-a de februaro
11 an Gearran	11-a de februaro
12 an Gearran	12-a de februaro
19 an Gearran	19-a de februaro
17 an Gearran	17-a de februaro
16 an Gearran	16-a de februaro
18 an Gearran	18-a de februaro
20 an Gearran	20-a de februaro
21 an Gearran	21-a de februaro
22 an Gearran	22-a de februaro
23 an Gearran	23-a de februaro
24 an Gearran	24-a de februaro
25 an Gearran	25-a de februaro
26 an Gearran	26-a de februaro
27	27
27 an Gearran	27-a de februaro
28 an Gearran	28-a de februaro
11 an Dùbhlachd	11-a de decembro
29 an Gearran	29-a de februaro
12 an Dùbhlachd	12-a de decembro
13 an Dùbhlachd	13-a de decembro
14 an Dùbhlachd	14-a de decembro
15 an Dùbhlachd	15-a de decembro
2 am Màrt	2-a de marto
3 am Màrt	3-a de marto
5 am Màrt	5-a de marto
1 am Màrt	1-a de marto
7 am Màrt	7-a de marto
8 am Màrt	8-a de marto
4 am Màrt	4-a de marto
10 am Màrt	10-a de marto
11 am Màrt	11-a de marto
6 am Màrt	6-a de marto
13 am Màrt	13-a de marto
9 am Màrt	9-a de marto
12 am Màrt	12-a de marto
15 am Màrt	15-a de marto
14 am Màrt	14-a de marto
16 an Dùbhlachd	16-a de decembro
17 an Dùbhlachd	17-a de decembro
16 am Màrt	16-a de marto
17 am Màrt	17-a de marto
18 am Màrt	18-a de marto
19 am Màrt	19-a de marto
1989	1989
1988	1988
20 am Màrt	20-a de marto
1987	1987
1986	1986
1985	1985
1984	1984
21 am Màrt	21-a de marto
1983	1983
22 am Màrt	22-a de marto
1982	1982
1981	1981
18 an Dùbhlachd	18-a de decembro
1980	1980
23 am Màrt	23-a de marto
Mogadishu	Mogadiŝo
19 an Dùbhlachd	19-a de decembro
24 am Màrt	24-a de marto
25 am Màrt	25-a de marto
20 an Dùbhlachd	20-a de decembro
26 am Màrt	26-a de marto
27 am Màrt	27-a de marto
28 am Màrt	28-a de marto
29 am Màrt	29-a de marto
30 am Màrt	30-a de marto
31 am Màrt	31-a de marto
Nassau	Nasaŭo (Bahamoj)
Ṣan'ā'	Sanao
1970	1970
1971	1971
1972	1972
1973	1973
1974	1974
1975	1975
1976	1976
1977	1977
1978	1978
1979	1979
1969	1969
Pàpa Beinidict XVI	Benedikto la 16-a
15 an Giblean	15-a de aprilo
13 an Giblean	13-a de aprilo
12 an Giblean	12-a de aprilo
14 an Giblean	14-a de aprilo
11 an Giblean	11-a de aprilo
10 an Giblean	10-a de aprilo
8 an Giblean	8-a de aprilo
9 an Giblean	9-a de aprilo
7 an Giblean	7-a de aprilo
6 an Giblean	6-a de aprilo
5 an Giblean	5-a de aprilo
4 an Giblean	4-a de aprilo
3 an Giblean	3-a de aprilo
1 an Giblean	1-a de aprilo
2 an Giblean	2-a de aprilo
16 an Giblean	16-a de aprilo
17 an Giblean	17-a de aprilo
18 an Giblean	18-a de aprilo
19 an Giblean	19-a de aprilo
20 an Giblean	20-a de aprilo
21 an Giblean	21-a de aprilo
22 an Giblean	22-a de aprilo
23 an Giblean	23-a de aprilo
24 an Giblean	24-a de aprilo
25 an Giblean	25-a de aprilo
26 an Giblean	26-a de aprilo
27 an Giblean	27-a de aprilo
28 an Giblean	28-a de aprilo
29 an Giblean	29-a de aprilo
30 an Giblean	30-a de aprilo
Saideal (reul-eòlas)	Natura satelito
1 an Cèitean	1-a de majo
2 an Cèitean	2-a de majo
3 an Cèitean	3-a de majo
4 an Cèitean	4-a de majo
5 an Cèitean	5-a de majo
6 an Cèitean	6-a de majo
7 an Cèitean	7-a de majo
8 an Cèitean	8-a de majo
9 an Cèitean	9-a de majo
10 an Cèitean	10-a de majo
11 an Cèitean	11-a de majo
12 an Cèitean	12-a de majo
13 an Cèitean	13-a de majo
14 an Cèitean	14-a de majo
15 an Cèitean	15-a de majo
16 an Cèitean	16-a de majo
17 an Cèitean	17-a de majo
18 an Cèitean	18-a de majo
19 an Cèitean	19-a de majo
20 an Cèitean	20-a de majo
21 an Cèitean	21-a de majo
22 an Cèitean	22-a de majo
23 an Cèitean	23-a de majo
24 an Cèitean	24-a de majo
25 an Cèitean	25-a de majo
26 an Cèitean	26-a de majo
27 an Cèitean	27-a de majo
28 an Cèitean	28-a de majo
29 an Cèitean	29-a de majo
30 an Cèitean	30-a de majo
31 an Cèitean	31-a de majo
Paul McCartney	Paul McCartney
Pit	Piĉo
21 an Dùbhlachd	21-a de decembro
Pàpa Pius XII	Pio la 12-a
14 an t-Ògmhios	14-a de junio
15 an t-Ògmhios	15-a de junio
13 an t-Ògmhios	13-a de junio
10 an t-Ògmhios	10-a de junio
7 an t-Ògmhios	7-a de junio
11 an t-Ògmhios	11-a de junio
9 an t-Ògmhios	9-a de junio
12 an t-Ògmhios	12-a de junio
6 an t-Ògmhios	6-a de junio
8 an t-Ògmhios	8-a de junio
5 an t-Ògmhios	5-a de junio
3 an t-Ògmhios	3-a de junio
2 an t-Ògmhios	2-a de junio
1 an t-Ògmhios	1-a de junio
4 an t-Ògmhios	4-a de junio
Ringo Starr	Ringo Starr
Napoli	Napolo
22 an Dùbhlachd	22-a de decembro
S.S.C. Napoli	SSC Napoli
George Harrison	George Harrison
1968	1968
1967	1967
1966	1966
1965	1965
1964	1964
16 an t-Ògmhios	16-a de junio
30 an t-Ògmhios	30-a de junio
29 an t-Ògmhios	29-a de junio
28 an t-Ògmhios	28-a de junio
26 an t-Ògmhios	26-a de junio
25 an t-Ògmhios	25-a de junio
22 an t-Ògmhios	22-a de junio
27 an t-Ògmhios	27-a de junio
24 an t-Ògmhios	24-a de junio
20 an t-Ògmhios	20-a de junio
23 an t-Ògmhios	23-a de junio
19 an t-Ògmhios	19-a de junio
18 an t-Ògmhios	18-a de junio
21 an t-Ògmhios	21-a de junio
17 an t-Ògmhios	17-a de junio
23 an Dùbhlachd	23-a de decembro
Ceusair Uilleam II	Vilhelmo la 2-a (Germana Regno)
Bruce Willis	Bruce Willis
Arnold Schwarzenegger	Arnold Schwarzenegger
15 an t-Iuchar	15-a de julio
13 an t-Iuchar	13-a de julio
12 an t-Iuchar	12-a de julio
10 an t-Iuchar	10-a de julio
9 an t-Iuchar	9-a de julio
14 an t-Iuchar	14-a de julio
8 an t-Iuchar	8-a de julio
7 an t-Iuchar	7-a de julio
6 an t-Iuchar	6-a de julio
5 an t-Iuchar	5-a de julio
2 an t-Iuchar	2-a de julio
4 an t-Iuchar	4-a de julio
3 an t-Iuchar	3-a de julio
1 an t-Iuchar	1-a de julio
11 an t-Iuchar	11-a de julio
24 an Dùbhlachd	24-a de decembro
Bremerhaven	Bremerhaven
31 an t-Iuchar	31-a de julio
30 an t-Iuchar	30-a de julio
29 an t-Iuchar	29-a de julio
28 an t-Iuchar	28-a de julio
27 an t-Iuchar	27-a de julio
25 an t-Iuchar	25-a de julio
24 an t-Iuchar	24-a de julio
23 an t-Iuchar	23-a de julio
26 an t-Iuchar	26-a de julio
22 an t-Iuchar	22-a de julio
19 an t-Iuchar	19-a de julio
21 an t-Iuchar	21-a de julio
20 an t-Iuchar	20-a de julio
17 an t-Iuchar	17-a de julio
18 an t-Iuchar	18-a de julio
16 an t-Iuchar	16-a de julio
Ball-coise	Futbalo
25 an Dùbhlachd	25-a de decembro
Augsburg	Augsburg
Siena	Sieno
1963	1963
Lech Kaczyński	Lech Kaczyński
Urbino	Urbino
26 an Dùbhlachd	26-a de decembro
Uile-losgadh	Holokaŭsto
1962	1962
Gelsenkirchen	Gelsenkirchen
14 an Lùnastal	14-a de aŭgusto
15 an Lùnastal	15-a de aŭgusto
13 an Lùnastal	13-a de aŭgusto
12 an Lùnastal	12-a de aŭgusto
11 an Lùnastal	11-a de aŭgusto
10 an Lùnastal	10-a de aŭgusto
8 an Lùnastal	8-a de aŭgusto
7 an Lùnastal	7-a de aŭgusto
9 an Lùnastal	9-a de aŭgusto
5 an Lùnastal	5-a de aŭgusto
4 an Lùnastal	4-a de aŭgusto
2 an Lùnastal	2-a de aŭgusto
3 an Lùnastal	3-a de aŭgusto
6 an Lùnastal	6-a de aŭgusto
1 an Lùnastal	1-a de aŭgusto
Chemnitz	Chemnitz
27 an Dùbhlachd	27-a de decembro
Madrid	Madrido
Bàta-tumaidh	Submarŝipo
16 an Lùnastal	16-a de aŭgusto
Halle (Saale)	Halle (Saale)
29 an Lùnastal	29-a de aŭgusto
28 an Lùnastal	28-a de aŭgusto
30 an Lùnastal	30-a de aŭgusto
25 an Lùnastal	25-a de aŭgusto
26 an Lùnastal	26-a de aŭgusto
23 an Lùnastal	23-a de aŭgusto
27 an Lùnastal	27-a de aŭgusto
21 an Lùnastal	21-a de aŭgusto
20 an Lùnastal	20-a de aŭgusto
24 an Lùnastal	24-a de aŭgusto
18 an Lùnastal	18-a de aŭgusto
17 an Lùnastal	17-a de aŭgusto
22 an Lùnastal	22-a de aŭgusto
19 an Lùnastal	19-a de aŭgusto
31 an Lùnastal	31-a de aŭgusto
28 an Dùbhlachd	28-a de decembro
Freiburg im Breisgau	Freiburg
Bogotá	Bogoto
Lübeck	Lubeko
Brasília	Braziljo
15 an t-Sultain	15-a de septembro
14 an t-Sultain	14-a de septembro
13 an t-Sultain	13-a de septembro
12 an t-Sultain	12-a de septembro
8 an t-Sultain	8-a de septembro
11 an t-Sultain	11-a de septembro
7 an t-Sultain	7-a de septembro
10 an t-Sultain	10-a de septembro
5 an t-Sultain	5-a de septembro
4 an t-Sultain	4-a de septembro
9 an t-Sultain	9-a de septembro
2 an t-Sultain	2-a de septembro
6 an t-Sultain	6-a de septembro
1 an t-Sultain	1-a de septembro
3 an t-Sultain	3-a de septembro
Rostock	Rostock
29 an Dùbhlachd	29-a de decembro
Alexander Lukashenko	Aleksandro Lukaŝenko
Lima	Limo
30 an t-Sultain	30-a de septembro
29 an t-Sultain	29-a de septembro
28 an t-Sultain	28-a de septembro
27 an t-Sultain	27-a de septembro
26 an t-Sultain	26-a de septembro
25 an t-Sultain	25-a de septembro
Santiago	Santiago de Ĉilio
23 an t-Sultain	23-a de septembro
22 an t-Sultain	22-a de septembro
24 an t-Sultain	24-a de septembro
21 an t-Sultain	21-a de septembro
20 an t-Sultain	20-a de septembro
18 an t-Sultain	18-a de septembro
17 an t-Sultain	17-a de septembro
19 an t-Sultain	19-a de septembro
16 an t-Sultain	16-a de septembro
Mülheim an der Ruhr	Mülheim
Quito	Kito
30 an Dùbhlachd	30-a de decembro
Sucre	Sukro
31 an Dùbhlachd	31-a de decembro
1 an Dàmhair	1-a de oktobro
15 an Dàmhair	15-a de oktobro
12 an Dàmhair	12-a de oktobro
10 an Dàmhair	10-a de oktobro
14 an Dàmhair	14-a de oktobro
9 an Dàmhair	9-a de oktobro
8 an Dàmhair	8-a de oktobro
13 an Dàmhair	13-a de oktobro
7 an Dàmhair	7-a de oktobro
11 an Dàmhair	11-a de oktobro
6 an Dàmhair	6-a de oktobro
4 an Dàmhair	4-a de oktobro
5 an Dàmhair	5-a de oktobro
3 an Dàmhair	3-a de oktobro
2 an Dàmhair	2-a de oktobro
Asunción	Asunciono
31 an Dàmhair	31-a de oktobro
30 an Dàmhair	30-a de oktobro
29 an Dàmhair	29-a de oktobro
28 an Dàmhair	28-a de oktobro
26 an Dàmhair	26-a de oktobro
25 an Dàmhair	25-a de oktobro
24 an Dàmhair	24-a de oktobro
27 an Dàmhair	27-a de oktobro
22 an Dàmhair	22-a de oktobro
23 an Dàmhair	23-a de oktobro
20 an Dàmhair	20-a de oktobro
21 an Dàmhair	21-a de oktobro
19 an Dàmhair	19-a de oktobro
17 an Dàmhair	17-a de oktobro
16 an Dàmhair	16-a de oktobro
18 an Dàmhair	18-a de oktobro
Heidelberg	Heidelberg
Notre Dame de Paris	Dipatrino de Parizo
15 an t-Samhain	15-a de novembro
14 an t-Samhain	14-a de novembro
13 an t-Samhain	13-a de novembro
12 an t-Samhain	12-a de novembro
11 an t-Samhain	11-a de novembro
10 an t-Samhain	10-a de novembro
7 an t-Samhain	7-a de novembro
8 an t-Samhain	8-a de novembro
9 an t-Samhain	9-a de novembro
6 an t-Samhain	6-a de novembro
5 an t-Samhain	5-a de novembro
4 an t-Samhain	4-a de novembro
3 an t-Samhain	3-a de novembro
2 an t-Samhain	2-a de novembro
1 an t-Samhain	1-a de novembro
Paramaribo	Paramaribo
Ulm	Ulm
30 an t-Samhain	30-a de novembro
29 an t-Samhain	29-a de novembro
28 an t-Samhain	28-a de novembro
27 an t-Samhain	27-a de novembro
26 an t-Samhain	26-a de novembro
25 an t-Samhain	25-a de novembro
23 an t-Samhain	23-a de novembro
24 an t-Samhain	24-a de novembro
21 an t-Samhain	21-a de novembro
20 an t-Samhain	20-a de novembro
22 an t-Samhain	22-a de novembro
19 an t-Samhain	19-a de novembro
18 an t-Samhain	18-a de novembro
17 an t-Samhain	17-a de novembro
16 an t-Samhain	16-a de novembro
Caileag	Knabino
Göttingen	Göttingen
Kathmandu	Katmanduo
Belmopan	Belmopano
Teàrlach Mòr	Karolo la Granda
Pforzheim	Pforzheim
Liger-Atlantel	Loire-Atlantique
San José, Costa Rica	San-Joseo (Kostariko)
Punc	Punko
Ain	Ain
Aisne	Aisne
Vosges (département)	Vosges (departemento)
San Salvador	San-Salvadoro
Allier	Allier
Canberra	Kanbero
Jura (département)	Ĵuraso (franca departemento)
Hautes-Alpes	Hautes-Alpes
Sydney	Sidnejo
Alpes-de-Haute-Provence	Alpes-de-Haute-Provence
Alpes-Maritimes	Alpes-Maritimes
Melbourne	Melburno
Ardèche	Ardèche
Jena	Jena
Ardennes (département)	Ardennes (departemento)
Peairt, Astràilia	Perto
Ariège	Ariège
Hildesheim	Hildesheim
Aube	Aube (departemento)
Teine	Fajro
Astràilia an Iar	Okcidenta Aŭstralio
Aude	Aude
Aveyron	Aveyron
New South Wales	Novsudkimrio
Roinn-a-Tuath	Norda Teritorio
Tegucigalpa	Tegucigalpo
Bouches-du-Rhône	Bouches-du-Rhône
Calvados (département)	Calvados
Cantal	Cantal
Charente	Charente
Managua	Managvo
Charente-Maritime	Charente-Maritime
Cher (département)	Cher (departemento)
Panama (baile)	Panamurbo
Haute-Corse	Haute-Corse
George Orwell	George Orwell
Corse-du-Sud	Corse-du-Sud
Côte-d'Or	Côte-d'Or
Aodoù-an-Arvor	Côtes-d'Armor
Dordogne	Dordogne
Drôme	Drôme
Essonne	Essonne
Eure	Eure
Eure-et-Loir	Eure-et-Loir
Penn-ar-Bed	Finistère
Nile	Nilo
Voronezh	Voroneĵ
Sumatra	Sumatro
Rabat	Rabato
Reul earballach	Kometo
Algiers	Alĝero
Tunis	Tunizo
Tripoli	Tripolo
Djibouti (Baile)	Ĝibuto
Tehran	Teherano
Addis Ababa	Adis-Abebo
Jakarta	Ĝakarto
Ankara	Ankaro
Asmara	Asmaro
N'Djamena	Nĵameno
Niamey	Niameo
Nouakchott	Nuakŝoto
Riyadh	Riado
1961	1961
Bamako	Bamako
Troigh	Futo
Belgrade	Beogrado
Dakar	Dakaro
Banjul	Banĵulo
Conakry	Konakrio
Bissau	Bisaŭo
Roinn-seòrsa:Teamplaid	Kategorio:Vikipedio:Ŝablonoj
Monrovia	Monrovio
Praia	Prajo
1960	1960
Diàbha	Javo
Accra	Akrao
Damascus	Damasko
Yamoussoukro	Jamusukro
Guiana Fhrangach	Franca Gviano
Ouagadougou	Uagaduguo
Freetown	Fritaŭno
Abuja	Abuĝo
Lomé	Lomeo
Porto-Novo	Porto-Novo
Amman	Amano
Yaoundé	Jaundeo
Sulawesi	Sulaveso
Malabo	Malabo
Beirut	Bejruto
Libreville	Librevilo
Muscat	Maskato
Bangui	Bango
Kinshasa	Kinŝaso
Brazzaville	Brazavilo
Gini-Nuadh an Iar	Okcidenta Nov-Gvineo
Worms	Worms
Bujumbura	Buĵumburo
Nicosia	Nikozio
Kigali	Kigalo
Doha	Doho
Dodoma	Dodomao
Nairobi	Najrobo
Lilongwe	Lilongvo
Neumünster	Neumünster
Lusaka	Lusako
Manama	Manamo
Maputo	Maputo
Kampala	Kampalo
Luanda	Luando
Moroni	Moronio
Mbabane	Mbabano
Galicia	Galegio
Maseru	Maseruo
Antananarivo	Antananarivo
Oilthigh	Universitato
Gaborone	Gaberono
Harare	Harareo
Detmold	Detmold
Pretoria	Pretorio
Port Louis	Port-Luiso
São Tomé	Sao-Tomeo
Prionnsachd Asturias	Asturio
Windhoek	Vindhuko
Uicipeid:Tigh-cluiche	Vikipedio:Provejo
Victoria (na h-Eileanan Sheiseall)	Viktorio (Sejŝeloj)
Uicipeid:Ro-ràdh	Vikipedio:Bonvenon al Vikipedio
Cantàbria	Kantabrio
Taigh	Domo
Baile	Taŭno
Bathar-cruaidh	Aparataro
Neuwied	Neuwied
Ailseabra	Algebro
Dùthaich nam Basgach	Eŭska Aŭtonoma Komunumo
Nafarroa	Navaro
Abhainn	Rivero
Osasco	Osasco (San-Paŭlo)
Aragón	Aragono
Euskirchen	Euskirchen
Fàsach Bheag na Gainmhich	Malgranda Sablodezerto
Glaschu	Glasgovo
Greifswald	Greifswald
Reul-chuairt	Orbito
Port Adhair Dong Hoi	Flughaveno Dong Hoi
Fèin-eachdraidh	Aŭtobiografio
Luzern	Lucerno
Curitiba	Kuritibo
Feòrag	Rufa sciuro
Pangaea	Pangeo
Coille	Arbaro
Zichyújfalu	Zichyújfalu
Pàpa Pius VIII	Pio la 8-a
Pàpa Beinidict XV	Benedikto la 15-a
Cabhlach	Mararmeo
Sean Connery	Sean Connery
Gnàth-fhacail	Sentencoj de Salomono
Anne Frank	Anne Frank
Confucius	Konfuceo
Corbin Bleu	Corbin Bleu
Roinn-seòrsa:Matamataig	Kategorio:Matematiko
Na h-Eileanan Fàro	Ferooj
Mohamed Morsi	Mohamed Mursi
Ath-bheòthachadh	Renesanco
Oamaru	Oamaru
Nead	Nesto
1488	1488
Euro	Eŭro
Am Muir Meadhan-thìreach	Mediteraneo
Crìosdaidheachd	Kristanismo
1004	1004
Seattle, Washington	Seattle
Baltimore, Maryland	Baltimore (Marilando)
Mòr-roinn	Kontinento
Adelaide	Adelajdo
Eun	Birdoj
Prìomh-bhaile	Ĉefurbo
Monzón	Monzono
Portagailis	Portugala lingvo
Mustafa Kemal Atatürk	Mustafa Kemal Atatürk
1948	1948
1949	1949
Almazán	Almazán
Huang Sianfan	Huang Senfan
Quechua	Keĉua lingvaro
1956	1956
1200	1200
1201	1201
1202	1202
1203	1203
1204	1204
1205	1205
1206	1206
1941	1941
1207	1207
1208	1208
1945	1945
1209	1209
1210	1210
1211	1211
1958	1958
1212	1212
1926	1926
1213	1213
1947	1947
1944	1944
1952	1952
Bill Gates	Bill Gates
Seapanais	Japana lingvo
Leabhar-eòlais	Enciklopedio
Prìomh-Dhuilleag	Vikipedio:Ĉefpaĝo
1959	1959
1957	1957
1214	1214
1215	1215
Ball-stèidhe	Basbalo
Ball-basgaid	Korbopilkado
1216	1216
Criogaid	Kriketo
Goilf	Golfo (sporto)
Rugbaidh	Rugbeo
1217	1217
1218	1218
1219	1219
Na h-Olympics	Olimpiaj ludoj
1220	1220
1221	1221
1222	1222
1223	1223
Eoràisia	Eŭrazio
1224	1224
1225	1225
1226	1226
1227	1227
1228	1228
1229	1229
1230	1230
1231	1231
1232	1232
1233	1233
1234	1234
1235	1235
1236	1236
1237	1237
1238	1238
1239	1239
1240	1240
1241	1241
1242	1242
1243	1243
1244	1244
1245	1245
1246	1246
Beanntan na h-Andes	Andoj
Na Beanntan Creagach	Roka Montaro
Cape Town	Kaburbo
1247	1247
1248	1248
Muir Caspach	Kaspio
1249	1249
1250	1250
Loch Erie	Eria Lago
1251	1251
1252	1252
1253	1253
1254	1254
1255	1255
1256	1256
1257	1257
1258	1258
1259	1259
1260	1260
1261	1261
1262	1262
1263	1263
Loch Baikal	Bajkalo
1264	1264
1265	1265
1266	1266
1267	1267
1268	1268
1269	1269
1270	1270
1271	1271
1272	1272
1273	1273
1274	1274
1275	1275
1276	1276
1277	1277
1278	1278
1279	1279
1280	1280
1281	1281
1282	1282
1283	1283
1284	1284
1285	1285
1286	1286
1287	1287
1288	1288
1289	1289
1290	1290
1291	1291
1292	1292
1293	1293
1294	1294
1295	1295
1296	1296
1297	1297
1298	1298
1299	1299
Vincent van Gogh	Vincent van Gogh
Frida Kahlo	Frida Kahlo
Michelangelo	Mikelanĝelo
Rembrandt	Rembrandt Harmenszoon van Rijn
Frank Lloyd Wright	Frank Lloyd Wright
1300	1300
1301	1301
1302	1302
1303	1303
1304	1304
1305	1305
Hans Christian Andersen	Hans Christian Andersen
Cervantes	Miguel de Cervantes
Charles Dickens	Charles Dickens
Åland	Alando
Catalòinia	Katalunio
1306	1306
1307	1307
Co-chomann València	Valencilando
Philippe Pétain	Philippe Pétain
1308	1308
1309	1309
La Rioja (An Spàinn)	Provinco Rioĥo
1310	1310
1311	1311
1312	1312
1313	1313
Castilla y León	Kastilio kaj Leono
1314	1314
1315	1315
1316	1316
1317	1317
Castilla-La Mancha	Kastilio-Manĉo
1318	1318
Na h-Eileanan Balèarach	Balearoj
1319	1319
1320	1320
1321	1321
1322	1322
1323	1323
Murcia (provincia)	Murcia Regiono
1324	1324
1325	1325
Extremadura	Ekstremaduro
1326	1326
Andalusia	Andaluzio
1327	1327
1328	1328
Mecca	Mekko
Che Guevara	Che Guevara
Na h-Eileanan Canàrach	Kanarioj
Mao Zedong	Mao Zedong
Córdoba, An Spàinn	Kordovo (Hispanio)
Ceuta	Ceŭto
Melilla	Melilo
Kabul	Kabulo
Aonadh Rugbaidh	Rugbeo 15
Vukovar	Vukovar
Lhasa	Lasao
Dàirich	Amoro
Gabriel García Márquez	Gabriel García Márquez
Johann Wolfgang von Goethe	Johann Wolfgang von Goethe
Faighean	Vagino
Tamailis	Tamila lingvo
Feallsanachd	Filozofio
1329	1329
Aachener Dom	Katedralo de Akeno
Huntington Beach, Calafòrnia	Huntington Beach
Orange County, Calafòrnia	Kantono Orange (Kalifornio)
James Brown	James Brown
Roinn-seòrsa:Candidates for speedy deletion	Kategorio:Tujforigendaj artikoloj
Buddy Holly	Buddy Holly
1330	1330
1331	1331
1332	1332
1333	1333
1334	1334
Rap	Repo
1335	1335
1336	1336
Dada	Dadaismo
1337	1337
1338	1338
1339	1339
1340	1340
1341	1341
1342	1342
1343	1343
1344	1344
1345	1345
1346	1346
1347	1347
1348	1348
1349	1349
1350	1350
Tì	Teo
Marco Polo	Marko Polo
1351	1351
Hebe Camargo	Hebe Camargo
1400	1400
1401	1401
1352	1352
1402	1402
1353	1353
1403	1403
1354	1354
1404	1404
1355	1355
1405	1405
1500	1500
1406	1406
1356	1356
1501	1501
1407	1407
1357	1357
1502	1502
1408	1408
1358	1358
1503	1503
1359	1359
1409	1409
1504	1504
1360	1360
1410	1410
1505	1505
1506	1506
1411	1411
1361	1361
1507	1507
1412	1412
1362	1362
1413	1413
1508	1508
1363	1363
1509	1509
1414	1414
1510	1510
1415	1415
1364	1364
Co-mhaoineas	Komunismo
1511	1511
1416	1416
1365	1365
1512	1512
1417	1417
1366	1366
Ain-Riaghailteachd	Anarkiismo
1513	1513
1418	1418
1367	1367
1514	1514
1419	1419
Calpachas	Kapitalismo
1368	1368
1515	1515
1420	1420
1369	1369
1516	1516
1421	1421
Libearalas	Liberalismo
1370	1370
Faisisteachas	Faŝismo
Sathara an Iar	Okcidenta Saharo
1371	1371
Dùthaich	Lando
1372	1372
1373	1373
1422	1422
1517	1517
Nàisean	Nacio
1423	1423
1518	1518
1374	1374
1424	1424
1375	1375
1519	1519
1376	1376
1425	1425
1520	1520
1521	1521
1377	1377
1426	1426
1522	1522
1523	1523
1427	1427
1378	1378
1524	1524
1525	1525
1428	1428
1379	1379
1526	1526
1429	1429
1380	1380
1381	1381
1382	1382
1383	1383
1430	1430
1431	1431
Indianapolis, Indiana	Indianapolis
1384	1384
1432	1432
1385	1385
1386	1386
1433	1433
1387	1387
1434	1434
1435	1435
1388	1388
Brabhsair-lìn	TTT-legilo
1436	1436
1389	1389
1437	1437
1390	1390
1438	1438
1391	1391
1439	1439
1392	1392
1440	1440
1393	1393
1394	1394
1395	1395
1441	1441
1396	1396
1397	1397
1442	1442
1527	1527
1528	1528
1398	1398
1443	1443
1444	1444
1529	1529
1399	1399
1445	1445
1530	1530
1446	1446
1531	1531
1447	1447
1532	1532
1448	1448
1533	1533
1449	1449
1534	1534
1450	1450
1535	1535
1451	1451
1536	1536
1452	1452
1537	1537
Département	Departementoj de Francio
1453	1453
1538	1538
1454	1454
1539	1539
1455	1455
1540	1540
Roinn-seòrsa:Reul-eòlas	Kategorio:Astronomio
1541	1541
1456	1456
1457	1457
1542	1542
1458	1458
1543	1543
1459	1459
1544	1544
Jean-Jacques Rousseau	Jean-Jacques Rousseau
1460	1460
1545	1545
1461	1461
1546	1546
Günter Grass	Günter Grass
1462	1462
1547	1547
1463	1463
1548	1548
1464	1464
1549	1549
1465	1465
1550	1550
Belluno	Beluno
1466	1466
1551	1551
1467	1467
1468	1468
1552	1552
1469	1469
1553	1553
1470	1470
1554	1554
Hamstair	Hamstroj
1471	1471
1555	1555
Carcassonne	Karkasuno
Fàsach Sahara	Saharo
1472	1472
1556	1556
Spekulatius	Spekulaco
Gwened	Vannes
1473	1473
1557	1557
1474	1474
1558	1558
1475	1475
1559	1559
1476	1476
1560	1560
1477	1477
1478	1478
1561	1561
1479	1479
1562	1562
1480	1480
1563	1563
1481	1481
1564	1564
1482	1482
1565	1565
Co-ghnèitheachd	Samseksemo
1483	1483
1566	1566
1484	1484
1567	1567
1485	1485
1486	1486
1568	1568
1487	1487
1569	1569
Croatais	Kroata lingvo
1570	1570
Cesena	Cesena
1489	1489
1571	1571
1490	1490
1572	1572
1491	1491
1573	1573
1492	1492
1574	1574
1493	1493
1575	1575
Homer	Homero
1494	1494
1495	1495
1496	1496
1576	1576
1497	1497
1577	1577
1498	1498
1578	1578
1499	1499
1579	1579
1580	1580
1581	1581
1582	1582
1600	1600
1601	1601
1583	1583
1602	1602
1584	1584
1603	1603
1585	1585
1604	1604
1586	1586
1605	1605
1587	1587
1606	1606
1607	1607
1588	1588
1608	1608
1589	1589
1609	1609
1590	1590
1610	1610
1591	1591
1611	1611
1592	1592
1612	1612
1593	1593
1613	1613
1594	1594
1614	1614
1595	1595
1615	1615
1596	1596
1616	1616
1597	1597
1617	1617
1598	1598
1618	1618
1599	1599
1619	1619
1620	1620
1621	1621
1700	1700
1701	1701
1622	1622
1623	1623
1702	1702
1624	1624
1703	1703
1704	1704
1625	1625
1705	1705
1626	1626
1627	1627
1706	1706
Wittenberg	Wittenberg
1628	1628
1707	1707
1708	1708
1629	1629
1630	1630
1709	1709
1631	1631
1710	1710
1632	1632
1711	1711
1633	1633
1712	1712
1634	1634
1713	1713
1800	1800
1801	1801
1714	1714
1635	1635
1802	1802
1715	1715
1636	1636
1803	1803
1637	1637
1716	1716
1638	1638
1804	1804
1717	1717
1639	1639
1805	1805
1718	1718
1640	1640
1719	1719
1806	1806
1641	1641
1720	1720
1807	1807
1642	1642
1721	1721
1808	1808
1643	1643
1722	1722
1809	1809
1644	1644
1723	1723
1810	1810
1645	1645
1724	1724
20mh Linn	20-a jarcento
1811	1811
1646	1646
1725	1725
1812	1812
1647	1647
1726	1726
1813	1813
21mh Linn	21-a jarcento
1648	1648
1727	1727
1814	1814
1649	1649
1728	1728
1815	1815
1650	1650
1729	1729
1816	1816
19mh Linn	19-a jarcento
1651	1651
1730	1730
1817	1817
1652	1652
1731	1731
1818	1818
1653	1653
1732	1732
1819	1819
1654	1654
1733	1733
1820	1820
1655	1655
1821	1821
1734	1734
1656	1656
1822	1822
1735	1735
1657	1657
1823	1823
1736	1736
1658	1658
1737	1737
1824	1824
1659	1659
1738	1738
1825	1825
1660	1660
1739	1739
1826	1826
1661	1661
1740	1740
1827	1827
18mh Linn	18-a jarcento
17mh Linn	17-a jarcento
16mh Linn	16-a jarcento
15mh Linn	15-a jarcento
Lugano	Lugano
Catalanais	Kataluna lingvo
14mh Linn	14-a jarcento
Girona	Ĝirono
13mh Linn	13-a jarcento
12na linn	12-a jarcento
11mh Linn	11-a jarcento
Neo-dhiadhaireachd	Ateismo
Stendal	Stendal
Eag-eòlas	Ekologio
Gintinneachd	Genetiko
Poilitigs	Politiko
Deamocrasaidh	Demokratio
Naguib Mahfouz	Naguib Mahfouz
Marie Curie	Marie Curie
Duais Nobel	Nobel-premio
Qin Shi Huang	Qin Shihuangdi
Girona (provincia)	Provinco Ĝirono
An Ear Mheadhanach	Mezoriento
Ban-rìgh Ealasaid I	Elizabeto la 1-a (Anglio)
Rabindranath Tagore	Rabindranath Tagore
Lev Tolstoj	Lev Tolstoj
Aon-adharcach (each)	Unukornulo
Alan Turing	Alan Turing
Boireann-dhligheachas	Feminismo
Marxachas	Marksismo
Sòisealachd	Socialismo
Pàrtaidh phoileatagach	Partio (politiko)
Kilimanjaro	Kilimanĝaro
Antonín Dvořák	Antonín Dvořák
Georg Friedrich Händel	Georg Friedrich Händel
Giacomo Puccini	Giacomo Puccini
Giuseppe Verdi	Giuseppe Verdi
A' Ghearmailt Nàsach	Nazia Germanio
Cristoforo Colombo	Kristoforo Kolumbo
James Cook	James Cook
Ûrij Gagarin	Jurij Aleksejeviĉ Gagarin
Vasco da Gama	Vasco da Gama
An Cuan a Deas	Suda Oceano
Cluas	Orelo
Sròn	Nazo (organo)
Sùil	Okulo
Òran	Kanto
Caora	Ŝafo
Cearban (iasg)	Ŝarko
Càmhal	Kamelo
Mamal	Mamuloj
Ailbhean	Elefanto
Seillean	Abelo
Bathar-bog	Programaro
Duitsis	Nederlanda lingvo
Margaret Thatcher	Margaret Thatcher
Richard Stallman	Richard Stallman
Irène Joliot-Curie	Irène Joliot-Curie
Deimos	Dejmo (luno)
Màthair	Patrino
Sneachd	Neĝo
Athair	Patro
Pàrant	Generinto
Pàiste	Infano
1828	1828
1829	1829
1741	1741
1662	1662
1742	1742
1830	1830
1663	1663
1831	1831
1743	1743
1664	1664
1665	1665
1744	1744
1832	1832
1666	1666
1745	1745
1833	1833
1667	1667
1746	1746
Giùlan	Transporto
1834	1834
1668	1668
1747	1747
1835	1835
1748	1748
1836	1836
1669	1669
1670	1670
1749	1749
1837	1837
Wildebeest	Gnuo
1671	1671
1750	1750
1838	1838
1672	1672
1751	1751
1839	1839
1673	1673
1752	1752
1840	1840
1674	1674
1753	1753
1841	1841
1754	1754
1675	1675
1842	1842
1755	1755
1676	1676
1843	1843
1677	1677
1756	1756
1844	1844
1678	1678
1757	1757
1845	1845
1679	1679
1758	1758
1846	1846
1680	1680
1759	1759
1847	1847
1681	1681
1760	1760
1848	1848
1682	1682
1761	1761
1849	1849
1683	1683
1762	1762
1850	1850
1684	1684
1763	1763
1851	1851
1764	1764
1685	1685
1852	1852
1686	1686
1765	1765
1853	1853
1687	1687
1766	1766
1854	1854
1688	1688
1767	1767
1855	1855
1689	1689
1768	1768
1856	1856
1690	1690
1769	1769
1857	1857
1691	1691
1770	1770
1858	1858
1692	1692
1771	1771
1859	1859
1693	1693
1772	1772
1860	1860
1773	1773
1861	1861
1694	1694
1695	1695
1774	1774
1862	1862
1696	1696
1775	1775
1863	1863
1697	1697
1776	1776
1864	1864
1698	1698
Uisge-polo	Akvopilkado
1865	1865
1777	1777
1699	1699
1866	1866
1778	1778
1779	1779
1867	1867
1780	1780
1868	1868
1781	1781
1869	1869
Grazia Deledda	Grazia Deledda
Ruisis	Rusa lingvo
Louis XV na Frainge	Ludoviko la 15-a (Francio)
1782	1782
1870	1870
1783	1783
1871	1871
Vladimir Putin	Vladimir Putin
Lagh	Leĝo (jura)
1784	1784
1872	1872
Anailis mhatamataigeach	Analitiko
Bun-reachd	Konstitucio
1785	1785
1873	1873
1786	1786
1874	1874
1787	1787
1875	1875
1788	1788
1876	1876
1789	1789
1877	1877
1790	1790
1878	1878
1879	1879
1791	1791
Sakhalin	Saĥaleno
Aran	Pano
1792	1792
1880	1880
1793	1793
1881	1881
1794	1794
1882	1882
1795	1795
1883	1883
1796	1796
1884	1884
1797	1797
1885	1885
1886	1886
1798	1798
1887	1887
1799	1799
1888	1888
1889	1889
1890	1890
1891	1891
1892	1892
1893	1893
1894	1894
1895	1895
1896	1896
1897	1897
1898	1898
Sìonais	Ĉina lingvaro
1899	1899
Fuil	Sango
Toulouse	Tuluzo
Sgamhan	Pulmo
Analachadh	Spira sistemo
Ròmainis	Rumana lingvo
Bulgàiris	Bulgara lingvo
Uisge-adhair	Pluvo
Maoim-sneachda	Lavango
Blàthachadh na cruinne	Tutmonda varmiĝo
Crith-thalmhainn	Tertremo
Zen	Zeno
Lluís Companys i Jover	Lluís Companys
Lluís Llach i Grande	Lluís Llach
Franklin D. Roosevelt	Franklin D. Roosevelt
Winston Churchill	Winston Churchill
Nelson Mandela	Nelson Mandela
Martin Luther King, Jr.	Martin Luther King
Sìthiche	Feo
10mh Linn	10-a jarcento
Clach	Rokaĵo
Beinn-theine	Vulkano
Neul	Nubo
Cuairt-ghaoth	Tornado (ŝtormo)
9mh Linn	9-a jarcento
8mh Linn	8-a jarcento
Geoimeatras	Geometrio
7mh Linn	7-a jarcento
6mh Linn	6-a jarcento
Gràmar	Gramatiko
Gaoth	Vento
5mh Linn	5-a jarcento
4mh Linn	4-a jarcento
3mh Linn	3-a jarcento
2na Linn	2-a jarcento
Àile	Atmosfero (astro)
1 Linn	1-a jarcento
Eaconomachd	Ekonomiko
Ruith-airgid	Valuto
Cànanachas	Lingvoscienco
Lide	Silabo
Aibidil Arabach	Araba alfabeto
Aibidil Cirileach	Cirila alfabeto
Aibidil Ghreugach	Greka alfabeto
Aibidil Ròmanach	Latina alfabeto
Roinn-seòrsa:Bulgàiria	Kategorio:Bulgario
Litreachas	Literaturo
Roinn-seòrsa:An Fhraing	Kategorio:Francio
Roinn-seòrsa:Ceòl	Kategorio:Muziko
Roinn-seòrsa:Litreachas	Kategorio:Literaturo
Nobhail	Romano
Roinn-seòrsa:Bàrdachd	Kategorio:Poezio
Sionnach	Ruĝa vulpo
Trombaid	Trumpeto
Jazz	Ĵazo
Clàirneid	Klarneto
Trombon	Trombono
Fìdheall	Violono
Valladolid	Valadolido
Alasdair Mòr	Aleksandro la Granda
Foghlam	Eduko
Teaghlach	Familio
Hugo Chávez	Hugo Chávez
Otto von Bismarck	Otto von Bismarck
Pòsadh	Geedzeco
Cogadh sìobhalta	Interna milito
Cofaidh	Kafo
Bainne	Lakto
Beinn	Monto
Fàsach	Dezerto
Simón Bolívar	Simón Bolívar
Andrew Johnson	Andrew Johnson
Iùdais	Jida lingvo
Hong Kong	Honkongo
Miami, Florida	Miamo
Karachi	Karaĉio
Lagos	Lagoso
Cogadh Catharra Ameireaganach	Usona Enlanda Milito
Rio de Janeiro	Rio-de-Ĵanejro
Cogadh Fuar	Malvarma milito
Seoul	Seulo
Shanghai	Ŝanhajo
Bilbao	Bilbao
Sevilla	Sevilo
Archimedes	Arkimedo
Albàinis	Albana lingvo
Michael Faraday	Michael Faraday
Basgais	Eŭska lingvo
Corùna	Korunjo
Radebeul	Radebeul
Ucràinis	Ukraina lingvo
Granada	Granado
València	Valencio
Mallorca	Majorko
Valence (Drôme)	Valence (Drôme)
Málaga	Malago
Sealgair Mòr	Oriono (konstelacio)
Reul-bhad	Konstelacio
Johannes Gutenberg	Johannes Gutenberg
Leas-Rìoghachd Ghranada Ùire	Vicreĝlando de Nova Granado
Mo Yan	Mo Yan
Schaffhausen	Ŝafhaŭzo
Suainis	Sveda lingvo
Danmhairgis	Dana lingvo
James Watt	James Watt
Nirribhis	Norvega lingvo
Noam Chomsky	Noam Chomsky
Lucsamburgais	Luksemburga lingvo
Seacais	Ĉeĥa lingvo
Slòbhacais	Slovaka lingvo
Karl Marx	Karl Marx
Slòbhainis	Slovena lingvo
Ungairis	Hungara lingvo
Voltaire	Voltaire
Eastoinis	Estona lingvo
Maois	Moseo
Latbhais	Latva lingvo
Liotuànais	Litova lingvo
Hionduthachd	Hinduismo
Bealaruisis	Belorusa lingvo
Dmitri Mendeleev	Dmitrij Mendelejev
Ernest Rutherford	Ernest Rutherford
Winterthur	Vinterturo
Greugais	Greka lingvo
Miotas-eòlas	Mitologio
Gàidhlig na h-Èireann	Irlanda lingvo
Jozip Broz Tito	Josip Broz Tito
Anam	Animo
Maltais	Malta lingvo
Genesis	Genezo
Ecsodus	Eliro
Sigmund Freud	Sigmund Freud
Roinn-seòrsa:Reul-bhadan	Kategorio:Konstelacioj
Baku	Bakuo
Làrach Dhualchas na Cruinne	Monda heredaĵo de Unesko
Iùdhachd	Judismo
Thimphu	Timbuo
Bandar Seri Begawan	Bandar-Seri-Begavano
Eabhra	Hebrea lingvo
Sèirbis	Serba lingvo
Cuimris	Kimra lingvo
Dili	Dilo
Immanuel Kant	Immanuel Kant
Gàidhlig	Skotgaela lingvo
John Maynard Keynes	John Maynard Keynes
Vientiane	Vjentiano
Guy de Maupassant	Guy de Maupassant
Lao Zi	Laozio
Malé	Maleo (Maldivoj)
Bishkek	Biŝkeko
Jean-Paul Sartre	Jean-Paul Sartre
Dushanbe	Duŝanbeo
Àdha	Hepato
Adam Smith	Adam Smith
Aotraman	Urina veziko
Coineanach	Kuniklo
Eòlas-inntinn	Psikologio
Cuan	Oceano
Bànrigh Bhictoria	Viktoria (Britio)
Buddha	Sidarto Gotamo
Mohammed	Mohamedo
BBC	BBC
Tony Blair	Tony Blair
Al-Ghazali	Algazelo
Martin Luther	Marteno Lutero
John Major	John Major
James Callaghan	James Callaghan
Gerald Ford	Gerald Ford
Richard Nixon	Richard Nixon
Eaglais Chaitligeach	Katolika Eklezio
Balg	Ventro
Bangla	Bengala lingvo
Machlag	Utero
Teanga	Lango (anatomio)
Amhach	Kolo
Beul	Buŝo
Lyndon B. Johnson	Lyndon B. Johnson
Alt (corp)	Artiko
Broilleach	Brusto
Na h-Eileanan Fàclainn	Insuloj Falklandoj
A	A
Eilean Mhanainn	Manksinsulo
Bànrigh Ealasaid II	Elizabeto la 2-a (Britio)
John F. Kennedy	John F. Kennedy
B	B
Honoré de Balzac	Honoré de Balzac
G	G
U	U
Z	Z
Blues	Bluso
F	F
J	J
Aibidil	Alfabeto
Reggae	Regeo
Sacsafòn	Saksofono
T	T
C	C
Eindhoven	Eindhoven
R	R
Zundert	Zundert
D	D
Alpha	Alfo
Omega	Omego
I	I
Amstelveen	Amstelveen
Mu	Muo (litero)
E	E
H	H
Dwight D. Eisenhower	Dwight D. Eisenhower
Haarlem	Haarlemo
K	K
L	L
M	M
N	N
O	O
Laren	Laren (Norda Holando)
P	P
Q	Q
S	S
Ronald Reagan	Ronald Reagan
V	V
W	W
X	X
Y	Y
Zandvoort	Zandvoort
Deventer	Deventer
Enschede	Enschede
Phi	Fio (litero)
Vlissingen	Vlissingen
Andy Moireach	Andy Murray
LibreOffice	LibreOffice
Zulu (cànan)	Zulua lingvo
Pythagoras	Pitagoro
Iruña	Pamplono
Baraille	Barelo
Zaragoza	Zaragozo
Donostia	Donostio
Almería	Almerio
Dreagbhod	Malgranda Ursino (konstelacio)
Saskatoon	Saskatuno
Gordon Brown	Gordon Brown
Pàrtaidh Nàiseanta na h-Alba	Skota Nacia Partio
1100	1100
Neville Chamberlain	Neville Chamberlain
Roinn-seòrsa:A' Bheiniseala	Kategorio:Venezuelo
Beul Feirste	Belfasto
Caerdydd	Cardiff
Tórshavn	Tórshavn
Georgetown, Guiana	Ĝorĝtaŭno (Gujano)
9/11	Atencoj de la 11-a de septembro 2001
Pèist	Reptilioj
Mariano Rajoy Brey	Mariano Rajoy
Creimiche	Ronĝuloj
Calman	Kolombedoj
Cogadh Sìobhalta na Spàinne	Hispana Enlanda Milito
Peileag	Porkocetoj
Craobh	Arbo
Lambda	Lambdo
Dà-bheathach	Amfibioj
Rèabhlaid	Revolucio
Càise	Fromaĝo
Rugbaidh lìog	Rugbeo 13
Mil	Mielo
Feòil	Viando
Buntàta	Terpomo
Siùcar	Sukero
Taigh nam Morairean	House of Lords
Snùcair	Snukero
Teicneòlas	Teknologio
Inneal	Maŝino
Innleadaireachd	Inĝenierarto
Conaltradh	Komunikado
Pàipear-naidheachd	Gazeto
Clò-bhualadh	Presarto
Fòn	Telefono
Na Rolling Stones	The Rolling Stones
Pinnt	Pajnto
Lugo	Lugo (Hispanio)
Searbhag	Acido
Comharradh-ceiste	Demandosigno
Co-thàth	Kemia kombinaĵo
22mh Linn	22-a jarcento
Eòlas-leighis	Medicino
Sarajevo	Sarajevo
Àireamhachd	Aritmetiko
Siostaman cho-chomharran	Koordinatsistemo
Salann	Salo
Roinn-seòrsa:Braisil	Kategorio:Brazilo
Roinn-seòrsa:Romàinia	Kategorio:Rumanio
Ceàrn (Matamataig)	Angulo
Gualuisg	Karbonhidrato
Lùth	Energio
Ròc	Rok-muziko
Hip-hop	Hiphopo
Apartheid	Apartismo
Geama	Ludo
Iom-tharraing	Gravito
Go	Goo
Tomad	Maso
Film	Filmo
Meatailt	Metalo (fiziko)
Stàilinn	Ŝtalo
Gas	Gaso
Carbad-adhair	Flugmaŝino
Rothair	Biciklo
Long	Ŝipo
Àiteachas	Agrikulturo
Cotan	Kotono
Aodach	Vesto
Crann-treabhaidh	Plugilo
Pàipear	Papero
Farsaingeachd	Areo
Àireamh	Nombro
Darwin, Astràilia	Darvino
Cruithneachd Innseanach	Maizo
Harry S. Truman	Harry S. Truman
Judy Garland	Judy Garland
Dannsa	Danco
Aimsir	Vetero
Cinn-suidhe nan Stàitean Aonaichte	Prezidanto de Usono
Dùthchannan an t-Saoghail	Listo de sendependaj ŝtatoj
Mathan	Urso
John Adams	John Adams
Thomas Jefferson	Thomas Jefferson
James Madison	James Madison
James Monroe	James Monroe
John Quincy Adams	John Quincy Adams
Andrew Jackson	Andrew Jackson
Martin Van Buren	Martin Van Buren
Silvio Berlusconi	Silvio Berlusconi
William Henry Harrison	William H. Harrison
John Tyler	John Tyler
James K. Polk	James K. Polk
Zachary Taylor	Zachary Taylor
Bern (Kanton)	Kantono Berno
Genève (Canton)	Kantono Ĝenevo
Glarus (Kanton)	Kantono Glaruso
Grischuns (Chantun)	Kantono Grizono
Solothurn (Kanton)	Kantono Soloturno
Kevin Costner	Kevin Costner
Zug (Kanton)	Kantono Zugo
Zürich (Kanton)	Kantono Zuriko
Alacant	Alakanto
Aargau (Kanton)	Kantono Argovio
Las Palmas de Gran Canaria	Las Palmas de Gran Canaria
Foto-cho-chur	Fotosintezo
Leatrom	Gravedeco
Darach	Kverko
Giuthas	Pino
1101	1101
1102	1102
Aillse	Kancero
Appenzell Ausserrhoden (Kanton)	Kantono Apencelo Ekstera
Appenzell Innerrhoden (Kanton)	Kantono Apencelo Interna
Coirce	Kutima aveno
Breatannais	Bretona lingvo
Luzern (Kanton)	Kantono Lucerno
Bodhar	Surdeco
Roinn-tìde	Horzono
Basel-Landschaft (Kanton)	Kantono Bazelo Kampara
Slàinte	Sano
Basel-Stadt (Kanton)	Kantono Bazelo Urba
Gàidhlig Mhanainn	Manksa lingvo
Naoned	Nanto (Francio)
Brest	Brest (Francio)
AIDS	Aidoso
A' Chaitheamh	Tuberkulozo
Breac (tinneas)	Variolo
Stanley	Stanlejo
Huelva	Onubo
Ailtireachd	Arkitekturo
Drochaid	Ponto
Millard Fillmore	Millard Fillmore
Franklin Pierce	Franklin Pierce
James Buchanan	James Buchanan
Uri (Kanton)	Kantono Urio
Pontevedra	Pontevedro
Schwyz (Kanton)	Kantono Ŝvico
Newton	Neŭtono (mezurunuo)
Detroit, Michigan	Detrojto
Königswinter	Königswinter
Siostam Eadar-nàiseanta nan Aonadan	Internacia sistemo de unuoj
Staitistearachd	Statistiko
1103	1103
1104	1104
Balla Mòr Shìona	Granda Ĉina Muro
Cruinne	Sfero
Gard (département)	Gard
Biorramaid	Piramido
Gers	Gers
Gironde	Gironde
Haute-Garonne	Haute-Garonne
Soillseachadh	Klerismo
Hauts-de-Seine	Hauts-de-Seine
An t-Impireachd Bheasantian	Bizanca imperio
Hérault	Hérault
Il-ha-Gwilen	Ille-et-Vilaine
Indre	Indre
Meadhan-aoisean	Mezepoko
Indre-et-Loire	Indre-et-Loire
Isère	Isère
An t-Ath-Leasachadh	Reformacio
Landes (département)	Landes
Loir-et-Cher	Loir-et-Cher
Na Lochlannaich	Vikingoj
Haute-Loire	Haute-Loire
Obwalden (Kanton)	Kantono Obvaldo
Loiret	Loiret
Lot (département)	Lot
Lot-et-Garonne	Lot-et-Garonne
Lozère	Lozère
Maine-et-Loire	Maine-et-Loire
Aimearaga-Laideannach	Latin-Ameriko
Manche	Manche
Nidwalden (Kanton)	Kantono Nidvaldo
Marne	Marne
Haute-Marne	Haute-Marne
Mayenne	Mayenne
Meurthe-et-Moselle	Meurthe-et-Moselle
Camas Mheagsago	Meksika Golfo
Meuse	Meuse
Làn-thoradh Dùthchail	Malneta enlanda produkto
Fribourg (Canton)	Kantono Friburgo
Mor-Bihan	Morbihan
Moselle (département)	Moselle
Nièvre	Nièvre
Wilhelm Ostwald	Wilhelm Ostwald
Nord (département)	Nord
Oise	Oise (departemento)
Orne	Orne
Pas-de-Calais	Pas-de-Calais
Puy-de-Dôme	Puy-de-Dôme
Schaffhausen (Kanton)	Kantono Ŝafhaŭzo
Hautes-Pyrénées	Hautes-Pyrénées
Pyrénées-Atlantiques	Pyrénées-Atlantiques
Lùth ath-nuadhachail	Renoviĝanta energio
Pyrénées-Orientales	Pyrénées-Orientales
Thurgau (Kanton)	Kantono Turgovio
Bas-Rhin	Bas-Rhin
Haut-Rhin	Haut-Rhin
Ticino (Cantone)	Kantono Tiĉino
Dealan	Elektro
Haute-Saône	Haute-Saône
Saône-et-Loire	Saône-et-Loire
Neuchâtel (Canton)	Kantono Neŭŝatelo
Sarthe	Sarthe
Beul-àtha	Vadejo
Savoie (département)	Savoie
St. Gallen (Kanton)	Kantono Sankt-Galo
Haute-Savoie	Haute-Savoie
Seine-et-Marne	Seine-et-Marne
Jura (Canton)	Kantono Ĵuraso
Inneal broinne-losgaidh	Eksplodmotoro
Seine-Maritime	Seine-Maritime
Inneal-stotha	Vapormaŝino
Seine-Saint-Denis	Seine-Saint-Denis
Deux-Sèvres	Deux-Sèvres
Somme (département)	Somme
Vaud (Canton)	Kantono Vaŭdo
Tarn (département)	Tarn
Tarn-et-Garonne	Tarn-et-Garonne
Territoire de Belfort	Territoire de Belfort
Val-d'Oise	Val-d'Oise
Val-de-Marne	Val-de-Marne
Var (département)	Var (departemento)
Claidheamh	Glavo
Vaucluse	Vaucluse
Vendée	Vendée
Vienne	Vienne (departemento)
Haute-Vienne	Haute-Vienne
Yonne	Yonne
Yvelines	Yvelines
Ceàrn	Komarko
Reinhard Selten	Reinhard Selten
Majuro	Majuro
Fano	Fano (Italio)
Sùbh-craoibh	Frambo
Rumantsch	Romanĉa lingvo
Bàrr a' bhainne	Kremo
Reòiteag	Glaciaĵo
Sòrbais Uarach	Suprasoraba lingvo
Briosgaid	Biskvito
Sòrbais Ìosal	Malsuprasoraba lingvo
Graz	Graz
Nahuatl (cànan)	Naŭatla lingvo
Navajo (cànan)	Navaha lingvo
Imperia	Imperia (Italio)
Ravenna	Raveno
Oilthigh Harvard	Universitato Harvard
Pistoia	Pistojo
Nuoro	Nuoro
Agrigento	Agrigento
1105	1105
Lleida (provincia)	Provinco Ilerdo
Île-de-France	Francilio
Centre-Val de Loire	Centro-Valo de Luaro
Piocardaidh	Pikardio
Arabais	Araba lingvo
Tartu	Tartu
Casanare (Roinn)	Kasanareo
Caquetá (Roinn)	Kaketao
Kyūshū	Kjuŝuo
Honshū	Honŝu
Valle del Cauca (Roinn)	Valo de Kaŭko
Shikoku	Ŝikokuo
Risaralda (Roinn)	Risaraldo
Quindío (Roinn)	Kindio
Dolair Aimearaganach	Dolaro (monunuo)
Champagne-Ardenne	Ĉampanjo-Ardenoj
Corsaca	Korsiko
Ogsatanais	Okcitana lingvo
Afraganais	Afrikansa lingvo
Aarau	Araŭo
Santiago de Compostela	Santiago de Compostela
Vitoria-Gasteiz	Vitorio (Hispanio)
Santa Cruz de Tenerife	Santa Cruz de Tenerife
Tyrannosaurus	Tiranosaŭro
Iasgach	Fiŝkaptado
Beta	Beto (litero)
Gamma	Gamo (litero)
Delta	Delto (litero)
Epsilon	Epsilono
Zeta	Zeto
Eta	Eto (litero)
Theta	Teto
Iota	Joto
Kappa	Kapo (litero)
Nu	Nuo (litero)
Xi	Ksio
Omicron	Omikrono
Rho	Roto (litero)
Sigma	Sigmo
Tau	Taŭo (litero)
Loch Lugano	Lago de Lugano
Upsilon	Upsilono
Chi	Ĥio (litero)
Psi	Psio (litero)
A' Bheurla Ghallda	Skota lingvo
Emmen	Emmen (Nederlando)
Lùireach	Blazono
Caolabhain	Krajono
Àirneis	Meblo
Bòrd (àirneis)	Tablo
Macau	Makao
Bautzen	Bautzen
Aurich	Aurich
Bernburg	Bernburg
Crann-sneachda	Neĝoplugilo
Daleth	Daleto
Sioraf	Ĝirafo (specio)
Tarragona	Taragono
Lleida	Ilerdo
Castelló de la Plana	Castelló
Provence-Alpes-Côte d'Azur	Provenco-Alpoj-Bordo Lazura
Bile (corp)	Lipo
Aonadh Sobhiat	Sovetunio
Lord of the Rings ( leabhar )	La Mastro de l' Ringoj
Loch Ladoga	Ladoga (lago)
Platapas gob-tunnaige	Ornitorinko
Cáceres	Cáceres
Badajoz	Badaĥozo
Jaén (baile)	Ĥaeno
Cádiz	Kadizo
Salamanca	Salamanko
Bun-na-coise	Piedo
Queen	Queen
Freddie Mercury	Freddie Mercury
Amy Winehouse	Amy Winehouse
Altenburg	Altenburg
Cnàmh an ugain	Klaviklo
Gualann	Ŝultro
Peirceall	Mandiblo
Humphrey Bogart	Humphrey Bogart
Midi-Pyrénées	Sudo-Pireneoj
Franche-Comté	Franĉkonteo
Teamplaid:Link FA	Ŝablono:LigoElstara
Uicipeid:Talla a' Bhaile	Vikipedio:Diskutejo
České Budějovice	České Budějovice
Bàirdse	Barĝo
Breitheamh	Juĝisto
Vermont	Vermonto
San Diego, Calafòrnia	San-Diego
San Jose, Calafòrnia	San Jose (Kalifornio)
Denver	Denvero (Koloradio)
Houston, Texas	Houston (Teksaso)
Phoenix, Arizona	Fenikso (Arizono)
Dallas, Texas	Dallas (Teksaso)
Fort Worth, Texas	Fort Worth
Memphis, Tennessee	Memphis (Tenesio)
Columbus, Ohio	Columbus (Ohio)
Jacksonville, Florida	Jacksonville (Florido)
Justus von Liebig	Justus von Liebig
Samoa Aimearaganach	Usona Samoo
Basse-Normandie	Malsupra Normandio
A' Ghearmailt an Ear	Germana Demokratia Respubliko
Haute-Normandie	Supra Normandio
Pàpa Pòl VI	Paŭlo la 6-a
Nord-Pas-de-Calais	Nordo-Kaleza Markolo
Pays de la Loire	Luarlandoj
Languedoc-Roussillon	Langvedoko-Rusiljono
Poitou-Charentes	Puatuo-Ĉarentoj
Guadeloupe	Gvadelupo
Oakland, Calafòrnia	Oakland (Kalifornio)
Martinique	Martiniko
Mayotte	Majoto
Réunion	Reunio
Ugh	Ovo
Cearcall	Cirklo
Bosco Marengo	Bosco Marengo
Tenzin Gyatso	Tenzin Gyatso
Donald Knuth	Donald Knuth
Diego Armando Maradona	Diego Armando Maradona
Fòn-làimh	Poŝtelefono
Struth (eun)	Struto
Aicseam	Aksiomo
Portacomaro	Portacomaro
LCDT	GLAT
Sappho	Sapfo
Sacramento, Calafòrnia	Sakramento (Kalifornio)
Honolulu	Honolulu
Coirea	Koreio
1925	1925
1927	1927
Manchester	Manchester
Gao Xingjian	Gao Xingjian
Alfonso XIII na Spàinne	Alfonso la 13-a (Hispanio)
Providence, Rhode Island	Providence (Rod-Insulo)
Sasainn Nuadh	Nov-Anglio
Alatri	Alatri
Joseph Stiglitz	Joseph E. Stiglitz
1000	1000
999	999
Faol	Lupo
Bàlla	Pilko
Doolish	Douglas (Mankso)
Tucson, Arizona	Tucson (Arizono)
1955	1955
1954	1954
1953	1953
1951	1951
1950	1950
1946	1946
1943	1943
1942	1942
1940	1940
1939	1939
1938	1938
1937	1937
1936	1936
1935	1935
Swansea City A.F.C.	Swansea City
1934	1934
1933	1933
1932	1932
1931	1931
1930	1930
1929	1929
Pyongyang	Pjongjango
Tiomnadh Nuadh	Nova testamento
Cuthag	Kukolo
Edwin Mattison McMillan	Edwin Mattison McMillan
2010an	2010-aj jaroj
George Bernard Shaw	George Bernard Shaw
Tìr-mòr na Sìne	Ĉeftera Ĉinio
1001	1001
1002	1002
1003	1003
1005	1005
1006	1006
1007	1007
1008	1008
1009	1009
1010	1010
1011	1011
1012	1012
1013	1013
1014	1014
1015	1015
1016	1016
1017	1017
1018	1018
1019	1019
1020	1020
1021	1021
1022	1022
1023	1023
1024	1024
1025	1025
1026	1026
1027	1027
1028	1028
1029	1029
1030	1030
1031	1031
1032	1032
1033	1033
1034	1034
1035	1035
1036	1036
1037	1037
1038	1038
1039	1039
1040	1040
1041	1041
1042	1042
1043	1043
1044	1044
1045	1045
1046	1046
1047	1047
1048	1048
1049	1049
1050	1050
1051	1051
1052	1052
1053	1053
1054	1054
1055	1055
1056	1056
1057	1057
1058	1058
1059	1059
1060	1060
1061	1061
1062	1062
1063	1063
1064	1064
1065	1065
1066	1066
Pelican	Pelikano
1067	1067
1068	1068
1069	1069
1070	1070
1071	1071
1072	1072
1073	1073
1074	1074
1075	1075
1076	1076
1077	1077
1078	1078
1079	1079
1080	1080
1081	1081
1082	1082
1083	1083
1084	1084
1085	1085
1086	1086
1087	1087
1088	1088
1089	1089
1090	1090
1091	1091
1092	1092
1093	1093
1094	1094
1095	1095
1096	1096
1097	1097
1098	1098
1099	1099
1106	1106
1107	1107
1108	1108
1109	1109
1110	1110
Podolsk	Podolsk
1111	1111
1112	1112
1113	1113
1114	1114
1115	1115
1116	1116
1117	1117
1118	1118
1119	1119
1120	1120
Pàpa	Papo
1130	1130
1131	1131
Rafael Correa	Rafael Correa
1132	1132
1133	1133
1134	1134
1135	1135
1136	1136
1137	1137
1138	1138
1139	1139
5	5
1140	1140
1141	1141
1142	1142
1143	1143
1144	1144
4	4
1145	1145
1146	1146
1147	1147
1148	1148
3	3
1149	1149
1150	1150
1151	1151
1152	1152
1153	1153
2	2
1154	1154
1155	1155
1156	1156
1157	1157
1158	1158
1159	1159
Bucharest	Bukareŝto
1160	1160
1161	1161
1162	1162
1163	1163
1164	1164
Louvre	Luvro
1165	1165
1166	1166
1167	1167
1168	1168
1169	1169
1170	1170
Buidheann neo-eisimeileachd na Porto Riko	Partio de la Sendependeco de Porto-Riko
1171	1171
1172	1172
1173	1173
Tirana	Tirano
1174	1174
1175	1175
1176	1176
1177	1177
1178	1178
Motörhead	Motörhead
1179	1179
1180	1180
1181	1181
Asal	Azeno
1182	1182
1928	1928
1183	1183
1184	1184
1185	1185
1186	1186
1187	1187
1188	1188
1189	1189
1190	1190
1191	1191
1192	1192
1193	1193
1194	1194
1195	1195
1196	1196
1197	1197
1198	1198
1199	1199
6	6
Seann Tiomnadh	Malnova testamento
Josh Duhamel	Josh Duhamel
Nollaig	Kristnasko
Cànanan Ròmanach	Latinida lingvaro
Bliadhna-leum	Superjaro
Steve Jobs	Steve Jobs
Lady Gaga	Lady Gaga
Cànanan Innd-Eòrpach	Hindeŭropa lingvaro
Breinigerberg	Breinigerberg
Muammar al-Gaddafi	Muamar Kadafi
Tìgear	Tigro
Rìgh Juan Carlos I na Spàinne	Johano Karlo la 1-a (Hispanio)
Francesco Totti	Francesco Totti
Bonnach-uighe	Omleto
Àrd-Dhiùcachd Hesse	Hesio-Darmstadt
Mirow	Mirow
Feldberger Seenlandschaft	Feldberger Seenlandschaft
Neustrelitz	Neustrelitz
Eideard VII	Eduardo la 7-a
Lugaidh	Sablovermo
Fredericia	Fredericia
Lochlann	Skandinavio
A' Chàisg	Pasko
Chişinău	Kiŝinevo
Cànain Ghearmaineach	Ĝermana lingvaro
Eòlas-comainn	Sociologio
Şalom	Şalom
Aibidil Eadar-nàiseanta Fogharach	Internacia Fonetika Alfabeto
Oilthigh Phrinceton	Universitato Princeton
Echidna	Ekidno
Opossum	Didelfedoj
Taidh-Bhàn (eilean)	Tajvano
Aurora, Illinois	Aurora (Ilinojo)
New York	New York
Cruadhtan	Betono
Co-chomharran an Domhain	Geografia koordinata sistemo
Rathad-iarainn	Fervojo
Bròg	Ŝuo
Banca	Banko
Pàirce	Parko
Dùmhlachd-sluaigh	Loĝdenso
Èirinn	Irlando (insulo)
Abertawe	Swansea
Roinn Eilbheiseach	Kantonoj de Svislando
Sneek	Sneek
1	1
A’ Chòrn	Kornvalo
Bristol	Bristolo
Wombat	Vombato
10	10
Nashville, Tennessee	Naŝvilo (Tenesio)
20	20
Spinazzola	Spinazzola
30	30
40	40
9	9
7	7
8	8
Taylor Lautner	Taylor Lautner
Jeremy Renner	Jeremy Renner
12	12
Seòl-mara	Tajdo
Fiadh	Cervedoj
Dèigh	Glacio
Ùrnaigh an Tighearna	Patro nia
Loch-uisge	Lago
Musée d'Orsay	Musée d'Orsay
Corp-eòlas	Antropologio
930	930
13	13
985	985
1122	1122
981	981
939	939
Ulan Bator	Ulaanbaataro
Ernest Hemingway	Ernest Hemingway
Dùn Èideann	Edinburgo
Ashgabat	Aŝgabato
51	51
Eilean	Insulo
814	814
678	678
950	950
679	679
996	996
680	680
37	37
980	980
900	900
1129	1129
Chris Pine	Chris Pine
843	843
Lordi	Lordi
690	690
691	691
988	988
692	692
476	476
693	693
Marseille	Marsejlo
694	694
695	695
Uinnean	Cepo
696	696
697	697
698	698
Cànan Oifigeil	Oficiala lingvo
699	699
700	700
Moshchena	Moŝĉena
701	701
702	702
Àrc-eòlas	Arkeologio
703	703
Tomàto	Tomato
704	704
705	705
George H. W. Bush	George H. W. Bush
706	706
68	68
89	89
707	707
708	708
709	709
11	11
710	710
711	711
712	712
Na Balcain	Balkana duoninsulo
713	713
714	714
Cànanan Slàbhach	Slava lingvaro
715	715
Dmitry Medvedev	Dmitrij Medvedev
716	716
717	717
718	718
Entrena	Entrena
719	719
720	720
Pròsdanachas	Protestantismo
721	721
722	722
723	723
NASA	NASA
724	724
725	725
726	726
Atlanta	Atlanta (Georgio)
727	727
Benito Mussolini	Benito Mussolini
728	728
729	729
963	963
730	730
Podgorica	Podgorico
731	731
Lost	Lost (televida serio)
962	962
732	732
733	733
997	997
734	734
972	972
735	735
955	955
901	901
736	736
737	737
936	936
738	738
953	953
902	902
739	739
15	15
740	740
14	14
741	741
742	742
17	17
743	743
958	958
744	744
500	500
745	745
150	150
746	746
880	880
747	747
748	748
749	749
870	870
903	903
750	750
HBO	Home Box Office
751	751
Bermuda	Bermudo
752	752
Ceann	Kapo
753	753
987	987
754	754
965	965
755	755
924	924
951	951
932	932
Wellington, Sealainn Nuadh	Velingtono
Breatainn Mhòr	Britio (insulo)
23	23
800	800
Jimmy Carter	Jimmy Carter
120	120
Laoidh Nàiseanta	Nacia himno
42	42
967	967
989	989
960	960
969	969
957	957
1124	1124
971	971
937	937
992	992
990	990
899	899
975	975
942	942
966	966
1128	1128
959	959
973	973
18	18
19	19
16	16
21	21
26	26
41	41
32	32
33	33
982	982
974	974
976	976
979	979
986	986
919	919
998	998
995	995
977	977
1125	1125
Valletta	La-Valeto
934	934
200	200
876	876
875	875
810	810
929	929
882	882
1127	1127
940	940
889	889
844	844
912	912
838	838
984	984
874	874
38	38
43	43
127	127
954	954
39	39
24	24
79	79
61	61
104	104
29	29
102	102
866	866
Pàpa Iain XXIII	Johano la 23-a
839	839
622	622
918	918
100	100
Lila Downs	Lila Downs
961	961
570	570
632	632
Andrew Garfield	Andrew Garfield
946	946
835	835
884	884
859	859
832	832
849	849
877	877
Sìotà	Gepardo
878	878
861	861
869	869
968	968
983	983
964	964
1121	1121
1123	1123
933	933
915	915
970	970
911	911
993	993
991	991
994	994
898	898
944	944
907	907
943	943
945	945
922	922
905	905
941	941
925	925
928	928
948	948
947	947
949	949
926	926
126	126
101	101
105	105
108	108
117	117
115	115
Gual	Terkarbo
22	22
46	46
25	25
153	153
156	156
31	31
825	825
Vancouver	Vankuvero
301	301
116	116
886	886
330	330
860	860
842	842
165	165
871	871
893	893
203	203
909	909
222	222
931	931
938	938
917	917
160	160
28	28
Poll a' Ghrùthain	Liverpool
85	85
88	88
76	76
54	54
477	477
914	914
920	920
913	913
935	935
841	841
820	820
906	906
Bremen	Bremeno
916	916
885	885
Gnìomhair	Verbo
168	168
Ficsean-saidheans	Sciencfikcio
60	60
47	47
836	836
112	112
854	854
862	862
879	879
887	887
770	770
817	817
864	864
863	863
868	868
855	855
818	818
837	837
845	845
Wangerooge	Wangerooge
166	166
Punnd Sasannach	Brita pundo
Guernsey	Guernsey
Svalbard	Svalbardo
Lon dubh	Merlo
Uair	Horo
Peasair	Ĝardena pizo
Beith	Betulo
2016	2016
Nowy Dwór Królewski	Nowy Dwór Królewski
Fàrothais	Feroa lingvo
Sgoil-aimsir	Meteologio
552	552
Joule	Ĵulo
Corra-ghritheach	Griza ardeo
2019	2019
Hispaniola	Hispaniolo
Harrisburg, Pennsylvania	Harrisburg (Pensilvanio)
Da Lat	Da Lat
Uppsala	Upsalo
Göteborg	Göteborg
Còrnais	Kornvala lingvo
2017	2017
2018	2018
Cànanan Ceilteach	Kelta lingvaro
6mh linn RC	6-a jarcento a.K.
1ad linn RC	1-a jarcento a.K.
2na linn RC	2-a jarcento a.K.
Washington	Washington
Pioghaid	Eŭropa pigo
Neas bheag	Vizelo
Comhachag	Turstrigo
Aarhus	Arhuzo
3mh linn RC	3-a jarcento a.K.
Brù-dhearg	Ruĝgorĝulo
4mh linn RC	4-a jarcento a.K.
Pocanach	Marsupiulo
2020	2020
5mh linn RC	5-a jarcento a.K.
7mh linn RC	7-a jarcento a.K.
Cumhachd	Povumo
Neas mhòr	Ermeno
8mh linn RC	8-a jarcento a.K.
Tunnag fhiadhaich	Platbeka anaso
Theodor Mommsen	Theodor Mommsen
Fitheach	Korako
Meanbh-bheò	Planktono
Dràma	Dramo (verko)
Atlantis	Atlantido
Breacan-beithe	Fringo
Leeuwarden	Leeuwarden
Curracag	Vanelo
Cadhag	Monedo
Breac an t-sìl	Blanka motacilo
Faidhbhile	Fago
Helsingborg	Helsingborg
Deargan-fraoich	Kardelo
9mh linn RC	9-a jarcento a.K.
10mh linn RC	10-a jarcento a.K.
Gobhlan-gaoithe	Kamphirundo
Sgarbh	Granda kormorano
Sòrbais	Soraba lingvo
Funchal	Funchal
Bovidae	Bovedoj
Sjælland	Sjælland
600	600
St. Gallen	Sankt-Galo
400	400
300	300
Aiseag	Pramo
Aiteann	Junipero
1mh mìle-bliadhna RC	1-a jarmilo a.K.
Dreathan donn	Troglodito
Kaikoura District	Kaikoura
2 mìle-bliadhna	2-a jarmilo
1 mìle-bliadhna	1-a jarmilo
Antalop	Antilopo
Uiseag	Kampalaŭdo
Hermann Hesse	Hermann Hesse
Coileach-coille	Eŭrazia skolopo
Växjö	Växjö
Neòinean	Lekanteto
Buidheag-bhealaidh	Flava emberizo
3mh mìle-bliadhna	3-a jarmilo
Esbjerg	Esbjerg
Madeira	Madejro
2 mìle-bliadhna RC	2-a jarmilo a.K.
Oilthigh Niccolò Cusano	Università degli Studi Niccolò Cusano
Smeòrach	Kantoturdo
Dordrecht	Dordrecht
Montpelier, Vermont	Montpelier (Vermonto)
Tilburg	Tilburg
1040an	1040-aj jaroj
Hidalgo County, Texas	Kantono Hidalgo (Teksaso)
Saideal fuadain	Artefarita satelito
Yak	Gruntbovo
Cam-ghob	Malgranda krucbekulo
Arspag	Nigramantela mevo
Lach-mhòr	Molanaso
Clo-mheas	Kariofilo
Beanntan Sierra Nevada	Sierra Nevada (Usono)
Spruis	Piceo
Coileach Frangach	Komuna meleagro
San Andrés y Providencia (Roinn)	Sankta Andreo kaj Providenco
Inneal-fogharaidh	Kombajno
Ròn cumanta	Ordinara foko
Háček	Haĉeko
Wayne County, Utah	Kantono Wayne (Utaho)
Broc	Melo
Garding	Garding
Crìonag	Fajroverta regolo
Afraga-Eoràisia	Afrik-Eŭrazio
Faoileag	Mevo
Aimearaga Mheadhanach	Centra Ameriko
Mikhail Bakunin	Miĥail Bakunin
Ostfriesische Inseln	Orientfrisaj insuloj
Chester County, Pennsylvania	Kantono Chester (Pensilvanio)
Beus	Baso
Gille-fionntrainn	Litorino
Caineal	Cinamo
Jackson, Mississippi	Jackson (Misisipio)
Augusta, Maine	Augusta (Majno)
Lansing, Michigan	Lansing (Miĉigano)
Amarais	Amhara lingvo
Concord, Hampshire Nuadh	Concord (Nov-Hampŝiro)
Oitir	Sablobenko
Ialtag	Kiropteroj
36	36
Falt	Haro
Springfield, Illinois	Springfield (Ilinojo)
Tarnobrzeg	Tarnobrzeg
Neas	Musteloj
Frankfort, Kentucky	Frankfort (Kentukio)
Proifeasan	Profesio
Saint Paul, Minnesota	Saint Paul (Minesoto)
Glaisean	Paseredoj
Miloš Zeman	Miloš Zeman
C.B. Kuban Krasnodar	FK Kuban Krasnodar
Francisco Franco	Francisco Franco
Easbaig	Episkopo
Tarja Halonen	Tarja Halonen
Sant-Brieg	Saint-Brieuc
Bill Murray	Bill Murray
Montgomery, Alabama	Montgomery (Alabamo)
Sìona (roinn chultarach)	Ĉinio
Dluthad	Denso
Ferio	Ferlo
815	815
816	816
822	822
840	840
823	823
3mh mìle-bliadhna RC	3-a jarmilo a.K.
811	811
771	771
Mordvin	Erzja lingvo
888	888
768	768
851	851
205	205
159	159
Gallais	Gaŭla lingvo
107	107
162	162
103	103
802	802
804	804
119	119
118	118
801	801
807	807
806	806
Cafaidh	Kafejo
152	152
Beàrnan-brìde	Taraksako
240	240
218	218
655	655
496	496
238	238
197	197
451	451
775	775
489	489
Dà-chànanas	Plurlingveco
784	784
661	661
625	625
653	653
904	904
921	921
923	923
1126	1126
668	668
636	636
408	408
464	464
Rionnach	Skombro
410	410
956	956
952	952
658	658
650	650
518	518
70	70
81	81
Leopard-sneachda	Neĝleopardo
Boglach	Aluvia grundo
69	69
87	87
65	65
66	66
67	67
55	55
34	34
44	44
35	35
64	64
504	504
Ròn	Fokuloj
453	453
161	161
169	169
481	481
151	151
155	155
128	128
129	129
463	463
193	193
674	674
687	687
251	251
337	337
786	786
660	660
50	50
260	260
501	501
45	45
491	491
49	49
Ecser	Ecser
978	978
Cànan Silesianach	Silezia lingvo
221	221
543	543
536	536
230	230
762	762
610	610
787	787
480	480
209	209
202	202
192	192
681	681
819	819
173	173
867	867
865	865
827	827
824	824
847	847
883	883
829	829
813	813
910	910
850	850
808	808
853	853
872	872
873	873
856	856
858	858
831	831
857	857
828	828
826	826
833	833
848	848
834	834
881	881
852	852
163	163
154	154
201	201
803	803
805	805
52	52
532	532
82	82
84	84
73	73
72	72
62	62
71	71
75	75
74	74
83	83
78	78
77	77
90	90
80	80
627	627
456	456
91	91
190	190
109	109
53	53
270	270
688	688
452	452
795	795
465	465
778	778
846	846
830	830
404	404
908	908
896	896
897	897
927	927
63	63
555	555
571	571
86	86
401	401
890	890
533	533
264	264
Mikhail Gorbachev	Miĥail Gorbaĉov
99	99
415	415
483	483
469	469
462	462
459	459
466	466
402	402
761	761
780	780
675	675
689	689
774	774
759	759
Seabhag	Migra falko
758	758
350	350
782	782
760	760
785	785
783	783
767	767
766	766
211	211
232	232
204	204
188	188
98	98
894	894
891	891
602	602
628	628
892	892
601	601
672	672
682	682
821	821
648	648
686	686
664	664
677	677
640	640
110	110
111	111
137	137
138	138
122	122
140	140
809	809
167	167
665	665
776	776
763	763
769	769
667	667
529	529
777	777
788	788
671	671
772	772
432	432
231	231
237	237
239	239
Auguste Rodin	Auguste Rodin
130	130
226	226
207	207
475	475
454	454
495	495
206	206
468	468
461	461
460	460
194	194
210	210
225	225
311	311
220	220
541	541
642	642
Oscar Wilde	Oscar Wilde
313	313
180	180
794	794
587	587
530	530
609	609
497	497
540	540
428	428
Neach-seinn àirde	Soprano
548	548
422	422
549	549
457	457
478	478
253	253
467	467
458	458
158	158
157	157
164	164
124	124
113	113
121	121
106	106
551	551
494	494
320	320
242	242
291	291
48	48
97	97
56	56
93	93
Alofi	Alofo
57	57
Poilinèis na Frainge	Franca Polinezio
Rouen	Rueno
503	503
510	510
509	509
474	474
484	484
576	576
493	493
479	479
287	287
407	407
485	485
547	547
546	546
544	544
537	537
535	535
502	502
527	527
Yaren	Jareno
508	508
525	525
613	613
618	618
617	617
608	608
645	645
621	621
606	606
623	623
604	604
603	603
626	626
619	619
634	634
630	630
614	614
505	505
446	446
791	791
557	557
Àireamhair	Kalkulilo
656	656
657	657
659	659
651	651
676	676
670	670
652	652
673	673
654	654
647	647
812	812
669	669
792	792
649	649
895	895
756	756
663	663
779	779
662	662
684	684
773	773
757	757
435	435
790	790
437	437
433	433
764	764
426	426
781	781
425	425
429	429
423	423
765	765
235	235
233	233
223	223
224	224
216	216
219	219
254	254
272	272
208	208
175	175
170	170
171	171
172	172
58	58
59	59
139	139
114	114
134	134
135	135
179	179
142	142
96	96
181	181
146	146
145	145
183	183
182	182
184	184
324	324
589	589
Piorraid	Papagoformaj
521	521
92	92
597	597
329	329
Kraków	Krakovo
133	133
413	413
258	258
259	259
196	196
236	236
789	789
332	332
631	631
487	487
638	638
473	473
176	176
143	143
643	643
523	523
215	215
148	148
247	247
424	424
641	641
492	492
639	639
256	256
441	441
131	131
191	191
450	450
612	612
635	635
611	611
534	534
488	488
607	607
524	524
282	282
472	472
471	471
490	490
316	316
797	797
511	511
295	295
598	598
303	303
250	250
515	515
512	512
418	418
333	333
294	294
217	217
277	277
578	578
312	312
Cur-ris	Adicio
284	284
283	283
Pahlavi	Mezpersa lingvo
241	241
243	243
262	262
498	498
336	336
334	334
266	266
Dòrnaireachd	Boksado
261	261
470	470
349	349
271	271
275	275
292	292
296	296
345	345
431	431
304	304
550	550
586	586
588	588
554	554
229	229
583	583
265	265
263	263
585	585
582	582
556	556
420	420
280	280
581	581
558	558
302	302
309	309
353	353
335	335
367	367
344	344
245	245
290	290
449	449
308	308
255	255
439	439
319	319
318	318
299	299
419	419
416	416
338	338
310	310
315	315
359	359
360	360
273	273
286	286
288	288
Teàrlach V, Iompaire Naomh Ròmanach	Karlo la 5-a (Sankta Romia Imperio)
278	278
455	455
577	577
575	575
482	482
486	486
580	580
567	567
564	564
561	561
328	328
325	325
317	317
574	574
566	566
249	249
348	348
442	442
443	443
267	267
244	244
248	248
343	343
562	562
417	417
268	268
590	590
269	269
499	499
409	409
405	405
406	406
403	403
414	414
411	411
412	412
560	560
592	592
Asal stiallach	Zebro
276	276
Mosg	Moskeo
314	314
323	323
366	366
362	362
545	545
531	531
514	514
513	513
539	539
538	538
519	519
516	516
520	520
522	522
528	528
506	506
526	526
507	507
214	214
213	213
212	212
228	228
227	227
149	149
174	174
189	189
199	199
141	141
132	132
125	125
123	123
Vincent du Vigneaud	Vincent du Vigneaud
147	147
144	144
198	198
178	178
177	177
187	187
195	195
186	186
347	347
620	620
624	624
605	605
629	629
616	616
615	615
644	644
646	646
633	633
637	637
436	436
434	434
293	293
427	427
185	185
321	321
327	327
430	430
Leon Trotsky	Lev Trockij
447	447
Little Rock, Arkansas	Little Rock (Arkansaso)
569	569
568	568
444	444
796	796
798	798
Càrdamon	Kardamomo
793	793
685	685
Hartford	Hartford (Konektikuto)
799	799
683	683
Taigh-tasgaidh	Muzeo
Rolling Stone	Rolling Stone
274	274
Aibidil Eabhra	Hebrea alfabeto
Dover, Delaware	Dover (Delavaro)
579	579
281	281
306	306
438	438
Friedrich II na Pruise	Frederiko la 2-a (Prusio)
297	297
421	421
298	298
351	351
352	352
355	355
95	95
94	94
594	594
542	542
448	448
445	445
305	305
234	234
565	565
381	381
385	385
553	553
307	307
584	584
346	346
257	257
285	285
591	591
289	289
Bertrand Russell	Bertrand Russell
Làmh	Mano
563	563
252	252
Nepali (canan)	Nepala lingvo
Àireamh-shluaigh	Loĝantaro
595	595
246	246
Theodore Roosevelt	Theodore Roosevelt
596	596
593	593
357	357
573	573
Tel Aviv	Tel-Avivo
Nice	Nico
Duilleag	Folio
Sàrdais	Sarda lingvo
Actair	Aktoro
Marlon Brando	Marlon Brando
Niue	Niuo
Eas	Akvofalo
559	559
599	599
326	326
341	341
322	322
Nathalia Dill	Nathalia Dill
Justin Bieber	Justin Bieber
Umha	Bronzo
Modica	Modica
Hosni Mubarak	Hosni Mubarak
386	386
Funafuti	Funafutio
374	374
380	380
Pablo Neruda	Pablo Neruda
Àth nan Damh	Oksfordo
Walloon (cànan)	Valona lingvo
136	136
Linus Torvalds	Linus Torvalds
Port-au-Prince	Portoprinco
Międzyrzec Podlaski	Międzyrzec Podlaski
Alexander Graham Bell	Alexander Graham Bell
Woodrow Wilson	Woodrow Wilson
Tasmania	Tasmanio
Rotterdam	Roterdamo
Innealan-ciùil	Muzika instrumento
Eala	Cigno
Oilthigh Oxford	Universitato de Oksfordo
Rathad	Vojo
Aleksandr Solženicyn	Aleksandr Solĵenicin
Heileacoptair	Helikoptero
Each-aibhne	Amfibia hipopotamo
382	382
342	342
373	373
372	372
James A. Garfield	James A. Garfield
Kyoto	Kioto
Sionagog	Sinagogo
Caolas Sasannach	Manika Markolo
1980an	1980-aj jaroj
Johannesburg	Johanesburgo
Eaglais	Eklezio
1990an	1990-aj jaroj
Albert Camus	Albert Camus
Gainmheach	Sablo
Kingston, Iaimeuca	Kingstono
Buadhair	Adjektivo
Leopard	Leopardo
Qaidam	Tsaidam
Salzburg	Salzburg
Sròn-adharcach	Rinoceredoj
Dayton, Ohio	Dayton (Ohio)
Rudyard Kipling	Rudyard Kipling
Leth-eilean	Duoninsulo
Còd Àireamh fòn eadar-nàiseanta	Telefona landokodo
Friedrich Engels	Friedrich Engels
Bliadhna Ùr	Novjaro
Santo Domingo	Sankta Domingo
Ulysses S. Grant	Ulysses S. Grant
Oklahoma City, Oklahoma	Oklahomaurbo (Oklahomo)
375	375
Brisbane	Brisbano
Ptolomaidh	Ptolemeo
1970an	1970-aj jaroj
2000an	2000-aj jaroj
William McKinley	William McKinley
Càl	Blanka brasiko
Sheòirsea a Deas is na h-Eileanan Shandwich a Deas	Sud-Georgio kaj Sud-Sandviĉinsuloj
Prìomh-bhailtean	Listo de ĉefurboj
Noemi	Noemi
Làrach-lìn	TTT-ejo
Wilhelm Conrad Röntgen	Wilhelm Conrad Röntgen
Grover Cleveland	Grover Cleveland
Cubhait (baile)	Kuvajturbo
Herbert Hoover	Herbert C. Hoover
Facal-fhreumachd	Etimologio
Pùma	Pumo
44 RC	-44
Warren G. Harding	Warren G. Harding
387	387
Nikita Hruŝëv	Nikita Ĥruŝĉov
Brad Pitt	Brad Pitt
Colombo	Kolombo (urbo)
Uinneag	Fenestro
Almaty	Almato
Chester A. Arthur	Chester A. Arthur
Seann-Lochlannais	Malnovnordlanda lingvo
Uamh	Kaverno
Hokkaidō	Hokajdo
Arthur Conan Doyle	Arthur Conan Doyle
Dinnsear	Zingibro
Duais Nobel airson Sith	Nobel-premio pri paco
William Howard Taft	William H. Taft
Benjamin Harrison	Benjamin Harrison
Rutherford B. Hayes	Rutherford B. Hayes
Iaguar	Jaguaro
1930an	1930-aj jaroj
Astràilia a Deas	Suda Aŭstralio
1960an	1960-aj jaroj
1920an	1920-aj jaroj
Pàrlamaid	Parlamento
Aiste	Eseo
Osaka	Osako
Boise, Idaho	Boise (Idaho)
Oilthigh Chambridge	Universitato de Kembriĝo
Baruch Spinoza	Baruĥ Spinozo
Cadal	Dormo
Heactair	Hektaro
Uachdar-fhiaclan	Dentopasto
Baisteadh	Bapto
Bàta	Boato
Guaranaidh	Gvarania lingvo
Ceilteach	Keltoj
Calvin Coolidge	Calvin Coolidge
Seileach	Saliko
Queensland	Kvinslando
Minneapolis, Minnesota	Minneapolis
Mathan coala	Koalo
Charles Bronson	Charles Bronson
Muhammed Ali	Muhammad Ali
Borneo	Borneo
Ùir	Grundo
Àlach	Aro (matematiko)
Bridgetown	Briĝurbo
Siligo	Siligo
Riochdair	Pronomo
Fuaimreag	Vokalo
Apia	Apio
Saint John's, Antigua agus Barbuda	Sankta Johano (Antigvo-Barbudo)
Beath-eachdraidh	Biografio
Roseau	Roseo
1950an	1950-aj jaroj
Thales	Taleso de Mileto
Calgary	Kalgario
Jane Austen	Jane Austen
Aisling	Sonĝo
Fribourg	Friburgo
Comann Iosaid	Jezuitoj
Radan	Rato
Obar Dheathain	Aberdeen
Porto	Porto
Flùr	Faruno
The Lion King	The Lion King
Naisgear	Konjunkcio (gramatiko)
Mìle-bliadhna	Jarmilo
Francis Drake	Francis Drake
Port Moresby	Port-Moresbo
Àbhainn	Forno
1940an	1940-aj jaroj
1900an	1900-aj jaroj
1910an	1910-aj jaroj
Den Haag	Hago
Goiriola	Gorilo
Siùrsachd	Prostituo
Corcaigh	Cork
Ealain-lèirsinneach	Vidaj artoj
Bruach-an-Iar	Cisjordanio
Victoria, Astràilia	Viktorio (Aŭstralio)
Nòrnais	Norna lingvo
Mamot	Mamuto
Pāli	Palia lingvo
Ndebele (cànan)	Suda Ndebela lingvo
Doras	Pordo
Ceithir-cheàrnach	Kvarlatero
Robert De Niro	Robert De Niro
Toshiro Mifune	Mifune Toshiro
Aodann	Vizaĝo
Zingiberaceae	Zingibracoj
Thomas Mann	Thomas Mann
Tallahassee, Florida	Tallahassee (Florido)
José Saramago	José Saramago
Alexander Fleming	Alexander Fleming
Pop	Pop-muziko
Trianaid	Sankta Triunuo
30 an Gearran	30-a de februaro
Loidhne	Rekto
331	331
365	365
Niùclas	Atomkerno
379	379
Innd-Eòrpais	Hindeŭropa pralingvo
Robert Koch	Robert Koch
Neach-teagaisg	Instruisto
Pàpa Iain Pòl I	Johano Paŭlo la 1-a
An Spiorad Naomh	Sankta Spirito
Cleveland, Ohio	Klevlando
Samuel Beckett	Samuel Beckett
Lublin	Lublin
John Michael Talbot	John Michael Talbot
Naypyidaw	Nepjido
Glùn	Genuo
Abragod	Abrikotarbo
Pierre Curie	Pierre Curie
Poileagan	Plurlatero
Jean Calvin	Kalvino
Leòmhann-làir	Ĥameleono
Bloemfontein	Bloemfontein
Arm	Armeo
Coimheatailt	Alojo
T. S. Eliot	T. S. Eliot
Charlotte's Web	Charlotte's Web (filmo, 1973)
Port Vila	Portvilao
Auckland Grammar School	Auckland Grammar School
Milwaukee, Wisconsin	Milvokio
Caol	Markolo
Duais Nobel ann an Litreachas	Nobel-premio pri literaturo
Mendel, Gregor	Johann Gregor Mendel
Carinthia (stàit)	Karintio
St. Louis, Missouri	Sankta Luiso
Connrag	Konsonanto
Herta Müller	Herta Müller
Samurai	Samurajo
George Lucas	George Lucas
Eithne	Enya
1840an	1840-aj jaroj
Còmhlan (bith-eòlas)	Filumo
Rìgh Eanraig VIII Shasainn	Henriko la 8-a (Anglio)
William Faulkner	William Faulkner
Romano Prodi	Romano Prodi
Xena: Warrior Princess	Xena
Turku	Turku
Devanāgarī	Nagario
1880an	1880-aj jaroj
Còcaireachd	Kuirado
Blàr Stalingrad	Batalo ĉe Stalingrado
Suva	Suvo
Nuku'alofa	Nukualofo
Meatailt throm	Metalroko
A' Phruis	Prusio
1890an	1890-aj jaroj
Vorarlberg	Vorarlbergo
Abhag	Terhundoj
Ceusair	Imperiestro
Cheyenne, Wyoming	Cheyenne
Port of Spain	Portospeno
Bohemia	Bohemio (lando)
Peata	Dombesto
John Steinbeck	John Steinbeck
Luch	Muso (besto)
Bothan	Sovaĝeja kabano
Ronaldinho	Ronaldinho
Anchorage, Alasca	Anchorage
1830an	1830-aj jaroj
Tractar-àiteachais	Traktoro
Gamal Abdel Nasser	Naser
Acfhainn	Laborilo
Peatrail	Benzino
Burbank, Calafòrnia	Burbank (Kantono Los-Anĝeleso)
1800an	1800-aj jaroj
Linne	Golfo
Antoine Lavoisier	Antoine Lavoisier
Cladh (creideamh)	Tombejo
Fast	Boaco
Nicolas Appert	Nicolas Appert
Des Moines, Iowa	Des Moines (Iovao)
Taigh-solais	Lumturo
The Rescuers	The Rescuers
Raon Ghàsa	Gaza Sektoro
Pràis	Latuno
Sangiano	Sangiano
Mario Vargas Llosa	Mario Vargas Llosa
Gleann	Valo
1860an	1860-aj jaroj
1870an	1870-aj jaroj
Briogais	Pantalono
Deichead	Jardekoj
Almon	Migdalujo
Sylvester Stallone	Sylvester Stallone
Prògram (coimpiutair)	Komputila programo
Abhainn Iòrdan	Jordano
Clach-chreadha	Briko
Will Smith	Will Smith
Beus-fhìdheall	Gambovjolo
Hobart	Hobarto
1810an	1810-aj jaroj
William Butler Yeats	William Butler Yeats
Canale d'Agordo	Canale d'Agordo
Carl Benz	Karl Benz
European Cup Winners Cup	UEFA-pokalo de pokalvenkintoj
Iomadachadh	Multipliko
Gini-Nuadh	Nov-Gvineo
The Fox and the Hound	The Fox and the Hound
Norman, Oklahoma	Norman
Prìosan	Malliberejo
Desio	Desio
Buffalo, Eabhraig Nuadh	Bufalo
Na Slàbhaich	Slavo
John Wayne	John Wayne
Sumo	Sumoo
Lisa Gerrard	Lisa Gerrard
Somma Lombardo	Somma Lombardo
Co-bhualadair Mòr Hadron	Granda Koliziigilo de Hadronoj
Tacloban	Tacloban
Ray Bradbury	Ray Bradbury
Eòin Baistidh	Johano la Baptisto
Paulínia	Paulinjo
'100 Leabhar an Linn' le Le Monde	La 100 libroj de la 20-a jarcento laŭ Le Monde
Toirt air falbh	Subtraho
Partan	Krabo
God Save the Queen	God Save the Queen
Knut Hamsun	Knut Hamsun
Tampere	Tampere
Breda	Breda
Tenerife	Tenerifo
Neul Oort	Oorta nubo
Doris Lessing	Doris Lessing
Buinneach	Diareo
Dumbo	Dumbo
Frank Sinatra	Frank Sinatra
Honiara	Honiaro
Mùn	Urino
1850an	1850-aj jaroj
Rèabhlaid Ameireaganach	Usona Milito de Sendependeco
Ùrnaigh	Preĝo
Skype	Skajpo
Each-mara (mamal)	Rosmaro
Harold Pinter	Harold Pinter
Bathais	Frunto
Topeka, Kansas	Topeka (Kansaso)
Sailm	Psalmo
Heraclitus a Ephesus	Heraklito
Al Pacino	Al Pacino
Demi Lovato	Demi Lovato
Eibhir	Granito
Iolair-bhuidhe	Reĝa aglo
Bonn (airgead)	Monero
San Juan, Puerto Rico	San-Juano (Porto-Riko)
Boris Pasternak	Boris Pasternak
Opera	Opera (retumilo)
Bydgoszcz	Bydgoszcz
Johannes Vermeer	Johannes Vermeer
John Dalton	John Dalton
Basseterre	Bastero
Poblachd Weimar	Vajmara Respubliko
Ball-coise Aimearaganach	Usona piedpilkado
Steiermark	Stirio
José Luis Rodríguez Zapatero	José Luis Rodríguez Zapatero
Teletubbies	Teletubbies
Brot	Supo
Kingstown	Kingstaŭno
Neasgaid-fala	Hemoroido
Wole Soyinka	Wole Soyinka
Lebhiticus	Levidoj
Freumh	Radiko (planto)
Henryk Sienkiewicz	Henryk Sienkiewicz
William Blake	William Blake
St. George’s	Sankta Georgo (Grenado)
Buaidh an taigh-ghloine	Forceja efiko
Julia Gillard	Julia Gillard
Còcein	Kokaino
Dlighe Ohm	Leĝo de Omo
Coireaman	Kultiva koriandro
Haifa	Ĥajfo
Eilean Stiùbhairt	Stewart-insulo
Castries	Kastrizo
Brachadh	Fermentado
Haracleas	Heraklio
Paul Newman	Paul Newman
Sri Jayawardenapura	Sri Jayawardenapura Kotte
An Ostair Uachdar	Supra Aŭstrio
Democritus	Demokrito de Abdero
Tahiti	Tahitio
Am Bàs Dubh	Nigra morto
Anwar El Sadat	Anvar Sadat
J. M. G. Le Clézio	Jean-Marie Gustave Le Clézio
Clach theinnteach	Magmorokaĵo
Gobi	Gobio
Tomas Tranströmer	Tomas Tranströmer
Henri Bergson	Henri Bergson
Abel Tasman	Abel Tasman
Hainan	Hajnano
Fàilte Mhoire	Ave Maria
Obair	Laboro (fiziko)
Mel Gibson	Mel Gibson
Sully Prudhomme	Sully Prudhomme
Mirante do Vale	Videjo de Valo
Eileanan a' Chaolais	Manikinsuloj
Savannah	Savano
Pàpa Pius XI	Pio la 11-a
Neul (reul-eòlas)	Nebulozo
Mihail Šolohov	Miĥail Ŝoloĥov
Sasannaich	Angloj
Evo Morales	Evo Morales
Anatole France	Anatole France
Anaximander	Anaksimandro
Eabhraig	York
Asterix An Ceilteach	Asteriks
An Ostair Ìochdarach	Malsupra Aŭstrio
Eaglais Ìosa Chrìost de Naoimh an Latha mu Dheireadh	Eklezio de Jesuo Kristo de la Sanktuloj de la Lastaj Tagoj
Spìosradh	Spico
Wisława Szymborska	Wisława Szymborska
Curcuma	Kurkumo
Uilinn	Kubuto
Frédéric Mistral	Frédéric Mistral
Sagart	Pastro
Deuteronomi	Readmono
Cat Manainneach	Manksa kato
Heinrich Böll	Heinrich Böll
Palikir	Palikiro
Johnny Cash	Johnny Cash
Audrey Hepburn	Audrey Hepburn
Leif Ericson	Leifr Eiríksson
Port Adhair Long Thanh	Flughaveno Long Thanh
Tirol	Tirolo (Aŭstrio)
Dustin Hoffman	Dustin Hoffman
Balla	Muro
Ola	Oleo
Ailtire	Arkitekturistoj
1600an	1600-aj jaroj
Bambi	Bambi
Peabar	Nigra pipro
Àireamh (Bìoball)	Nombroj
Barail-fhuasgladh	Referendumo
Naomh	Sanktulo
Sofia Rotaru	Sofia Rotaru
Crotal	Likeno
Cincinnati, Ohio	Cincinnati
Omaha, Nebraska	Omaha (Nebrasko)
Dà-ghnèitheachd	Ambaŭseksemo
Clint Eastwood	Clint Eastwood
Burgenland	Burgenlando
Ingrid Bergman	Ingrid Bergman
Fàire	Horizonto
Morabhia	Moravio
Pieter Brueghel Mòr	Pieter Bruegel la pliaĝa
Prionnsa Teàrlach, Prionnsa na Cuimrigh	Karlo, princo de Kimrujo
Talmud	Talmudo
J. M. Coetzee	John Maxwell Coetzee
Fresno, Calafòrnia	Fresno
Cumhachd na Gaoithe	Ventoenergio
Salzburg (stàit)	Salcburgio
Basalt	Bazalto
1700an	1700-aj jaroj
Raibeart Ò Baoghail	Robert Boyle
Richmond, Virginia	Richmond (Virginio)
Giosuè Carducci	Giosuè Carducci
Gustave Flaubert	Gustave Flaubert
Boireannach	Ina sekso
Gàirdean	Brako
Desiderius Erasmus	Erasmo de Roterdamo
Guayaquil	Guayaquil
Gerhart Johann Robert Hauptmann	Gerhart Hauptmann
Cotonou	Kotonuo
Drannd-eun	Kolibro
Leiden	Leiden
Louisville, Kentucky	Louisville
Montehermoso	Montehermoso
Pàpa Pius IX	Pio la 9-a
Pàpa Leo XII	Leono la 12-a
Pàpa Griogair XVI	Gregorio la 16-a
Yasunari Kawabata	Kaŭabata Jasunari
Pàpa Pius X	Pio la 10-a
Àilean	Oazo
Crith-thalmhainn Haiti 2010	Tertremo en Haitio en 2010
Madison, Wisconsin	Madison (Viskonsino)
Imleag	Umbiliko
Otto I, Impire Naomh Ròmanach	Oto la 1-a (Sankta Romia Imperio)
Eduard Buchner	Eduard Buchner
Pàpa Leo XIII	Leono la 13-a
Seoc an Reubainnear	Ĵakvo la Buĉisto
1740an	1740-aj jaroj
Wassily Leontief	Wassily Leontief
1500an	1500-aj jaroj
Fireannach	Vira sekso
William Golding	William Golding
Ùirsgeul	Legendo
Tsar	Caro
Cayenne	Kajeno
Selma Lagerlöf	Selma Lagerlöf
Anne Brontë	Anne Brontë
Bheactor	Vektoro
Teampall	Templo
Duais Nobel ann an Ceimigeachd	Nobel-premio pri kemio
V. S. Naipaul	Vidiadhar Surajprasad Naipaul
Aoine	Fasto
1820an	1820-aj jaroj
Amazonas (Roinn)	Amazonio (Kolombio)
Port	Haveno
Suharto	Suharto
Viljandi	Viljandi
1770an	1770-aj jaroj
Tulsa, Oklahoma	Tulsa
Chubut	Ĉubutio
Biorra-crùidein	Alcededoj
Elba	Elbo (insulo)
The Doors	The Doors
Coimbra	Koimbro
Beirm	Gisto
Silesia Seiceach	Ĉeĥa Silezio
Boa	Boaedoj
Dennis Ritchie	Dennis Ritchie
Cairdeanal	Kardinalo
Himnusz	Hungara nacia himno
Strabo	Strabono
Czesław Miłosz	Czesław Miłosz
1680an	1680-aj jaroj
1610an	1610-aj jaroj
Maigheach	Leporo
Felix Mendelssohn Bartholdy	Felix Mendelssohn Bartholdy
Rhône (département)	Rhône (departemento)
Aardvark	Orikteropo
1510an	1510-aj jaroj
Bogha is saighead	Arko (armilo)
Crùban-coille	Teraj testudoj
Bjørnstjerne Bjørnson	Bjørnstjerne Bjørnson
CSS	CSS
Ivan Bunin	Ivan Bunin
Bhampair	Vampiro
Inndis Fìdi	Fiĝa hinda lingvo
Octavio Paz	Octavio Paz
Riese Pio X	Riese Pio X
Alcalá de Henares	Alcalá de Henares
Posterstein	Posterstein
Oulu	Oulu
Clach chruth-atharrachail	Metamorfa rokaĵo
Joseph Smith Jr	Joseph Smith
Peile	Sitelo
Sealtainn	Ŝetlandaj Insuloj
Atacama	Atakama-Dezerto
Romain Rolland	Romain Rolland
Santa Mónica, Calafòrnia	Santa Monica
Duais Nobel ann an Eaconomachd	Nobel-premio pri ekonomiko
Elfriede Jelinek	Elfriede Jelinek
Cnuimh	Vermo
Palo Alto	Palo Alto
Marie Antoinette	Marie-Antoinette
Clàrsach	Harpo
Milton Friedman	Milton Friedman
Green Bay, Wisconsin	Green Bay (Viskonsino)
Nota (airgead)	Monbileto
André Gide	André Gide
Gàsa (baile)	Gaza-urbo
Allt	Rivereto
Los-leathann	Kastoro
Toruń	Toruń
Ivo Andrić	Ivo Andrić
Dùthaich nam Basgach (mòr-cheàrn)	Eŭskio
Bolgan (innleachd)	Ampolo
Nadine Gordimer	Nadine Gordimer
Iosua	Josuo (libro)
Rudolf Christoph Eucken	Rudolf Christoph Eucken
Kalahari	Kalaharo
The Godfather	The Godfather
Imre Kertész	Imre Kertész
El Aaiún	Ajuno
Armadillo	Dazipo
Green Day	Green Day
Robbie Williams	Robbie Williams
Sid Vicious	Sid Vicious
339	339
340	340
Nijmegen	Nijmegen
Mario Monti	Mario Monti
354	354
356	356
358	358
361	361
363	363
364	364
368	368
369	369
370	370
Unnsa	Unco
371	371
Teamplaid:Commonscat	Ŝablono:Commonscat
376	376
377	377
378	378
1780an	1780-aj jaroj
383	383
384	384
388	388
389	389
390	390
391	391
392	392
1730an	1730-aj jaroj
393	393
394	394
395	395
396	396
397	397
398	398
399	399
1540an	1540-aj jaroj
Medellín	Medeĝino
Parabòla	Parabolo (matematiko)
Kobe	Kobe
Mariehamn	Mariehamn
An Talamh Ùr	Novlando
Daibhidh MacDhùnleibh	David Livingstone
Richard Gere	Richard Gere
Ainneamhag	Fenikso (birdo)
1750an	1750-aj jaroj
1580an	1580-aj jaroj
1590an	1590-aj jaroj
Neuilly-sur-Seine	Neuilly-sur-Seine
Glenn Theodore Seaborg	Glenn Theodore Seaborg
Linus Carl Pauling	Linus Pauling
Patrick Swayze	Patrick Swayze
San Luis Obispo, Calafòrnia	San Luis Obispo (Kalifornio)
San Luis Obispo County, Calafòrnia	Kantono San Luis Obispo (Kalifornio)
Oilthigh Cholumbia	Universitato Kolumbio
Cambridge, Massachusetts	Kembriĝo (Masaĉuseco)
Oilthigh Yale	Universitato Yale
Ivy League	Ivy League
Oilthigh Chornell	Universitato Cornell
Oilthigh Phennsylvania	Universitato de Pensilvanio
New Haven, Connecticut	New Haven (Konektikuto)
Springfield, Massachusetts	Springfield (Masaĉuseco)
Lowell, Massachusetts	Lowell (Masaĉuseco)
Stamford, Connecticut	Stamford (Konektikuto)
279	279
Bridgeport, Connecticut	Bridgeport (Konektikuto)
Waterbury, Connecticut	Waterbury (Konektikuto)
Worcester, Massachusetts	Worcester (Masaĉuseco)
440	440
517	517
572	572
Portland, Maine	Portland (Majno)
Rochester, Eabhraig Nuadh	Roĉestro (Nov-Jorkio)
Irvine, Calafòrnia	Irvine
Fremont, Calafòrnia	Fremont (Kalifornio)
Scottsdale, Arizona	Scottsdale (Arizono)
Norfolk, Virginia	Norfolko (Virginio)
Orlando, Florida	Orlando
St. Petersburg, Florida	Sankt-Peterburgo (Florido)
Toledo, Ohio	Toledo (Ohio)
Stockton, Calafòrnia	Stockton (Kalifornio)
Lexington, Kentucky	Leksingtono (Kentukio)
Riverside, Calafòrnia	Riverside (Kalifornio)
Santa Ana, Calafòrnia	Santa Ana (Kalifornio)
Aurora, Colorado	Aurora (Koloradio)
Anaheim, Calafòrnia	Anaheim
Tampa, Florida	Tampa
Bakersfield, Calafòrnia	Bakersfield
Colorado Springs, Colorado	Colorado Springs
Virginia Beach, Virginia	Virginia Beach
Mesa, Arizona	Mesa
Wichita, Kansas	Wichita (Kansaso)
Chula Vista, Calafòrnia	Chula Vista
Chandler, Arizona	Chandler (Arizono)
Melvin Calvin	Melvin Calvin
Linn na Deighe	Glaciepoko
Àrc	Korko
Àrd-easbaig	Ĉefepiskopo
Loch Nis	Loch Ness
Schaan	Schaan
Maurice Maeterlinck	Maurice Maeterlinck
23mh Linn	23-a jarcento
Banais	Nupto
24mh Linn	24-a jarcento
25mh Linn	25-a jarcento
26mh Linn	26-a jarcento
27mh Linn	27-a jarcento
28mh Linn	28-a jarcento
29mh Linn	29-a jarcento
Bogsa-litrichean	Poŝtkesto
30mh Linn	30-a jarcento
Solomon Burke	Solomon Burke
Caochladair	Variablo
Riaghailtean Astràilianach	Aŭstralia piedpilkado
Cali	Santiago de Cali
Pereira (baile)	Pereira
Kórnik	Kórnik
Dàn Sholaimh	Alta Kanto de Salomono
Malachi	Libro de Malaĥi
Pago Pago	Pagopago
Glendale, Arizona	Glendale (Arizono)
Gilbert, Arizona	Gilbert (Arizono)
Tempe, Arizona	Tempe (Arizono)
Peoria, Arizona	Peoria (Arizono)
Gravina in Puglia	Gravina in Puglia
Laphroaig	Laphroaig
Middelburg	Middelburg
Formentera	Formentero
Ibiza	Ibizo
Menorca	Minorko
Château-d'Œx	Château-d'Œx
Jogaila	Ladislao la 2-a Jogajlo
Oilthigh Chologne	Universitato de Kolonjo
Providence County, Rhode Island	Kantono Providence (Rod-Insulo)
Kent County, Rhode Island	Kantono Kent (Rod-Insulo)
Washington County, Rhode Island	Kantono Washington (Rod-Insulo)
Newport County, Rhode Island	Kantono Newport (Rod-Insulo)
Bristol County, Rhode Island	Kantono Bristol (Rod-Insulo)
Cuenca (provincia)	Provinco Kvenko
Albacete (provincia)	Provinco Albaceto
Guadalajara (provincia)	Provinco Gvadalaĥaro
Toledo (provincia)	Provinco Toledo
Ciudad Real (provincia)	Provinco Reĝurbo
Alacant (provincia)	Provinco Alikanto
Valencia (provincia)	Valencio (provinco)
Teruel (provincia)	Provinco Teruelo
Zaragoza (provincia)	Provinco Zaragozo
Huesca (provincia)	Provinco Huesko
Laurence Olivier	Laurence Olivier
Palencia (provincia)	Provinco Palencio
Burgos (provincia)	Provinco Burgoso
Soria (provincia)	Provinco Sorio
Segovia (provincia)	Provinco Segovio
Ávila (provincia)	Provinco Avilo
Contae Laoise	Graflando Laois
Roinn-seòrsa:Film	Kategorio:Filmo
José María Aznar López	José María Aznar
Peter Ustinov	Peter Ustinov
Katharine Hepburn	Katharine Hepburn
Grottammare	Grottammare
Lise Meitner	Lise Meitner
Sàmais	Samea lingvo
Otto Hahn	Otto Hahn
Nelly Sachs	Nelly Sachs
Fritz Haber	Fritz Haber
Johann Friedrich Wilhelm Adolf von Baeyer	Adolf von Baeyer
Pàpa Hadrianus VI	Hadriano la 6-a
Paul Ehrlich	Paul Ehrlich
Walther Hermann Nernst	Walther Nernst
Anna Cleves	Anna de Kleve
Otto Wallach	Otto Wallach
Georgi Parvanov	Georgi Parvanov
Traian Băsescu	Traian Basescu
Jacob Zuma	Jacob Zuma
Ólafur Ragnar Grímsson	Ólafur Ragnar Grímsson
Toomas Hendrik Ilves	Toomas Hendrik Ilves
Ivan Gašparovič	Ivan Gašparovič
Juan Manuel Santos Calderón	Juan Manuel Santos
Václav Klaus	Václav Klaus
Hans-Adam II	Hans Adam la 2-a
Mark Rutte	Mark Rutte
Èideard I Shasainn	Eduardo la 1-a (Anglio)
Éanna Ó Coinnigh	Enda Kenny
Duran Duran	Duran Duran
Punjabi (cànan)	Panĝaba lingvo
Torc fiadhach	Apro
Cogadh a' Chaidreachais Thrìpilte	Milito de la Trilanda Alianco
Dà-theangachas	Diglosio
Artur Balder	Artur Balder
Robert Redford	Robert Redford
Northland Region	Nordia Regiono
Breatainn Nuadh	Nova Britio
Wicca	Viko
Albertus Magnus	Alberto la Granda
Gerhard Ertl	Gerhard Ertl
1150an	1150-aj jaroj
1030an	1030-aj jaroj
1050an	1050-aj jaroj
Peacadh	Peko
Meppel	Meppel
Earball	Vosto
Montgomery County, Arkansas	Kantono Montgomery (Arkansaso)
Mion-chànanan	Minoritata lingvo
Starnberg	Starnberg
Barranquilla	Barankilo
Delémont	Delemonto
Glarus	Glaruso (komunumo)
Vernier	Vernier
Stans	Stans
Sarnen	Sarno (Obvaldo)
Herisau	Herisau
Uster	Uster
Bellinzona	Belinzono
Köniz	Köniz
Aarberg	Aarberg
Teòirim	Teoremo
Bloigh (matamataig)	Frakcio (matematiko)
Niccolò Paganini	Niccolò Paganini
Abhlan coisrigte	Komunio
Tavau	Davos
Frauenfeld	Frauenfeld
La Chaux-de-Fonds	La Chaux-de-Fonds
Sion	Siono
Zug	Zugo (komunumo)
Altdorf	Altdorf (Urio)
Schwyz	Ŝvico (komunumo)
Vevey	Vevey
Hawaii (eilean)	Hawaii (insulo)
Einsiedeln	Einsiedeln
Solothurn	Soloturno
Liestal	Liestal
Thun	Thun
Ciura	Koiro
Genolier	Genolier
Neuchâtel	Neŭŝatelo
Tolochenaz	Tolochenaz
Mammern	Mammern
Muralto	Muralto
Hermann Emil Fischer	Hermann Emil Fischer
Robert Bunsen	Robert Bunsen
Salamanca (provincia)	Provinco Salamanko
Valladolid (provincia)	Provinco Valadolido
Clark Gable	Clark Gable
Dromadair	Dromedaro
Hollywood Walk of Fame	Trotuaro de famo en Holivudo
An Oriant	Lorient
1370an	1370-aj jaroj
Toni Morrison	Toni Morrison
Blonag	Ŝmalco
Cingoli	Cingoli
The Hobbit	La Hobito
Hobbit	Hobito
Àrd-thìr	Altebenaĵo
Miguel Ángel Asturias	Miguel Ángel Asturias
Isaac Bashevis Singer	Isaac Bashevis Singer
Dietrich Bonhoeffer	Dietrich Bonhoeffer
Rainer Maria Rilke	Rainer Maria Rilke
Paul Johann Ludwig von Heyse	Paul Heyse
Hans Fallada	Hans Fallada
Kurt Alder	Kurt Alder
Richard August Carl Emil Erlenmeyer	Emil Erlenmeyer
Georg Ludwig Carius	Georg Ludwig Carius
Hans Fischer	Hans Fischer
Carl Bosch	Carl Bosch
Friedrich Bergius	Friedrich Bergius
Adolph Wilhelm Hermann Kolbe	Hermann Kolbe
Viktor Meyer	Viktor Meyer
Robert Huber	Robert Huber
Robert Havemann	Robert Havemann
Theodor Fontane	Theodor Fontane
Lèine	Ĉemizo
Friedrich August Kekulé von Stradonitz	August Kekulé
George de Hevesy	George de Hevesy
Arthur Koestler	Arthur Koestler
Walter Scott	Walter Scott
Waldron, Arkansas	Waldron (Arkansaso)
Fairbanks, Alasca	Fairbanks (Alasko)
1230an	1230-aj jaroj
Nogales, Arizona	Nogales (Arizono)
930an	930-aj jaroj
Gearra-mhuc	Kobajo
Sitka, Alasca	Sitka
Mulhouse	Mulhouse
Canaib	Kanabo
1390an	1390-aj jaroj
Bogsa-ciùil	Akordiono
Huntsville, Alabama	Huntsville (Alabamo)
Birmingham, Alabama	Birmingham (Alabamo)
Braille	Brajlo
1130an	1130-aj jaroj
Poilean	Poleno
Selma, Alabama	Selma (Alabamo)
Seumas VI na h-Alba is Seumas I Shasainn	Jakobo la 1-a (Anglio)
1360an	1360-aj jaroj
1270an	1270-aj jaroj
Christchurch, Sealainn Nuadh	Kristkirko
Petersburg, Alasca	Peterburgo (Alasko)
Rut	Libro de Rut
Seic	Ĉeko
Duais Nobel ann an Leigheas	Nobel-premio pri fiziologio aŭ medicino
Elias Canetti	Elias Canetti
Babsk	Babsk
Kenzaburo Oe	Oe Kenzaburo
Daniel	Libro de Danielo
Emily Brontë	Emily Brontë
Ad	Ĉapelo
Siompansaidhe	Ĉimpanza genro
Botal	Botelo
Ailt	Aldviolono
Halldór Laxness	Halldór Kiljan Laxness
Mongùs	Mungotedoj
Gavrilo Princip	Gavrilo Princip
Gondwana	Gondvano
Charlton Heston	Charlton Heston
960an	960-aj jaroj
990an	990-aj jaroj
890an	890-aj jaroj
1190an	1190-aj jaroj
1180an	1180-aj jaroj
Uaireadair-grèine	Sunhorloĝo
Gabriela Mistral	Gabriela Mistral
Sigrid Undset	Sigrid Undset
Pearl S. Buck	Pearl S. Buck
Robert Lefkowitz	Robert Lefkowitz
John Travolta	John Travolta
Svante Arrhenius	August Svante Arrhenius
Na h-Eileanan Siar	Foraj Hebridoj
Biadh-maidne	Matenmanĝo
Prionnsa Philip, Diùc Dhùn Èideann	Princo Filipo, Duko de Edinburgo
Inbheach	Plenkreskeco
Ite	Plumo
Na h-Eileanan a-staigh	Proksimaj Hebridoj
Innleadair	Inĝeniero
950an	950-aj jaroj
Seòlaid an Iar-thuath	Nordokcidenta pasejo
Eilean Bhaffin	Bafina Insulo
1020an	1020-aj jaroj
1060an	1060-aj jaroj
Moirfin	Morfino
Britheamhan	Juĝistoj (libro)
1210an	1210-aj jaroj
1350an	1350-aj jaroj
Acair (talamh)	Akreo (mezurunuo)
Harrison Ford	Harrison Ford
1310an	1310-aj jaroj
1260an	1260-aj jaroj
1220an	1220-aj jaroj
1010an	1010-aj jaroj
Bloinigean-gàrraidh	Legoma spinaco
Teàrlach I	Karlo la 1-a (Anglio)
Alpaca	Alpako
970an	970-aj jaroj
François Mauriac	François Mauriac
1420an	1420-aj jaroj
Almería (provincia)	Provinco Almerio
Badajoz (provincia)	Provinco Badaĥozo
Burras	Raŭpo
Barcelona (provincia)	Provinco Barcelono
Raibeart Burns	Robert Burns
Córdoba (provincia)	Provinco Kordovo
Cáceres (provincia)	Provinco Kacereso
Cádiz (provincia)	Provinco Kadizo
Cruit-chòrda	Klaviceno
Benjamin Disraeli	Benjamin Disraeli
Adharc	Korno (anatomio)
Steven Seagal	Steven Seagal
A Coruña (provincia)	Provinco Korunjo
Granada (provincia)	Granado (provinco)
Mata Hari	Mata Hari
John Galsworthy	John Galsworthy
920an	920-aj jaroj
1170an	1170-aj jaroj
980an	980-aj jaroj
1080an	1080-aj jaroj
1000an	1000-aj jaroj
1300an	1300-aj jaroj
1330an	1330-aj jaroj
Uilleam Uallas	William Wallace
Clach ghrùideach	Sedimenta rokaĵo
The Sex Pistols	Sex Pistols
1090an	1090-aj jaroj
Leslie Nielsen	Leslie Nielsen
Ainm	Nomo
Druim an t-saoghail	Zenito
1380an	1380-aj jaroj
Sigmaringen	Sigmaringen
An Carghas	Karesmo
1240an	1240-aj jaroj
1290an	1290-aj jaroj
Aidmheint	Advento
1450an	1450-aj jaroj
Pàpa Griogair XIII	Gregorio la 13-a
Bad Urach	Bad Urach
Clisgear	Interjekcio
Salvatore Quasimodo	Salvatore Quasimodo
1110an	1110-aj jaroj
1160an	1160-aj jaroj
940an	940-aj jaroj
1250an	1250-aj jaroj
Saul Bellow	Saul Bellow
Ailbhinn	Siliko
Jacques-Louis David	Jacques-Louis David
Charlotte's Web 2: Wilbur's Great Adventure	Charlotte's Web 2: Wilbur's Great Adventure
Eugenio Montale	Eugenio Montale
Almere	Almere
Jacinto Benavente	Jacinto Benavente
Eideard VI	Eduardo la 6-a (Anglio)
Selena Gomez	Selena Gomez
870an	870-aj jaroj
1340an	1340-aj jaroj
880an	880-aj jaroj
860an	860-aj jaroj
1320an	1320-aj jaroj
1070an	1070-aj jaroj
1200an	1200-aj jaroj
1280an	1280-aj jaroj
Òrdag	Dikfingro
1140an	1140-aj jaroj
Factoraidh	Fabriko
Cary Grant	Cary Grant
Paracelsus	Paracelsus
Tuath-Cheòl	Kontreo
1440an	1440-aj jaroj
Fliùiteag	Fluteto
Buabhall	Bubalo
Gearastan	Garnizono
Teamplaid:Cite book	Ŝablono:Citaĵo el libro
Pär Fabian Lagerkvist	Pär Lagerkvist
Eugene O'Neill	Eugene O'Neill
Baisteach	Baptismo
Còigeamh Uladh	Ulster
Lesser Antilles	Malgrandaj Antiloj
Tairbeart (feart tìre)	Istmo
Inneal-siubhail	Lokomotivo
Chrzanów	Chrzanów
Seamus Heaney	Seamus Heaney
Ò Canada	O Canada
Jack Lemmon	Jack Lemmon
Gipuzkoa	Provinco Gipusko
Lugo (provincia)	Provinco Lugo
Málaga (provincia)	Malago (provinco)
Ourense (provincia)	Provinco Oŭrenso
Pontevedra (provincia)	Provinco Pontevedro
Sevilla (provincia)	Provinco Sevilo
Dùthaich nam Basgach a Tuath	Nord-Eŭskio
Ourense	Oŭrenso
Santa Cruz de Tenerife (provincia)	Provinco Sankta Kruco de Tenerifo
Arcaibh	Orkadoj
Casnewydd	Newport (Monmouthshire)
Pàpa Innocentius X	Inocento la 10-a
Pàpa Innocentius XI	Inocento la 11-a
Pàpa Alasdair VIII	Aleksandro la 8-a
Lillehammer	Lillehammer
Lobamba	Lobambo
Rastafarachd	Rastafaria movado
Thabo Mbeki	Thabo Mbeki
Sotto il Monte Giovanni XXIII	Sotto il Monte Giovanni XXIII
Cromleac	Dolmeno
Altair	Altaro
Ainu	Ajnuoj
Iar-leasachan	Sufikso
Narva	Narva
Peter Agre	Peter Agre
Pärnu	Pärnu
Paul Samuelson	Paul Samuelson
James Stewart	James Stewart
Apa	Homoideoj
Jaroslav Seifert	Jaroslav Seifert
Parraist	Paroĥo
Dà-fhoghar	Diftongo
Ernest Borgnine	Ernest Borgnine
Giorrachadh	Mallongigo
Henri Moissan	Henri Moissan
Jacobus Henricus van't Hoff	Jacobus Henricus van 't Hoff
Na Cruithnich	Piktoj
An Òlaind	Holando
Kurt Russell	Kurt Russell
Feamainn dearg	Ruĝalgoj
Alt (gràmar)	Artikolo (gramatiko)
Donald Sutherland	Donald Sutherland
Peter Debye	Peter Debye
Peadar Ó Tuathail	Peter O’Toole
Alec Guinness	Alec Guinness
Judea	Judeo
Concesio	Concesio
Singilte	Gramatika nombro
Deborah Kerr	Deborah Kerr
Robert Walpole	Robert Walpole
Chorzów	Chorzów
Paul Sabatier	Paul Sabatier
Victor Grignard	Victor Grignard
Beinn Nibheis	Ben Nevis
Los Angeles County, Calafòrnia	Kantono Los-Anĝeleso
El Callao	Kajao
Dearc-luachrach (dà-bheathach)	Tritono
Biorabhaig	Peruko
Ei-ichi Negishi	Ei-ichi Negishi
Brachadh (craiceann)	Puso
Rangachadh Élő	Elo-nombro
Maurice Allais	Maurice Allais
La Gomera	La Gomera
Crìosdaidh	Kristano
Blàthach	Buterlakto
Ahmed H. Zewail	Ahmed H. Zewail
Mestizos	Mestizo
Richard Smalley	Richard E. Smalley
Ísafjörður	Ísafjörður
Arlington County, Virginia	Arlington
Alameda County, Calafòrnia	Kantono Alameda
An t-Eilean Sgitheanach	Skye
Contae Liatroma	Graflando Leitrim
Eisir	Ostro
Contra Costa County, Calafòrnia	Kantono Contra Costa
Sonoma County, Calafòrnia	Kantono Sonoma
Solano County, Calafòrnia	Kantono Solano
San Mateo County, Calafòrnia	Kantono San Mateo
Santa Barbara County, Calafòrnia	Kantono Santa Barbara (Kalifornio)
Riverside County, Calafòrnia	Kantono Riverside
Marin County, Calafòrnia	Kantono Marin
San Diego County, Calafòrnia	Kantono San-Diego
Caibeal	Kapelo
Culberson County, Texas	Kantono Culberson (Teksaso)
Spèil	Sketilo
King County, Washington	Kantono King (Vaŝingtonio)
Diùcachd Mhecklenburg-Güstrow	Meklenburgo
Hudspeth County, Texas	Kantono Hudspeth (Teksaso)
Snohomish County, Washington	Kantono Snohomish (Vaŝingtonio)
Travis County, Texas	Kantono Travis (Teksaso)
Santa Clara County, Calafòrnia	Kantono Santa Clara
Rusk County, Texas	Kantono Rusk (Teksaso)
Dail Riata	Dalriada
Kittitas County, Washington	Kantono Kittitas
Mason County, Washington	Kantono Mason (Vaŝingtonio)
Santarcangelo di Romagna	Santarcangelo di Romagna
Warren County, Iowa	Kantono Warren (Iovao)
Bergen County, Jersey Nuadh	Kantono Bergen (Nov-Ĵerzejo)
Jasper County, Carolina a Deas	Kantono Jasper (Suda Karolino)
Kossuth County, Iowa	Kantono Kossuth (Iovao)
Thurston County, Washington	Kantono Thurston (Vaŝingtonio)
Wayne County, Illinois	Kantono Wayne (Ilinojo)
Skagit County, Washington	Kantono Skagit (Vaŝingtonio)
Sìol-lann	Grenejo
Macon County, Illinois	Kantono Makona (Ilinojo)
Madison County, Iowa	Kantono Madison (Iovao)
4mh mìle-bliadhna RC	4-a jarmilo a.K.
Sgarbh an sgùmain	Tufkormorano
5mh mìle-bliadhna RC	5-a jarmilo a.K.
Clàs (gràmar)	Propozicio
Błędów	Błędów Dezerto
Galar ana-chaidreamhach na pearsantachd	Kontraŭsocia karaktero
Franklin County, Washington	Kantono Franklin (Vaŝingtonio)
Tucker County, Virginia an Iar	Kantono Tucker (Okcidenta Virginio)
Eilean a Tuath, Sealainn Nuadh	Norda Insulo (Nov-Zelando)
Na h-Eileanan Aleutianach	Aleutaj Insuloj
Tama County, Iowa	Kantono Tama (Iovao)
Anna, Bànrigh Shasainn, Alba is Èireann	Anna (Britio)
Eilean a Deas, Sealainn Nuadh	Suda Insulo (Nov-Zelando)
Władysław Reymont	Władysław Stanisław Reymont
Boyacá (Roinn)	Bojakao
Tosgair	Ambasadoro
Teàrlach II	Karlo la 2-a (Anglio)
Dziecinów	Dziecinów (poviato Otwock)
Alfred Werner	Alfred Werner
Fang (eun)	Vulturo
Òr-iasg	Orfiŝo (fiŝo)
Antioquia (Roinn)	Antjokio
Na h-Innse Gall	Hebridaj Insuloj
Sinclair Lewis	Sinclair Lewis
Al-Andalus	Al-Andalus
Dùn Dèagh	Dundee
La Genga	Genga
Gunna	Fusilo
Bauhaus	Bauhaus
Pàpa Pius VII	Pio la 7-a
Blas	Gusto
Mindanao	Mindanao
Senigallia	Senigallia
Gàirnealachd	Ĝardenado
Luzon	Luzono
Parmenides	Parmenido
Rìgh Seumas VII Alba is II Shasainn	Jakobo la 2-a (Anglio)
Ceannsaichean	Konkistadoro
Comhairle Dhùn Phris is Gall-Ghaidhealaibh	Dumfries kaj Galloway
An Àirc	Arkeo de Noa
Pàpa Beinidict XIV	Benedikto la 14-a
Bùth	Podetala komerco
Chippewa County, Wisconsin	Kantono Chippewa (Viskonsino)
Boma	Bombo
Jackson County, Missouri	Kantono Jackson (Misurio)
Pàpa Alasdair VII	Aleksandro la 7-a
Seòras III	Georgo la 3-a (Britio)
Frank Zappa	Frank Zappa
Charlotte Brontë	Charlotte Brontë
José Echegaray y Eizaguirre	José Echegaray
Lord of the Rings ( film )	La Mastro de l' Ringoj: La Kunularo de l' Ringo (filmo)
Maimonides	Maimonido
Taunton, Massachusetts	Taunton (Masaĉuseco)
Aghann	Pato
Beverley Hills	Beverly Hills
Greater Antilles	Grandaj Antiloj
Pàpa Pius VI	Pio la 6-a
Syracuse, Eabhraig Nuadh	Sirakuso
Essex County, Jersey Nuadh	Kantono Essex (Nov-Ĵerzejo)
Yonkers, Eabhraig Nuadh	Yonkers
Mick Jagger	Mick Jagger
Cunnart nan arm-tilgidh ann an Cùba	Kariba krizo
Trianaid (eilean)	Trinidado
Paul Martin	Paul Martin
Jean Chrétien	Jean Chrétien
Iain MacDhòmhnaill	John A. Macdonald
John Nash	John Nash
William Pitt Beag	William Pitt
Arailt MacUilleim	Harold Wilson
Arailt MacMhaolain	Harold Macmillan
Anthony Eden	Anthony Eden
Clement Attlee	Clement Attlee
Àirne	Prunelo
Capall-coille	Urogalo
Paul Verhoeven	Paul Verhoeven
Roger Martin du Gard	Roger Martin du Gard
Carl Gustaf Verner von Heidenstam	Verner von Heidenstam
Patrick White	Patrick White
Fau	Digamo
Qoppa	Kuoppo
Gaillimh	Galivo
Pàpa Clemens XI	Klemento la 11-a
Uilleam III Shasainn is II Alba	Vilhelmo la 3-a (Anglio)
Hieronymus Bosch	Hieronymus Bosch
Seòras IV	Georgo la 4-a (Britio)
Corra-bhàn	Granda egretardeo
Papeete	Papeeto
Deòrsa I Bhreatainn is Èireann	Georgo la 1-a (Britio)
Màiri II Shasainn is Alba	Maria la 2-a (Anglio)
Uilleam IV	Vilhelmo la 4-a (Britio)
1 Rìghrean	1-a libro de la Reĝoj
Eclesiastes	Kohelet
Draoidh	Druido
An tuiseal ainmneach	Nominativo
Paul Krugman	Paul Krugman
Ailm	Ulmo
Braunau am Inn	Braunau am Inn
Cion-faireachdain	Anestezo
Henry David Thoreau	Henry David Thoreau
Tiùba	Tubjo
South Tarawa	Bairikio
Oilthigh Bhologna	Universitato de Bolonjo
Cultar mòr-thaitneach	Popola kulturo
Uicipeid:Book sources	Vikipedio:Libroservoj
Juan Ramón Jiménez	Juan Ramón Jiménez
Eyvind Johnson	Eyvind Johnson
Fàsach Namib	Namibo
Cèileafaid	Kalifujo
Màiri I, Bànrigh na h-Alba	Maria Stuart
Sampi	Sampio
Còigeamh Mumhan	Munster (Irlando)
Isaiah	Libro de Jesaja
Karl Adolph Gjellerup	Karl Gjellerup
Easotaireachd	Esoterismo
Claude Simon	Claude Simon
Pàpa Urbain VIII	Urbano la 8-a
Pàpa Clemens XIV	Klemento la 14-a
Ieremiah	Libro de Jeremia
San	Sano (litero)
Esra	Libro de Ezra
Ioel	Libro de Joel
Bonn-cuimhne	Medalo
Arthur Wellesley, 1st Duke of Wellington	Duko de Wellington
Henry Cavendish	Henry Cavendish
Fuath-bìdh	Anoreksio
Humphry Davy	Humphry Davy
Deugaire	Adolesko
Mèirneal	Kolombfalko
Pàpa Pius V	Pio la 5-a
Deòrsa II, Rìgh Bhreatainn is Èireann	Georgo la 2-a (Britio)
Laurasia	Laŭrazio
Universidade Federal de Minas Gerais	Universidade Federal de Minas Gerais
Theravada	Teravado
Meatailt Dhubh	Nigra metalroko
Jorge Eliecer Gaitán	Jorge Eliécer Gaitán
Amartya Sen	Amartya Sen
Paidirean	Rozario
Sgitheach	Kratago
Aepyceros melampus	Impalo
Camilo José Cela	Camilo José Cela
Aifreann	Meso (diservo)
Dealbh-sgrìobhadh	Hieroglifoj
Saint-John Perse	Saint-John Perse
Pàpa Griogair XV	Gregorio la 15-a
Harry Martinson	Harry Martinson
Derek Walcott	Derek Walcott
Pàpa Innocentius XII	Inocento la 12-a
Pàpa Pòl V	Paŭlo la 5-a
Pàpa Leo XI	Leono la 11-a
Frans Eemil Sillanpää	Frans Eemil Sillanpää
Cur fo chràdh	Torturo
Àrd-mharaiche	Admiralo
Finding Nemo	Finding Nemo
Àrdaichear	Lifto
Taklamakan	Taklamakano
Shmuel Yosef Agnon	Samuel Josef Agnon
Bealach	Montpasejo
Dùn Eidinn	Dunedin
Pàpa Innocentius XIII	Inocento la 13-a
Cas	Kruro
Pàpa Clemens XII	Klemento la 12-a
Pàpa Clemens XIII	Klemento la 13-a
Sonar	Sonaro
Luimneach	Limerick
Pàpa Sixtus V	Siksto la 5-a
An Tuil (fionn-sgeul)	Tutmonda diluvo
Pop-ealain	Poparto
Bruis-fhiaclan	Dentobroso
Polo	Poloo
Poilisacaraid	Polisakarido
Roger Moore	Roger Moore
Pàpa Urbain VII	Urbano la 7-a
Meidheadair	Pesilo (mezurilo)
Erik Axel Karlfeldt	Erik Axel Karlfeldt
Vicente Aleixandre	Vicente Aleixandre
Šiauliai	Šiauliai
Ro-leasachan	Prefikso
David Lloyd George	David Lloyd George
Crolaidh	Glitŝtonludo
Seumas V Alba	Jakobo la 5-a (Skotlando)
Germinal (nobhail)	Germinal
Seumas IV Alba	Jakobo la 4-a (Skotlando)
Alexis de Tocqueville	Alexis de Tocqueville
Danakil	Danakila dezerto
Allentown, Pennsylvania	Allentown (Pensilvanio)
Fàsach Mhòr Bhictòria	Granda Viktoria-Dezerto
An tuiseal tabhartach	Dativo
Calltainn	Avelujo
Buidheag an t-samhraidh	Ranunkolo
An tuiseal ginideach	Genitivo
Krzeszowice	Krzeszowice
Cathair-thalmhainn	Akileo
Cuibhle-uisge	Akvorado
Iolra	Pluralo
Lingua Franca Nova	Nova Lingvafrankao
Craobh-bhròin	Cipreso
Fìorachas druidheil	Magia realismo
Saidheans “Cognitive”	Kognoscienco
Saint Helier	Saint Helier
Sgìre	Distrikto
Biolar	Akvokreso
Buinneag Bhruisealach	Burĝonbrasiko
Gene Hackman	Gene Hackman
Frédéric Joliot-Curie	Frédéric Joliot-Curie
Vidkun Quisling	Vidkun Quisling
Creag nam Bathais	Roko Bass
Oilthigh Heidelberg	Universitato de Hajdelbergo
Nis, Leòdhas	Ness (Lewis)
Sùlaisgeir	Sula Sgeir
Boraraigh, Hiort	Borerajo
Piet Mondriaan	Piet Mondriaan
Jöns Jacob Berzelius	Jöns Jacob Berzelius
Fèileadh	Kilto
Braich	Malto (bierfarejo)
Sant-Nazer	Saint-Nazaire
Lorem ipsum	Ŝtopteksto
Luath	Cindro
Oilthigh Humboldt Berlin	Humboldt-Universitato en Berlino
Ballan	Banujo
László Sólyom	László Sólyom
Falt ruadh	Rufaj haroj
Amar-mùin	Noktovazo
Alfredo Stroessner	Alfredo Stroessner
Blobhsa	Bluzo
Rìoghachd Shagsainn	Reĝlando Saksio
Primo Levi	Primo Levi
Kislovodsk	Kislovodsk
Rìoghachd Westphalen	Reĝlando Vestfalio
Oilthigh Tübingen	Universitato de Tubingeno
Bòla	Bovlo
Melekeok	Melekeoko
Rìoghachd Bayern	Reĝlando Bavario
Meur-coise	Piedfingro
Saor	Ĉarpentisto
Bertie Ahern	Bertie Ahern
Oilthigh Leipzig	Universitato de Lepsiko
Coileach dubh	Tetro
Pàpa Clemens X	Klemento la 10-a
Pàpa Clemens IX	Klemento la 9-a
Pàpa Beinidict XIII	Benedikto la 13-a
Iadh-shlat	Lonicero
Craobh-àirc	Korkokverko
Powys	Powys
Benton County, Washington	Kantono Benton (Vaŝingtonio)
Douglas County, Washington	Kantono Douglas (Vaŝingtonio)
Clamhan-gobhlach	Ruĝa milvo
Columbia County, Washington	Kantono Columbia (Vaŝingtonio)
Adams County, Washington	Kantono Adams (Vaŝingtonio)
Cowlitz County, Washington	Kantono Cowlitz (Vaŝingtonio)
Clark County, Washington	Kantono Clark (Vaŝingtonio)
Asotin County, Washington	Kantono Asotin (Vaŝingtonio)
Clallam County, Washington	Kantono Clallam (Vaŝingtonio)
Universidade Estadual de Feira de Santana	Universidade Estadual de Feira de Santana
Pierce County, Washington	Kantono Pierce (Vaŝingtonio)
Whatcom County, Washington	Kantono Whatcom (Vaŝingtonio)
Yakima County, Washington	Kantono Yakima (Vaŝingtonio)
Sac County, Iowa	Kantono Sac (Iovao)
Ida County, Iowa	Kantono Ida (Iovao)
Howard County, Iowa	Kantono Howard (Iovao)
Felipe González Márquez	Felipe González
Beith-airgid	Penda betulo
Uinnseann	Ordinara frakseno
Trefynwy	Monmouth (Kimrio)
Prionnsalachd Hohenzollern-Sigmaringen	Hohenzollern-Sigmaringen
Zittau	Zittau
British Midland International	British Midland International
Ryoji Noyori	Ryoji Noyori
Taigh Rìoghail Hanòbhair	Hanovro (dinastio)
Frauenkirche	Frauenkirche (Dresdeno)
Harold Kroto	Harold Walter Kroto
Leonid Hurwicz	Leonid Hurwicz
Sàirdseant	Serĝento
Jaroslav Heyrovský	Jaroslav Heyrovský
Diùcachd Sagsainn-Meiningen	Saksio-Meiningen
Diùcachd Sachsen-Altenburg	Saksio-Altenburg
Eala bhuidhe	Trapunkta hiperiko
Cees Nooteboom	Cees Nooteboom
Darach neo-ghasagach	Tigfolia kverko
Bucas (craobh)	Bukso
Universidade Federal da Bahia	Federacia Universitato de Bahio
Centro Federal de Educação Tecnológica de Minas Gerais	Centro Federal de Educação Tecnológica de Minas Gerais
Santa Cruz, Calafòrnia	Santa Cruz (Kalifornio)
Santa Clara, Calafòrnia	Santa Clara (Kalifornio)
Arequipa	Arekipo
Santa Barbara, Calafòrnia	Santa Barbara (Kalifornio)
Àrd-sgoil	Mezlernejo
Steve McQueen	Steve McQueen
Muc-mhara adharcach	Narvalo
Faro	Faro (Portugalio)
Ravensbruck	Koncentrejo Ravensbrück
Johannes Vilhelm Jensen	Johannes V. Jensen
Diùcachd Württemberg	Virtembergo
Joseph Priestley	Joseph Priestley
Leas-abhainn	Alfluanto
Stèisean cumhachd	Elektrejo
Còigeamh Laighean	Leinster
J. M. W. Turner	Joseph Mallord William Turner
AC	A. D.
Eaconomaidh	Ekonomio
Coirce a' Mhadadh-Ruaidh	Arrhenatherum elatius
Oilthigh Rostock	Universitato Rostock
Augusto Roa Bastos	Augusto Roa Bastos
Leth-aon	Ĝemelo
Lus-an-eallain	Robert-geranio
Rousse	Ruse
Cherbourg-Octeville	Cherbourg-Octeville
Hernán Crespo	Hernán Crespo
Oilthigh Dhùn Èideann	Universitato de Edinburgo
Odysseas Elytis	Odysseas Elytis
Inbhir Nis	Inverness
Heraklion	Iraklio (urbo)
Alfred Russel Wallace	Alfred Russel Wallace
Amhrán na bhFiann	Amhrán na bhFiann
Colann	Torso
Abaid	Abatejo
William Gladstone	William Ewart Gladstone
Sgiath (bith-eòlas)	Flugilo
Campaichean Gulag	Gulago
Vojna i mir	Milito kaj paco
T.A.T.u.	T.A.T.u.
Pàpa Pius IV	Pio la 4-a
Samoa	Samoa Insularo
Gaisgeach	Heroo
Tony Curtis	Tony Curtis
Earrach Phràg	Praga printempo 1968
Sirte	Sirto
Contae Chorcaí	Graflando Cork
Roinnean na Spàinne	Provinco de Hispanio
Acadamh	Akademio
Nua-libearalas	Novliberalismo
Atlas	Atlaso (maparo)
Negev	Negevo
Seula	Sigelo
Sant-Maloù	Saint-Malo
Akron, Ohio	Akron (Ohio)
Leigiun	Legio
Brat-ùrlair	Tapiŝo
Doire	Derry
Bàislig	Baziliko
Còrn Sasannach	Korno (muzikinstrumento)
St Peter's College, Auckland	St Peter's College, Auckland
Dearbhair-litreachaidh	Literumilo
Obrachadh càraideach	Operacio (matematiko)
Corpse Bride	Corpse Bride (filmo)
Còigeamh Chonnacht	Connacht
Func	Funko
Curraidh	Kareaĵo
Jean Baptiste Dumas	Jean-Baptiste Dumas
Beach-lann	Abelujo
100an	100-aj jaroj
Maywood, Illinois	Maywood (Ilinojo)
Lope de Vega	Lope de Vega
Peann	Plumo (skribilo)
Co-iomlaideachd	Komuteco
Naomh Pàdraig	Sankta Patriko
Leucippus	Leŭkipo (filozofo)
Prionnsalachd Waldeck-Prymont	Waldeck
Giorgos Seferis	Giorgos Seferis
Fort Lauderdale, Florida	Fort Lauderdale
Lelystad	Lelystad
Gneiss	Gnejso
Hiort	Sankta Kildo
Seachd peacaidhean-bàis	Sep gravegaj pekoj
Stanley Baldwin	Stanley Baldwin
Ramsaigh MacDhòmhnaill	Ramsay MacDonald
Andrew Bonar Law	Andrew Bonar Law
Clisg-phuing	Krisigno
Gunna fada	Mezfingro
Naomh Antaine an Padua	Antonio de Padovo
Pàpa Innocentius IX	Inocento la 9-a
Adhbrann	Maleolo
Ynys Môn	Môn
Acair (bàta)	Ankro (ŝipo)
Àradh	Ŝtupetaro
Sgt. Pepper's Lonely Hearts Club Band	Sgt. Pepper's Lonely Hearts Club Band
Protagoras	Protagoro de Abdero
11mh linn RC	11-a jarcento a.K.
Contae na Gaillimhe	Graflando Galway
Loch Tahoe	Lago Tahoe
1100an	1100-aj jaroj
Poblachd nan Seachd Roinnean Aonaichte	Respubliko de la Sep Unuiĝintaj Provincoj
Comhachag gheal	Neĝostrigo
Cumhachd-uisge	Akvoenergio
Bheataireachd	Veterinara medicino
Apocruiphia	Apokrifoj
Cuaigearan	Kvakerismo
Na Seicich	Ĉeĥoj
Chester	Chester
110an	110-aj jaroj
Matilde Camus	Matilde Camus
Pàpa Clemens VIII	Klemento la 8-a
Scrabble	Skrablo
Taubaté	Taubaté
Tommy Lee Jones	Tommy Lee Jones
Advance Australia Fair	Advance Australia Fair
Teacno	Tekno-muziko
Ryanair	Ryanair
Roger D. Kornberg	Roger D. Kornberg
Ealasaid Báthory	Erzsébet Báthory
Carbad-smùide	Vaporlokomotivo
The Princess and the Frog	The Princess and the Frog
Neòinean-grèine	Sunfloro
Pàpa Griogair XIV	Gregorio la 14-a
12na linn RC	12-a jarcento a.K.
Neactair	Nektaro
Yochanan Vollach	Yochanan Vollach
Stad-phuing	Punkto (interpunkcio)
Co-fhlaitheas na Pòlainn - Liotuàinia	Respubliko de Ambaŭ Nacioj
Oidhche Shàmhach (òran)	Stille Nacht
Lady and the Tramp	Lady and the Tramp
Montauban	Montauban
Driuchaidean	Ekzorcismo
Fucking, An Ostaire	Fucking
Samuel L. Jackson	Samuel L. Jackson
Aleister Crowley	Aleister Crowley
Thar	Dezerto Tar
Na Marquesas	Markizinsuloj
Karakum	Karakumo
Siar-sgeul	Vakera filmo
Comhairle Treinte	Koncilio de Trento
Beart-chlò	Teksilo
Mícheál Ó Coileáin (ceannard Èireannach)	Michael Collins (politikisto)
Brisg	Ĉipso
Cros-dhàn	Akrostiko
Contae Chill Dara	Graflando Kildare
Éamon de Valera	Éamon de Valera
Bèigneid	Bajoneto
Uaigh	Tombo
Amen	Amen
Contae Átha Cliath	Graflando Dublino
Toradh Cartesach	Kartezia multipliko
Reidius	Radiuso
An Tàinistear	Regento
Peanta	Farbo
St. Peter Port	Sanktapetrurbo
Pedro Alvarez Cabral	Pedro Álvares Cabral
Amos	Libro de Amos
Obadiah	Libro de Obadja
Cuspair (gràmar)	Objekto (gramatiko)
13mh linn RC	13-a jarcento a.K.
Barra	Ĉarumo
Dlighe Úi Bhaoghail	Leĝo de Boyle
Taylor County, Iowa	Kantono Taylor (Iovao)
Seacadh	Recesio
Parabhan	Parafino
Tràth (gràmar)	Verbotempo
Cabhsair	Trotuaro
Pears-eaglais	Kleriko
Imre Nagy	Imre Nagy (politikisto)
Rùp	Aŭkcio
Nàidhlean	Nilono
Dàrna Poblachd na Spàinne	Dua Hispana Respubliko
Micah	Libro de Miĥa
Bàta-smùid	Vaporŝipo
Henry County, Iowa	Kantono Henry (Iovao)
Contae Luimnigh	Graflando Limerick
Hagai	Libro de Ĥagaj
Àrd-aingeal	Arkianĝelo
Eseciel	Libro de Jeĥezkel
Gille-cruidh	Vakero
Cath	Batalo
Lebkuchen	Spickuko
Contae Mhaigh Eo	Graflando Mayo
15mh linn RC	15-a jarcento a.K.
Stàitean agus fearainnean Astràilia	Aŭstraliaj ŝtatoj kaj teritorioj
Aonadh-obrach	Sindikato
Uaireadair	Brakhorloĝo
Ionah	Libro de Jona
Gran Canaria	Gran Canaria
Tuireadh	Libro de la Plorkanto
Coimpiutaireachd	Komputado
Alderney	Alderney
Contae Shligigh	Graflando Sligo
Puyallup, Washington	Puyallup (Vaŝingtonio)
Contae Dhún nan Gall	Graflando Donegal
Contae Ros Comáin	Graflando Roscommon
Guasca	Guasca
Beauty and the Beast (film 1991)	Beauty and the Beast (filmo, 1991)
Nahum	Libro de Naĥum
Habacuc	Libro de Ĥabakuk
Sechariah	Zeĥarja (libro)
Durham	Durham (Anglio)
Contaetha na h-Èireann	Graflandoj de Irlando
Kermanshah	Kermanŝaho
Johannes Nicolaus Brønsted	Johannes Nicolaus Brønsted
Contae Chill Chainnigh	Graflando Kilkenny
Uchd-mhacachd	Adopto
Carbad-eiridinn	Ambulanco
14mh linn RC	14-a jarcento a.K.
Truro	Truro
Buidheagan	Ovoflavo
Teodaileach	Teodolito
Fàsach Libianach	Libia Dezerto
Herbert Simon	Herbert Simon
Naomh Thérèse de Lisieux	Tereza de Lisieux
Contae an Chláire	Graflando Clare
Robert Peel	Robert Peel
Contae Cheatharlach	Graflando Carlow
Lanzarote	Lanzarote
Contae Chill Mhantáin	Graflando Wicklow
Contae na hIarmhí	Graflando Westmeath
Van Buren County, Iowa	Kantono Van Buren (Iovao)
Bailead	Balado
Deàrnadaireachd	Kiromancio
Biodag	Ponardo
Sruighlea	Stirling
Rahden	Rahden
Jihlava	Jihlava
Jefferson County, Iowa	Kantono Jefferson (Iovao)
G. K. Chesterton	Gilbert Keith Chesterton
Jan Tinbergen	Jan Tinbergen
Ibadan	Ibadano
Deachdaire	Diktatoro
Bolgan (lus)	Tubero
16mh linn RC	16-a jarcento a.K.
Ilya Prigogine	Ilja Prigogine
Contae Lú	Graflando Louth
Contae na Mí	Graflando Meath
Port Làirge	Waterford
Aideachadh	Konfeso
Hosea	Libro de Hoŝea
Gary, Indiana	Gary
Fàsach Mhojave	Mojave-Dezerto
Bodha	Rifo
Kyzyl Kum	Kizilkumo
Coire	Cirko (valformo)
Gràisgealachd	Sakro
Contae Uíbh Fhailí	Graflando Offaly
Rùsg	Arboŝelo
Contae Chiarraí	Graflando Kerry
Contae Phort Láirge	Graflando Waterford
Contae Loch Garman	Graflando Wexford
Contae Thiobraid Árann	Graflando Tipperary
Mòine	Torfo
Ogham	Ogamo
The Aristocats	The Aristocats
Jane Goodall	Jane Goodall
Luibhean-luaisgein	Fitoplanktono
Contae Mhuineacháin	Graflando Monaghan
Sgealbag	Montrofingro
John Hicks	John Richard Hicks
Taisbeanach (gràmar)	Gramatika modo
Tairbheadaireachd	Toreo
Mion-fhacal	Partikulo
Tromb-beòil	Buŝharpo
Tobago	Tobago
Piranha	Piranjo
Brian Cowen	Brian Cowen
Knoxville, Tennessee	Knoxville (Tenesio)
Grytviken	Grytviken
Fado	Fado
Caol-an-dùirn	Pojno
Todhar	Stala sterko
Bàta-foluaimein	Aeroglita boato
Lacrosse	Kanada bastonludo
Contae an Longfoirt	Graflando Longford
Theodor Svedberg	Theodor Svedberg
An Sionnach Sgianach	Wolverine
Bratach na dùthcha	Nacia flago
Faoighiche	Parazito
19mh linn RC	19-a jarcento a.K.
Chattanooga, Tennessee	Chattanooga (Tenesio)
17mh linn RC	17-a jarcento a.K.
Lite	Kaĉo (manĝaĵo)
Eilean Devon	Devon-insulo
Raibeart I na h-Alba	Roberto Bruso
Contae an Chabháin	Graflando Cavan
Álvaro Uribe	Álvaro Uribe Vélez
RMS Lusitania	RMS Lusitania
Pablo Escobar	Pablo Escobar
Bàr	Trinkejo
Eilthireachd	Elmigrado
Breac-sheunain	Efelido
Ragnar Frisch	Ragnar Anton Kittil Frisch
Gairbheal	Ŝtonminejo
Triantanadh	Triangulado
Bocsa	Kesto
Tuiseal	Deklinacio (gramatiko)
Český Krumlov	Český Krumlov
Eaconamaiche	Ekonomikisto
Ronald Coase	Ronald H. Coase
1400an	1400-aj jaroj
Cunbhal	Konstanto
Sioman	Kablo
Eilean Cheap Bhreatainn	Insulo de Breton-Kabo
Ceithir dùil phrìomh-shamhlach	Klasikaj elementoj
1410an	1410-aj jaroj
Pangram	Ĉiuliteraĵo
Sephaniah	Libro de Cefanja
Curran geal	Pastinako
Anaconda	Anakondo
Cagailt	Kameno
Aiseirigh	Reviviĝo
Achadh	Kampo (agrikulturo)
1430an	1430-aj jaroj
Ròs-chraobh	Rododendro
Fàsach Sonora	Sonora-Dezerto
Vladimir Voronin	Vladimir Voronin
Oilthigh Jagiellonian	Jagelona Universitato
18mh linn RC	18-a jarcento a.K.
Rèabhlaid Ghlòrmhor	Glora Revolucio
Aol-tàthaidh	Mortero
Contae Aontroma	County Antrim
Keith Richards	Keith Richards
Aonaran	Ermito
1460an	1460-aj jaroj
Alice in Wonderland (film 1951)	Alice in Wonderland (filmo, 1951)
Siorrachd Obar Dheathain	Aberdeenshire
Iain Knox	John Knox
Ùth	Laktoglando
Sligeach	Sligo
1470an	1470-aj jaroj
1480an	1480-aj jaroj
Contae Fhear Manach	Fermanagh
1490an	1490-aj jaroj
Ball-bodhaig	Membro (anatomio)
Famke Janssen	Famke Janssen
Bòtann	Boto
Edward Sapir	Edward Sapir
Tunna	Tuno
Fairge	Pelaga zono
Pàipear-balla	Tapeto
Santo André	Santo André (São Paulo)
Clavichord	Klavikordo
Bàta-slaodaidh	Trenŝipo
Taoiseach	Taoiseach
Abhainn Mhagdalena	Magdalena (rivero)
Bhàsa	Vazo
Don Giovanni	Don Giovanni
Uèir-bhiorach	Pikdrato
Crudha	Hufumo
Guido da Arezzo	Guido de Arezzo
1520an	1520-aj jaroj
Mac an aba	Ringofingro
1530an	1530-aj jaroj
Canari	Kanario
Fuerteventura	Fuerteventura
Streymoy	Streymoy
Edmund Phelps	Edmund S. Phelps
Hyères	Hyères
Simon Kuznets	Simon Kuznets
Dreuchdan	Verko
George A. Olah	George A. Olah
Tràth làthaireach	Prezenco
Bràigh (duine)	Ostaĝo
Oilthigh Ghlaschu	Universitato de Glasgovo
Nokia (baile)	Nokia (urbo)
Jan Palach	Jan Palach
Cathair Luail	Carlisle (Kumbrio)
Chinchilla	Ĉinĉilo
1550an	1550-aj jaroj
Marajó	Marajó
Spiorad	Spirito
Beul-an-latha	Sunleviĝo
Ard Mhacha	Armagh
A Night at the Opera	A Night at the Opera (Queen)
1560an	1560-aj jaroj
Oilthigh Phadua	Universitato de Padovo
Achd an Aonaidh	Act of Union 1707
Henry Temple, 3rd Viscount Palmerston	Lord Palmerston
1570an	1570-aj jaroj
Sugababes	Sugababes
Gath na grèine	Sunradiado
Leaba chrochta	Hamako
Bruis-pheant	Peniko
Uaireadair-uisge	Akvohorloĝo
1620an	1620-aj jaroj
1630an	1630-aj jaroj
1640an	1640-aj jaroj
1650an	1650-aj jaroj
1660an	1660-aj jaroj
1670an	1670-aj jaroj
Aisean	Ripo
1690an	1690-aj jaroj
1710an	1710-aj jaroj
1720an	1720-aj jaroj
1760an	1760-aj jaroj
Coloimbia Mhòr	Granda Kolombio
Magdalena (Roinn)	Magdalena (departemento)
1790an	1790-aj jaroj
Kreuzau	Kreuzau
Hamilton, Sealainn Nuadh	Hamilton
Dòbhran	Lutrenoj
Eilean Bhanks	Banks-insulo
Àrd-bhaile	Metropolo
Kamakura	Kamakura
Eysturoy	Eysturoy
Châtenay-Malabry	Châtenay-Malabry
Vicuña	Vicuña
Cliabh	Korbo
Anna na Breatainn Bheag	Ana de Bretonio
Fìobha	Fife (Skotlando)
Kohtla-Järve	Kohtla-Järve
Edward Said	Edward Said
Nori	Nori
Piast	Piastoj
La Palma (eilean)	La Palma
Dealg	Dorno (botaniko)
Herm	Herm
Foghar (cànanachas)	Parolsono
Linn Giùdain	Firth of Forth
Robert Grubbs	Robert H. Grubbs
Yves Chauvin	Yves Chauvin
Còigeamhan na h-Èireann	Provincoj de Irlando
Richard Schrock	Richard R. Schrock
Borðoy	Borðoy
Adag	Eglefino
Gruag bhàn	Blonda
Bheat	Bestokuracisto
Komi (sluagh)	Komioj
Manuel Azaña Díaz	Manuel Azaña
Modesto, Calafòrnia	Modesto
Sìobar-spàs	Kiberspaco
Ball-coise Gàidhealach	Pejlo
Eigir	Ægir
Dìcheannachadh	Senkapigo
Brian Jones	Brian Jones
Bogha (ceòl)	Arĉo
Dún Dealgan	Dundalk
Vézelay (Yonne)	Vézelay
Protractair	Angulilo
The Flowers of Romance	The Flowers of Romance
James Buchanan (eaconomaiche)	James M. Buchanan
Zipaquirá	Zipaquirá
Lancaster	Lancaster (Lancashire)
Tàrmachan	Monta lagopo
Sgeir Rocail	Rockall
Bith-mhoileciuil	Biomolekulo
Abeokuta	Abeokuta
Stuth-togail	Konstrumaterialo
Nelson, Sealainn Nuadh	Nelson (Nov-Zelando)
Redon	Redon
Lítla Dímun	Lítla Dímun
Sir Fynwy	Monmouthshire
Bràigh (tìr-eòlas)	Montopinto
Innis (eilean)	Insuleto (geografio)
Sylvia Kristel	Sylvia Kristel
Vágar	Vágar
Tauranga	Tauranga
Feur	Herbotapiŝo
Nibheis	Neviso
Cumadh	Formo (filozofio)
Fellowship of the Ring (leabhar)	La Mastro de l' Ringoj: La Kunularo de l' Ringo (libro)
Trygve Haavelmo	Trygve Haavelmo
Galar iomallach na pearsantachd	Emocie malstabila personeca perturbo
Fàsach Araibianach	Araba dezerto
Sandoy	Sandoy
Hestur	Hestur
Koltur	Koltur
Sgrab	Nordmara pufino
William Pitt, 1ad Iarla Chatham	William Pitt (pli maljuna)
Amar-bàistidh	Baptujo
Gilbert N. Lewis	Gilbert Newton Lewis
Loch Laomainn	Loch Lomond
Rotorua	Rotorua
Santa Marta (baile)	Sankta Marta
Oxnard, Calafòrnia	Oxnard
2 Samuel	2-a libro de Samuel
2 Eachdraidh	2-a libro de la Kroniko
2 Rìghrean	2-a libro de la Reĝoj
Brùchd	Rukto
Sgadan	Klupeoj
Suðuroy	Suðuroy
Fugloy	Fugloy
Fiodh almhaig	Blanka santalo
Fulangach (gràmar)	Gramatika voĉo
Comhairle nan Crìochan	Skotaj Limoj
Òr-cheàrdaichean	Oraĵisto
Ruaraidh MacFhionghain	Roderick MacKinnon
Rìgh Seumas VIII Alba agus III Shasainn	James Francis Edward Stuart
Alexandrine	Aleksandro (poetiko)
James Tobin	James Tobin
Fàsach Shimpson	Dezerto Simpson
Pàislig	Paisley (Skotlando)
Bangor	Bangor
Comhairle Shiorrachd Rinn Friù an Ear	East Renfrewshire
Dùn Phàrlain	Dunfermline
Cù Chullain	Cú Chulainn
Viðoy	Viðoy
Kunoy	Kunoy
Stóra Dímun	Stóra Dímun
Kalsoy	Kalsoy
P. W. Botha	Pieter Willem Botha
Wadowice	Wadowice
Na Seumasaich	Jakobitismo
Briogais-snàmh	Bankostumo
Santa Rosa, Calafòrnia	Santa Rosa (Kalifornio)
Aberystwyth	Aberystwyth
Menen	Menen (Belgio)
Clamecy (Nièvre)	Clamecy
Sir Benfro	Pembrokeshire
Mykines	Mykines
Uachtaran	Prezidanto de Irlando
Tom Selleck	Tom Selleck
Camanachd Èireannach	Iomano
Buain	Rikolto
Easag (eun)	Fazano
Rìghrean na h-Alba	Listo de skotlandaj monarkoj
Adolfo Suárez y González	Adolfo Suárez
Leticia (baile)	Leticia
Ceannaiche	Komercisto
Roinnean ann an Coloimbia	Departementoj de Kolombio
Carabhan	Ruldomo
Stràc gheur	Dekstra korno
Logarbaidh	Lockerbie
Spòrs bhuidheann	Teama sporto
Plastair	Pretpansaĵo
Bàrc	Barko
Oilthigh Chill Rìmhinn	Universitato St. Andrews
Eun-turais	Birdomigrado
Fianna Fáil	Soldatoj de Irlando
Basgaid-sgudail	Rubujo
Sam Houston	Sam Houston
Caibe	Ŝpato
Breacan	Tartano
Cúcuta	Cúcuta
Svínoy	Svínoy
Skúvoy	Skúvoy
Yr Wyddfa	Snowdon
Ùrlar	Planko
Ithaca, Eabhraig Nuadh	Ithaca (Nov-Jorkio)
Kenichi Fukui	Hukui Ken-iĉi
Ceredigion	Ceredigion
Halifax	Halifax (apartigilo)
Faidhbhile deasach	Notofago
Pietrasanta	Pietrasanta
Oilthigh Washington	Universitato de Vaŝingtonio
Na Deuchainnean na Buidseachd Salem	Sorĉistinaj juĝprocesoj en Salem
Fiodh-fillte	Tavolligno
Pío Baroja	Pío Baroja
Anggun	Anggun
Blàr Allt a' Bhonnaich	Batalo de Bannockburn
Arm na Breatainne	Brita Armeo
Ibagué	Ibagué
Muir-seilche	Testuduloj
Cogadh Chaco	Ĉaka milito
Barraigh	Barra
Sin	SIN
Nelson	Nelson
Fe	Fe
BMI	BMI
Henrik Pontoppidan	Henrik Pontoppidan
Riverside	Riverside
Aodh Mór Ó Néill	Aodh Mór Ó Néill
Carl Friedrich Georg Spitteler	Carl Spitteler
Lùdag	Etfingro
Neach-iùil	Konduktoro
Rub' al Khali	Rub-al-Ĥalo
Cuthag-bhogaidh	Motaciloj
Nariño (Roinn)	Nariño
Arauca (Roinn)	Araŭko
Chocó (Roinn)	Ĉokoo
Bolívar (Roinn)	Bolivaro (Kolombio)
Cauca (Roinn)	Kaŭko
Caldas (Roinn)	Kaldaso (departemento)
Zusamaltheim	Zusamaltheim
Irwin Rose	Irwin Rose
Atlántico (Roinn)	Atlantiko (Kolombio)
Avram Hershko	Avram Hershko
Cundinamarca (Roinn)	Kundinamarko
Putumayo (Roinn)	Putumajo
Arne Wilhelm Kaurin Tiselius	Arne Tiselius
Norte de Santander (Roinn)	Norda Santandero
Peoria, Illinois	Peoria (Ilinojso)
Aaron Ciechanover	Aaron Ciechanover
Laoidh Nàiseanta Choloimbia	Nacia Himno de Kolombio
Offa	Offa (Mercia)
Rockford, Illinois	Rockford (Ilinojo)
Theodore W. Schultz	Theodore Schultz
Daniel Kahneman	Daniel Kahneman
Erie, Pennsylvania	Erie (Pensilvanio)
Biadh Seapanach	Japana kuirarto
Giulio Natta	Giulio Natta
Adhaltranas	Adulto
Tolima (Roinn)	Tolimo
Vaupés (Roinn)	Vaŭpeso
Córdoba (Roinn)	Kordovo (Kolombio)
Cesar (Roinn)	Cezaro (Kolombio)
Huila (Roinn)	Ujlao
Aingeal	Anĝelo
Santander (Roinn)	Santandero (Kolombio)
Miso	Misoo
Sucre (Roinn)	Sukreo
Manizales (baile)	Manizales
Clash of Civilizations	Kontraŭstaro inter Civilizacioj
Seumas I, Rìgh Alba	Jakobo la 1-a (Skotlando)
Bòrd-dubh	Kretotabulo
Fisting	Pugnokoito
James Meade	James Meade
Calum Cille	Sankta Kolumbao
Ubhal-ghort	Fruktoĝardeno
Dùthchannan Ceilteach	Keltaj nacioj
Tunja	Tunja
Lucía Etxebarría	Lucía Etxebarria
Feamainn	Makroalgoj
John C. Polanyi	John Charles Polanyi
Seòras Santayana	George Santayana
Meta (Roinn)	Metao
Guainía (Roinn)	Gvajnio
Dolores Ibárruri	Dolores Ibárruri
Sacagawea	Sakagaveo
Daibhidh II, Rìgh Alba	Davido la 2-a (Skotlando)
Nólsoy	Nólsoy
Page County, Iowa	Kantono Page (Iovao)
Provençal	Provenca lingvo
Orhan Pamuk	Orhan Pamuk
Carpineto Romano	Carpineto Romano
Castel Gandolfo	Castel Gandolfo
Poli	Poli
546 RC	-546
Bucaramanga	Bucaramanga
Bàrd Spàinnteach Antonio Machado	Antonio Machado
Banntach	Ĉarniro
MacBheatha na h-Alba	Macbeth
Henry Pelham	Henry Pelham
Bòdhran	Bodhrán
William Styron	William Styron
Teth	TET
Creuse	Creuse (apartigilo)
Fine Gael	Fine Gael
610 RC	-610
Ball-coise Canaidianach	Kanada piedpilko
Liosta nam fàsaichean a rèir farsaingeachd	Listo de dezertoj laŭ areo
Winnebago County, Iowa	Kantono Winnebago (Iovao)
Étienne Mourrut	Étienne Mourrut
Nòs	Kutimo
Bainsiò	Banĝo
Buidseachd	Sorĉado
70an	70-aj jaroj
Diùcachd Anhalt-Köthen	Anhalt-Köthen
Cnàmh	Osto
Bataraidh	Pilo
Patrick Moore	Patrick Moore
Vichada (Roinn)	Viĉado
Seòras V	Georgo la 5-a (Britio)
Iúr Cinn Trá	Newry
Oilthigh Obar Dheathain	Universitato de Aberdeen
80an	80-aj jaroj
Craobhlann	Arboreto
John Harsanyi	John Charles Harsanyi
Joseph Black	Joseph Black
Kasabian	Kasabian
Fàsach Ghibson	Gibson-Dezerto
La Guajira (Roinn)	La Guajira
Seumas II Alba	Jakobo la 2-a (Skotio)
Guaviare (Roinn)	Gŭavjaro
Ionmhas	Trezoro
Cuiteag	Merlango
Bean-shìdh	Banŝio (estaĵo)
Leopoldo Calvo-Sotelo y Bustelo	Leopoldo Calvo Sotelo
Partan tuathal	Ermitokrabo
Urk	Urk
Aparan	Antaŭtuko
900an	900-aj jaroj
90an	90-aj jaroj
910an	910-aj jaroj
Uilebheist	Monstro
Seumas Mac an Deòir	James Dewar
Rùm	Rùm
Seòras VI	Georgo la 6-a (Britio)
Òrgan	Orgeno
Grant County, Washington	Kantono Grant (Vaŝingtonio)
Nicholas County, Virginia an Iar	Kantono Nicholas (Okcidenta Virginio)
Lafayette, Calafòrnia	Lafayette (Kalifornio)
Adhbharachas	Agnostikismo
Marjorie Estiano	Marjorie Estiano
Iain Stiubhart, 3mh Iarla Bhoid	John Stuart, 3a Grafo de Bute
Linn	Linn
Lee County, Carolina a Deas	Kantono Lee (Suda Karolino)
Skamania County, Washington	Kantono Skamania (Vaŝingtonio)
Quidditch	Quidditch
Jean-Claude Van Damme	Jean-Claude Van Damme
Oilthigh Shalamanca	Universitato de Salamanko
Crogall	Krokodilo
Prionnsalachd Schaumburg-Lippe	Ŝaŭmburgo-Lipo
Lüneburger Heide	Lüneburger Heide
Mariana na h-Ostaire	Mariana de Aŭstrio
Fachach	Fraterkulo
Andy Griffith	Andy Griffith
Seumas Mac a' Phearsain	James Macpherson
Johan Gadolin	Johan Gadolin
William Petty, 2nd Earl of Shelburne	Grafo de Shelburne
Iain Banks	Iain Banks
Prionnsa Teàrlach Stiùbhart	Charles Edward Stuart
Claude Louis Berthollet	Claude Louis Berthollet
Uilleam I na h-Alba	Vilhelmo la 1-a (Skotlando)
Daniel Rutherford	Daniel Rutherford
Johan August Arfwedson	Johan August Arfwedson
Bodach na Nollaige	Kristnaska Viro
Michiel de Ruyter	Michiel de Ruyter
Owain Glyndŵr	Owain Glyndŵr
Toirt am bruid	Homforkapto
Johan de Witt	Johan de Witt
Baralachas	Konjekto (matematiko)
Alasdair MacCoinnich	Alexander Mackenzie
Pasto	San Juan de Pasto
Colombey-les-Deux-Églises	Colombey-les-Deux-Églises
Tulach Mhór	Tullamore
Gòbhlan-monaidh	Alpa apuso
Fairfield, Calafòrnia	Fairfield (Kalifornio)
Wąbrzeźno	Wąbrzeźno
Bàta-iasgaich	Fiŝkapta ŝipo
Naoimh	Listo de sanktuloj
Armenia (baile)	Armenia (Kindio)
Connochaetes taurinus	Blua gnuo
Clarksville, Tennessee	Clarksville (Tenesio)
Creideamh	Listo de Religioj
Raidió Teilifís Éireann	Raidió Teilifís Éireann
Feòladair	Buĉisto
Adhlaic	Entombigo
Oak Park, Illinois	Oak Park (Ilinojo)
Tighearna	Lordo
The Two Towers (leabhar)	La Mastro de l' Ringoj: La Du Turoj (libro)
Dòmhnall Mac an Deòir	Donald Dewar
Newport News, Virginia	Newport News
Aspergillus	Aspergillus
Popayán	Popayán
Kappa (Creutair Miotas-eolasach)	Kapao
Fàsach Shirianach	Siria Dezerto
Achadh na Càiridh	Achnacarry
Fairfax County, Virginia	Kantono Fairfax
İstiklâl Marşı	İstiklâl Marşı
Adams County, Wisconsin	Kantono Adams (Viskonsino)
Picseal	Rastrumero
Oilthigh Coimbra	Universitato de Koimbro
Hardy County, Virginia an Iar	Kantono Hardy (Okcidenta Virginio)
Waukesha County, Wisconsin	Kantono Waukesha
Escondido, Calafòrnia	Escondido
Dodge County, Wisconsin	Kantono Dodge (Viskonsino)
Jeddah	Ĝido
Chittagong	Ĉitagongo
Valledupar	Valledupar
Pleasants County, Virginia an Iar	Kantono Pleasants (Okcidenta Virginio)
Rob Ruadh MacGriogair	Robert Roy MacGregor
Charles Hatchett	Charles Hatchett
Fulangas Naomh Mata	Matthäuspassion (Bach)
Co-ghnìomhair	Adverbo
Flugelhorn	Flugilkorno
Jefferson County, Washington	Kantono Jefferson (Vaŝingtonio)
Deisciobal	Disĉiplo
Washington County, Iowa	Kantono Washington (Iovao)
Gazella dorcas	Dorkas-gazelo
Soisgeul Mhata	Evangelio laŭ Mateo
Creag Ealasaid	Ailsa Craig
Hywel Dda	Hywel Dda
Mars	Mars
Caernarfon	Caernarfon
Bàn-dhearg	Roza
Alt	Alt
Asgair	Apostrofo
Torgny Lindgren	Torgny Lindgren
Pàpa Frangan	Francisko (papo)
Leabhar Mhormoin	Libro de Mormon
Lakewood, Colorado	Lakewood (Koloradio)
Coireall còsagail	Alveolara trilo
Nathair-ghleadhrach	Krotalo
Fàsach Nubianach	Nubia dezerto
Sandra Roelofs	Sandra Roelofs
Nevenoe	Nevenoeo
Bryan Gunn	Bryan Gunn
Mochi	Moĉio
Lemuria	Lemurio (kontinento)
Villeblevin	Villeblevin
Snàthad an duine mhairbh	Tipoledoj
Pastra	Bakaĵo
Port Adhair Tan Son Nhat	Flughaveno Tan Son Nhat
Deuchainn-lann	Laboratorio
Meatailt Bàis	Mortmetalo
Bòrd-iarnaigidh	Gladilo
Stevens County, Washington	Kantono Stevens (Vaŝingtonio)
Okanogan County, Washington	Kantono Okanogan (Vaŝingtonio)
Caingeiseachd	Pentekosta Kristanismo
Bodach-sneachda	Neĝhomo
Pacific County, Washington	Kantono Pacific (Vaŝingtonio)
Wahkiakum County, Washington	Kantono Wahkiakum (Vaŝingtonio)
Tì uaine	Verda teo
San Juan County, Washington	Kantono San Juan (Vaŝingtonio)
Lincoln County, Washington	Kantono Lincoln (Vaŝingtonio)
Whitman County, Washington	Kantono Whitman (Vaŝingtonio)
Kitsap County, Washington	Kantono Kitsap (Vaŝingtonio)
Andrew Carnegie	Andrew Carnegie
Berkeley, Calafòrnia	Berkeley (Kalifornio)
Eisleben	Eisleben
Armachd	Kiraso
Spokane County, Washington	Kantono Spokane (Vaŝingtonio)
Wayne County, Nebraska	Kantono Wayne (Nebrasko)
Pend Oreille County, Washington	Kantono Pend Oreille (Vaŝingtonio)
Walla Walla County, Washington	Kantono Walla Walla
Ferrol	Ferrol
Winneshiek County, Iowa	Kantono Winneshiek (Iovao)
Story County, Iowa	Kantono Story (Iovao)
Hancock County, Iowa	Kantono Hancock (Iovao)
Marion County, Iowa	Kantono Marion (Iovao)
Humboldt County, Iowa	Kantono Humboldt (Iovao)
Wayne County, Iowa	Kantono Wayne (Iovao)
Worth County, Iowa	Kantono Worth (Iovao)
Wapello County, Iowa	Kantono Wapello (Iovao)
Poweshiek County, Iowa	Kantono Poweshiek (Iovao)
Scott County, Iowa	Kantono Scott (Iovao)
Monona County, Iowa	Kantono Monona (Iovao)
Hardin County, Iowa	Kantono Hardin (Iovao)
Shelby County, Iowa	Kantono Shelby (Iovao)
Plymouth County, Iowa	Kantono Plymouth (Iovao)
Mitchell County, Iowa	Kantono Mitchell (Iovao)
Glendale, Calafòrnia	Glendale (Kalifornio)
Mills County, Iowa	Kantono Mills (Iovao)
Webster County, Iowa	Kantono Webster (Iovao)
Harrison County, Iowa	Kantono Harrison (Iovao)
Jasper County, Iowa	Kantono Jasper (Iovao)
Linn County, Iowa	Kantono Linn (Iovao)
Johnson County, Iowa	Kantono Johnson (Iovao)
Ringgold County, Iowa	Kantono Ringgold (Iovao)
Jackson County, Iowa	Kantono Jackson (Iovao)
Lee County, Iowa	Kantono Lee (Iovao)
Lyon County, Iowa	Kantono Lyon (Iovao)
Osceola County, Iowa	Kantono Osceola (Iovao)
Palo Alto County, Iowa	Kantono Palo Alto (Iovao)
Lucas County, Iowa	Kantono Lucas (Iovao)
Polk County, Iowa	Kantono Polk (Iovao)
Mahaska County, Iowa	Kantono Mahaska (Iovao)
Keokuk County, Iowa	Kantono Keokuk (Iovao)
Union County, Iowa	Kantono Union (Iovao)
Pocahontas County, Iowa	Pocahontas County (Iovao)
Montgomery County, Iowa	Kantono Montgomery (Iovao)
Jones County, Iowa	Kantono Jones (Iovao)
Marshall County, Iowa	Kantono Marshall (Iovao)
Monroe County, Iowa	Kantono Monroe (Iovao)
Iowa County, Iowa	Kantono Iowa (Iovao)
Woodbury County, Iowa	Kantono Woodbury (Iovao)
Louisa County, Iowa	Kantono Louisa (Iovao)
Barren County, Kentucky	Kantono Barren (Kentukio)
Fremont County, Iowa	Kantono Fremont (Iovao)
Grundy County, Iowa	Kantono Grundy (Iovao)
Hamilton County, Iowa	Kantono Hamilton (Iovao)
San Bernardino, Calafòrnia	San Bernardino (Kalifornio)
Guthrie County, Iowa	Kantono Guthrie (Iovao)
Cedar Rapids, Iowa	Cedar Rapids
Kansas City, Kansas	Kansasurbo (Kansaso)
Rochester, Minnesota	Rochester (Minesoto)
Marktl	Marktl
Pottawattamie County, Iowa	Kantono Pottawattamie (Iovao)
Calw	Calw
Salinas, Calafòrnia	Salinas (Kalifornio)
Ontario, Calafòrnia	Ontario (Kalifornio)
Greene County, Iowa	Kantono Greene (Iovao)
Monongalia County, Virginia an Iar	Kantono Monongalia (Okcidenta Virginio)
Montgomery County, Maryland	Kantono Montgomery (Marilando)
Monroe County, Virginia an Iar	Kantono Monroe (Okcidenta Virginio)
Oceanside, Calafòrnia	Oceanside (Kalifornio)
Anderson County, Carolina a Deas	Kantono Anderson (Suda Karolino)
Ratzeburg	Ratzeburg
Ventura, Calafòrnia	Ventura
Bayfield County, Wisconsin	Kantono Bayfield
Door County, Wisconsin	Kantono Door
Biloxi, Mississippi	Biloxi
Fort Collins, Colorado	Fort Collins
Pendleton County, Virginia an Iar	Kantono Pendleton (Okcidenta Virginio)
Boone County, Virginia an Iar	Kantono Boone (Okcidenta Virginio)
Brooke County, Virginia an Iar	Kantono Brooke (Okcidenta Virginio)
Jefferson County, Virginia an Iar	Kantono Jefferson (Okcidenta Virginio)
Berkeley County, Virginia an Iar	Kantono Berkeley (Okcidenta Virginio)
Morgan County, Virginia an Iar	Kantono Morgan (Okcidenta Virginio)
Calhoun County, Virginia an Iar	Kantono Calhoun (Okcidenta Virginio)
Fontana, Calafòrnia	Fontana (Kalifornio)
Muscatine County, Iowa	Kantono Muscatine (Iovao)
Wayne County, Missouri	Kantono Wayne (Misurio)
O'Brien County, Iowa	Kantono O'Brien (Iovao)
Wright County, Iowa	Kantono Wright (Iovao)
Berja	Berja
Grays Harbor County, Washington	Kantono Grays Harbor (Vaŝingtonio)
Island County, Washington	Kantono Island (Vaŝingtonio)
Seanadh Nàiseanta na Cuimrigh	Nacia Asembleo por Kimrio
Columbia County, Wisconsin	Kantono Columbia (Viskonsino)
Barbour County, Virginia an Iar	Kantono Barbour (Okcidenta Virginio)
Hampshire County, Virginia an Iar	Kantono Hampshire (Okcidenta Virginio)
Doddridge County, Virginia an Iar	Kantono Doddridge (Okcidenta Virginio)
Cabell County, Virginia an Iar	Kantono Cabell (Okcidenta Virginio)
Braxton County, Virginia an Iar	Kantono Braxton (Okcidenta Virginio)
Wayne County, Pennsylvania	Kantono Wayne (Pensilvanio)
Greenbrier County, Virginia an Iar	Kantono Greenbrier (Okcidenta Virginio)
Grant County, Virginia an Iar	Kantono Grant (Okcidenta Virginio)
Hechingen	Hechingen
Mingo County, Virginia an Iar	Kantono Mingo (Okcidenta Virginio)
Moreno Valley, Calafòrnia	Moreno Valley
Brown County, Wisconsin	Kantono Brown (Viskonsino)
Crawford County, Wisconsin	Kantono Crawford (Viskonsino)
Barron County, Wisconsin	Kantono Barron
Ashland County, Wisconsin	Kantono Ashland (Viskonsino)
Buffalo County, Wisconsin	Kantono Buffalo (Viskonsino)
Burnett County, Wisconsin	Kantono Burnett
Clark County, Wisconsin	Kantono Clark (Viskonsino)
Lancaster County, Carolina a Deas	Kantono Lancaster (Suda Karolino)
Edgefield County, Carolina a Deas	Kantono Edgefield (Suda Karolino)
Berkeley County, Carolina a Deas	Kantono Berkeley (Suda Karolino)
Wayne County, Virginia an Iar	Kantono Wayne (Okcidenta Virginio)
Webster County, Virginia an Iar	Kantono Webster (Okcidenta Virginio)
Lewis County, Virginia an Iar	Kantono Lewis (Okcidenta Virginio)
Lincoln County, Virginia an Iar	Kantono Lincoln (Okcidenta Virginio)
Preston County, Virginia an Iar	Kantono Preston (Okcidenta Virginio)
Logan County, Virginia an Iar	Kantono Logan (Okcidenta Virginio)
Upshur County, Virginia an Iar	Kantono Upshur (Okcidenta Virginio)
Rancho Cucamonga, Calafòrnia	Rancho Cucamonga
Euphonium	Eŭfono
Beaufort County, Carolina a Deas	Kantono Beaufort (Suda Karolino)
Sàl	Salakvo
Frombork	Frombork
Kennebec County, Maine	Kantono Kennebec
Chester County, Carolina a Deas	Kantono Chester (Suda Karolino)
Clarendon County, Carolina a Deas	Kantono Clarendon (Suda Karolino)
Hampton County, Carolina a Deas	Kantono Hampton (Suda Karolino)
Bamberg County, Carolina a Deas	Kantono Bamberg (Suda Karolino)
Bhaltair	Valtero
Sousaphone	Suzafono
Bràiste	Broĉo
Overland Park, Kansas	Overland Park
Padrón	Padrón (Korunjo)
Pocahontas County, Virginia an Iar	Kantono Pocahontas (Okcidenta Virginio)
Wood County, Virginia an Iar	Kantono Wood (Okcidenta Virginio)
Wirt County, Virginia an Iar	Kantono Wirt (Okcidenta Virginio)
Murfreesboro, Tennessee	Murfreesboro (Tenesio)
Kanawha County, Virginia an Iar	Kantono Kanawha (Okcidenta Virginio)
McDowell County, Virginia an Iar	Kantono McDowell (Okcidenta Virginio)
Putnam County, Virginia an Iar	Kantono Putnam (Okcidenta Virginio)
Raleigh County, Virginia an Iar	Kantono Raleigh (Okcidenta Virginio)
Randolph County, Virginia an Iar	Kantono Randolph (Okcidenta Virginio)
Mercer County, Virginia an Iar	Kantono Mercer (Okcidenta Virginio)
Summers County, Virginia an Iar	Kantono Summers (Okcidenta Virginio)
Mason County, Virginia an Iar	Kantono Mason (Okcidenta Virginio)
Roane County, Virginia an Iar	Kantono Roane (Okcidenta Virginio)
Ritchie County, Virginia an Iar	Kantono Ritchie (Okcidenta Virginio)
Wyoming County, Virginia an Iar	Kantono Wyoming (Okcidenta Virginio)
Wetzel County, Virginia an Iar	Kantono Wetzel (Okcidenta Virginio)
Dane County, Wisconsin	Kantono Dane
Greenville County, Carolina a Deas	Kantono Greenville (Suda Karolino)
Greenwood County, Carolina a Deas	Kantono Greenwood (Suda Karolino)
Darlington County, Carolina a Deas	Kantono Darlington (Suda Karolino)
Horry County, Carolina a Deas	Kantono Horry (Suda Karolino)
Dillon County, Carolina a Deas	Kantono Dillon (Suda Karolino)
Lexington County, Carolina a Deas	Kantono Lexington (Suda Karolino)
Dorchester County, Carolina a Deas	Kantono Dorchester (Suda Karolino)
Marion County, Carolina a Deas	Kantono Marion (Suda Karolino)
Colleton County, Carolina a Deas	Kantono Colleton (Suda Karolino)
Wayne County, Kentucky	Kantono Wayne (Kentukio)
Wayne County, Indiana	Kantono Wayne (Indianio)
Tuaidh	Rivero Tweed
Chris Pratt	Chris Pratt
Oisean	Ossian
Bearaig (baile)	Berwick-upon-Tweed
Fayette County, Virginia an Iar	Kantono Fayette (Okcidenta Virginio)
Marshall County, Virginia an Iar	Kantono Marshall (Okcidenta Virginio)
Gilmer County, Virginia an Iar	Kantono Gilmer (Okcidenta Virginio)
Marion County, Virginia an Iar	Kantono Marion (Okcidenta Virginio)
Harrison County, Virginia an Iar	Kantono Harrison (Okcidenta Virginio)
Jackson County, Virginia an Iar	Kantono Jackson (Okcidenta Virginio)
Hancock County, Virginia an Iar	Kantono Hancock (Okcidenta Virginio)
Fairfield County, Carolina a Deas	Kantono Fairfield (Suda Karolino)
Georgetown County, Carolina a Deas	Kantono Georgetown (Suda Karolino)
Florence County, Carolina a Deas	Kantono Florence (Suda Karolino)
Kershaw County, Carolina a Deas	Kantono Kershaw (Suda Karolino)
Martinez, Calafòrnia	Martinez (Kalifornio)
Wayne County, Carolina a Tuath	Kantono Wayne (Norda Karolino)
Bàthadh	Drono
Laurens County, Carolina a Deas	Kantono Laurens (Suda Karolino)
Mineral County, Virginia an Iar	Kantono Mineral (Okcidenta Virginio)
Tyler County, Virginia an Iar	Kantono Tyler (Okcidenta Virginio)
Taylor County, Virginia an Iar	Kantono Taylor (Okcidenta Virginio)
Tiriodh	Tiree
OpenOffice.org	OpenOffice
San Sebastián de La Gomera	San Sebastián de la Gomera
Rudolstadt	Rudolstadt
Bardenas Reales	Bardenas Reales
Llanfair	Llanfair
Còirnealair Parker	Kolonelo Tom Parker
2020an	2020-aj jaroj
Isaac Watts	Isaac Watts
Hydra	Hidro
Cluaran	Kardo
West Coast Region	Okcidentmarborda Regiono
Bleideag-sneachda	Floko
Uèir	Drato
Jean-Yves Le Drian	Jean-Yves Le Drian
Máirtín Ó Cadhain	Máirtín Ó Cadhain
Anarag	Anorako
Brynbuga	Usk (urbo)
Oware	Ovare
Cille Mheàrnaig	Kilmarnock
Coimeasach	Komparativo
2060an	2060-aj jaroj
Neuenhagen bei Berlin	Neuenhagen bei Berlin
Cocteau Twins	Cocteau Twins
Eideard VIII	Eduardo la 8-a (Britio)
Consairtean	Koncertino
Ceimigear	Kemiisto
Valentín González	El Campesino
Caldas	Caldas (Antjokio)
Malairt	Komerco
Cuan-choire	Kirlo
Dover	Dover
Dùn Bhlàthain	Dunblane
Breukelen	Breukelen (Utrecht)
Cailc	Kreto
Cherokee County, Carolina a Deas	Kantono Cherokee (Suda Karolino)
Deist	Diismo
Bòrd-sgeadachaidh	Komodo (meblo)
Helsa	Helsa
Alcelaphus buselaphus	Stepa alcelafo
Beannachd	Beno
Arauca (baile)	Araŭko (Kolombio)
Stràc throm	Maldekstra korno
Berkenbrück	Berkenbrück
Wehrheim	Wehrheim
Prionnsalachd Schwarzburg-Sondershausen	Schwarzburg-Sondershausen
Poblachd Ghranada Ùire	Respubliko de Nova Granado
Neiva	Neiva
Cebreros	Cebreros
Uainfheoil	Ŝafidaĵo
Cathag nan casan dearg	Ruĝbeka montokorvo
Torfaen	Torfaen
2050an	2050-aj jaroj
2040an	2040-aj jaroj
2070an	2070-aj jaroj
Blàr Chùil Lodair	Batalo de Culloden
Dùn Phrìs	Dumfries
Broth	Erupcio (medicino)
Cealsach	Kelso (Skotaj Limoj)
Canterbury Region	Kanterburio
Cartagena de Indias	Kartageno (Kolombio)
An Roinn Charaibeach	Karibio
Iòrdan	Jordan
Medellín (Spàinn)	Medellín (Hispanio)
Prionnsalachd Hohenzollern-Hechingen	Hohenzollern-Hechingen
Tanami	Tanami-Dezerto
Alpenhorn	Alpkorno
Crann-togail	Argano
Blas (dualchainnt)	Akĉento
Otago	Otago
Gaoth Dobhair	Gaoth Dobhair
Bowling Green, Kentucky	Bowling Green (Kentukio)
Prionnsalachd Schwarzburg-Rudolstadt	Schwarzburg-Rudolstadt
Garfield County, Washington	Kantono Garfield (Vaŝingtonio)
Diùcachd Sagsainn-Eisenach	Saksio-Eisenach
Diùcachd Nassau-Weilburg	Nassau-Weilburg
Prionnsalachd Isenburg	Graflando Isenburg
Oilthigh Erfurt	Universitato de Erfurto
Co-labhairt Évian	Konferenco de Évian
Arthur Aikin	Arthur Aikin
Liosta dùthchannan a-rèir àireamh-shluaigh	Listo de landoj laŭ loĝantaro
Aird nan Saighead	Arthur's Seat
2030an	2030-aj jaroj
Fuineadh	Bakado
Dealan-spèid	Telegrafo
Comar	Kunfluejo
Pluto	Pluto
2080an	2080-aj jaroj
Manach	Monaĥo
Mompós	Santa Cruz de Mompox
Nathair (Ceòl)	Serpento (blovinstrumento)
Tunnag	Hejmanaso
Corra-ghràin mhòr Aimeireaga	Nord-amerika botaŭro
Obar Neithich	Abernethy (Perth and Kinross)
Castell-nedd Port Talbot	Neath Port Talbot
Caisleán an Bharraigh	Castlebar
Nefud	Nefud
Duine-uasal	Ĝentlemano
Villavicencio	Villavicencio
Cimbasso	Cimbasso
Latha Mhartin Luther King	Martinluterkinga Tagofesto
Caisteal Shruighlea	Kastelo de Stirling
Karcag	Karcag
Lia Fàil	Ŝtono de Scone
Centro Federal de Educação Tecnológica Celso Suckow da Fonseca	Centro Federal de Educação Tecnológica Celso Suckow da Fonseca
Springs	Springs
Òrdag-coise	Halukso
Salm 91	Psalmo 91
Oilthigh Cantàbria	Universitato de Kantabrio
Bus	Buso
Klaipėda	Klaipėda
Llangernyw	Llangernyw
Doc Penfro	Pembroke Dock
Moguer	Moguer
Bealltainn	Belteno
Fàsach Cholistan	Dezerto de Ĉolistano
Baja California	Kaliforni-duoninsula Dezerto
Allt a' Bhonnaich	Bannockburn
Fàsach Bhayuda	Bajuda-Dezerto
Siontò	Ŝintoismo
Bello	Bello (Kolombio)
Ceimigearan Ainmeil	Listo de kemiistoj
Klickitat County, Washington	Kantono Klickitat (Vaŝingtonio)
Riohacha (baile)	Riohacha
Tinbheal	Tynwald
Bono	Bono Vox
Diùcachd Nassau	Duklando Nassau
La Jolla, Calafòrnia	La Jolla
Plasticine	Modlopasto
Bìth	Peĉo
Gath (cuibhle)	Spoko
2090an	2090-aj jaroj
Clay County, Virginia an Iar	Kantono Clay (Okcidenta Virginio)
Ohio County, Virginia an Iar	Kantono Ohio (Okcidenta Virginio)
Neapraigear	Buŝtuko
Siobhag	Meĉo
Buchach	Buĉaĉ
York University	York University
Aoradh	Diservo
Montería (baile)	Monteria
Sgàin	Scone (Skotlando)
VietJet Air	VietJet Air
Fàsach Chihuahuan	Ĉiuaŭa Dezerto
Strijen	Strijen
Gallaibh	Caithness
Wakame	Vakameo
Yarmouth, Alba Nuadh	Yarmouth (Nov-Skotio)
Teine an taighe-tionnsgain Trì-cheàrnag	Brulado de Triangle Shirtwaist Factory
Brillean	Klitoro
Steàrnan	Ŝterno
Dango	Dango
Boksburg	Boksburg
Jethou	Jethou
Leasbach dhatha-bhilean	Njo-lesbanino
Brecqhou	Brechou
Henri Braconnot	Henri Braconnot
Hilaire Rouelle	Hilaire Rouelle
Canàl Cailleanach	Kaledonia Kanalo
Caerffili	Caerphilly
Cobhair:Susbaint	Helpo:Enhavo
Kingston	Kingston
Pontifícia Universidade Católica de Minas Gerais	Pontifícia Universidade Católica de Minas Gerais
Àrd-thìr Cholorado	Kolorado-altebenaĵo
Santa Fe de Antioquia	Sankta Fido de Antjokio
Honda (Baile)	Honda (Tolimo)
Greymouth	Greymouth
Fàsach dathte (Arizona)	Pentrita Dezerto
Fàsach Thabernas	Dezerto de Tabernas
Sechura	Seĉura-Dezerto
Hebrides Overture	Die Hebriden (Mendelssohn)
Rangipo	Rangipo (dezerto)
Tùcaid	Kolomba staleto
Sir William Ramsay	William Ramsay
Forbes	Forbes
Great Basin	Granda Baseno
Beic	Riverenco
Bun-sgoil	Elementa lernejo
Àicheil	Negativa
Taigh Iain Ghròt	John o' Groats
Buenaventura	Buenaventura (Kolombio)
Urla	Urla (Izmiro)
Leiderdorp	Leiderdorp
Szczawno-Zdrój	Szczawno-Zdrój
Léim an Mhadaidh	Limavady
Lannraig, Lannraig a Deas	Lanark
Dùn Barra	Dunbar (Skotlando)
Craobh-Iubhair Fhartairchill	Taksuso de Fortingall
Druim na Drochaid	Drumnadrochit
Whanganui	Wanganui
Eaglais Fheichin	Ecclefechan
Gleann Iucha	Linlithgow
Hunndaidh	Huntly (Skotlando)
Jagniątków	Jagniątków
Eygelshoven	Eygelshoven
Uitenhage	Uitenhage
Mvezo	Mvezo
An t-Sròn	Troon
El Hierro	El Hierro
Sincelejo	Sincelejo
Carterton, Sealainn Nuadh	Carterton (Nov-Zelando)
Carwitz	Carwitz
Cairteil Medellín	Medellín-Kartelo
Tìr nan Cailleannach	Kaledonio
Bliadhna a' Phrionnsa	Dua jakobita ribelo
Cataibh	Sutherland
Fàsach Phatagòinia	Patagona Stepo
Channeled scablands	Skablandoj
Ainmean Bailtean Eòrpach	Listo de nomoj de eŭropaj urboj en diversaj lingvoj
Coileach Fraoich	Skota lagopo
Bas	Palm
Critheann	Tremolecaj poploj
Currach Cuimreach	Koraklo
Urras	Trusto
Bòid	Voto
Blàr Boyacá	Batalo de Bojakao
Oilthigh Nàiseanta Colombia	Nacia Universitato de Kolombio
Loidig mhatamataigeach	Matematika logiko
Loch	Loĥo
Giomach uisge	Kankro (besto)
Ùr-sgeulachd	Mito
Roinn (matamataig)	Divido
Dollar	Dolaro
Dolair	Dolaro (urbo)
Siorrachd Pheairt	Perthshire
Pàrtaidh Uaine na h-Alba	Skota Verda Partio
Oilthigh Antioquia	Universitato de Antjokio
Seòlaid	Akvovojo
60an	60-aj jaroj
50an	50-aj jaroj
40an	40-aj jaroj
30an	30-aj jaroj
Blàr Flodden	Flodden Field (batalo)
Loch Ma-ruibhe	Maree
Beinn Rothaich	Munro
Ennor	Sankta Maria (Scilly)
Sìdhe	Sidhe
Sgrùdair ciùil	Muzikkritikisto
Fàsach Strzelecki	Strzelecki-Dezerto
Oilthigh Cailleannach Glaschu	Kaledonia Universitato de Glasgovo
Agnes Monica	Agnes Monica
Joaquín Mosquera	Joaquín Mosquera
Loch Obha	Fjordo Awe
Domingo Caycedo Santamaría	Domingo Caycedo
Gaza	Gazao
Roinn-seòrsa:A' Ghearmailt	Kategorio:Germanio
Roinn-seòrsa:An Eadailt	Kategorio:Italio
Roinn-seòrsa:Na Stàitean Aonaichte	Kategorio:Usono
Roinn-seòrsa:An Ruis	Kategorio:Rusio
Roinn-seòrsa:Canada	Kategorio:Kanado
Roinn-seòrsa:An Rìoghachd Aonaichte	Kategorio:Unuiĝinta Reĝlando
Roinn-seòrsa:An Spàinn	Kategorio:Hispanio
Roinn-seòrsa:An t-Seapan	Kategorio:Japanio
Roinn-seòrsa:Astràilia	Kategorio:Aŭstralio
Roinn-seòrsa:Meagsago	Kategorio:Meksiko
Roinn-seòrsa:Na h-Innseachan	Kategorio:Barato
Roinn-seòrsa:Aràibia nan Sabhd	Kategorio:Sauda Arabio
Roinn-seòrsa:Israel	Kategorio:Israelo
Roinn-seòrsa:An Tuirc	Kategorio:Turkio
Roinn-seòrsa:An Èipheit	Kategorio:Egiptio
Roinn-seòrsa:Sealainn Nuadh	Kategorio:Nov-Zelando
Roinn-seòrsa:An Argantain	Kategorio:Argentino
Paramadair	Parametro
Roinn-seòrsa:0an	0-aj jaroj
20an	20-aj jaroj
Bogsa-phutan	Butonakordiono
An Caisteal Nuadh	Newcastle-upon-Tyne
Teicheadh nan Iarla	La Fuĝo de la Grafoj
1120an	1120-aj jaroj
Envigado	Envigado
Roinn-seòrsa:An Ostair	Kategorio:Aŭstrio
Roinn-seòrsa:An Innd-Innse	Kategorio:Indonezio
Roinn-seòrsa:Na Tìrean Ìsle	Kategorio:Nederlando
Roinn-seòrsa:Pacastan	Kategorio:Pakistano
Roinn-seòrsa:A' Phòlainn	Kategorio:Pollando
Roinn-seòrsa:A' Phortagail	Kategorio:Portugalio
Roinn-seòrsa:An Eilbheis	Kategorio:Svislando
Roinn-seòrsa:An Ucràin	Kategorio:Ukrainio
Roinn-seòrsa:Bhiet-Nam	Kategorio:Vjetnamio
Roinn-seòrsa:Impireachd na Ròimhe	Kategorio:Romia Imperio
Roinn-seòrsa:Mamalan	Kategorio:Mamuloj
Roinn-seòrsa:Snàigean	Kategorio:Reptilioj
Roinn-seòrsa:Eòin	Kategorio:Birdoj
Roinn-seòrsa:Eòlas-nàdair	Kategorio:Fiziko
Roinn-seòrsa:Bith-eòlas	Kategorio:Biologio
Roinn-seòrsa:Ceimigeachd	Kategorio:Kemio
Roinn-seòrsa:Eachdraidh	Kategorio:Historio
Roinn-seòrsa:Cruinn-eòlas	Kategorio:Geografio
Roinn-seòrsa:Creideamh	Kategorio:Religio
Roinn-seòrsa:Spòrs	Kategorio:Sporto
Roinn-seòrsa:Eòlas	Kategorio:Scienco
Roinn-seòrsa:An t-Aonadh Eòrpach	Kategorio:Eŭropa Unio
Reifreann air Neo-eisimealachd na h-Alba 2014	Referendumo pri sendependeco de Skotlando
Viktor Yushchenko	Viktor Juŝĉenko
Kapiti	Insulo Kapiti
Fàsach dathte (Astràilia)	Pentrita Dezerto (Aŭstralio)
Ketchum, Idaho	Ketchum (Idaho)
Itagüí	Itagüí
Breig (càr)	Bremso
Coinneach	Kenneth
Great Salt Lake Desert	Dezerto Granda Sala Lago
Bailiùn-adhair teth	Varmaerbalono
Orientalism (leabhar)	Orientalismo (libro)
Gobha	Forĝisto
Sùlaire	Suloj
Isla Grande de Tierra del Fuego	Granda Insulo de Fajrolando
Cogadh nam Boer	Brita-bura milito
Rhaeadr Gwy	Rhayader
Ball-maise	Ornamo
Panevėžys	Panevėžys
Una Voce	Una Voce
Monte Desert	Monte-Arbedaro
Fàsach Chalbi	Ĉalbi-Dezerto
Loch Innis Mo Cholmaig	Lago de Menteith
Latha a' Bhreitheanais	Lasta juĝo
Oilthigh Srath Chluaidh	Universitato de Strathclyde
Otorohanga	Otorohanga
Ad-Dahna	Daĥnao
1 Samuel	1-a libro de Samuel
Roinn-seòrsa:Soilleireachadh	Kategorio:Apartigiloj
Roinn-seòrsa:Na h-Olympics	Kategorio:Olimpikoj
Roinn-seòrsa:Feallsanachd	Kategorio:Filozofio
Roinn-seòrsa:Eòlas-inntinn	Kategorio:Psikologio
Roinn-seòrsa:Crìosdaidheachd	Kategorio:Kristanismo
Roinn-seòrsa:Islam	Kategorio:Islamo
Bodach-ròcais	Birdotimigilo
Ynys Enlli	Insulo Bardsey
Biwmares	Beaumaris
Universidad Pontificia Bolivariana	Pontifika Universitato Bolivarana
Cadha	Ravino
Àirigh	Alpopaŝtejo
Tír an Iúir	Terenure
Iolair	Aglo
Westland District	Okcidenta Distrikto
Lèineag is sgiort	Jupo
Llanwrtyd	Llanwrtyd Wells
Bealaidh	Genisto
Ocaña	Ocaña (Norda Santandero)
Còbra	Kobro
Cluain Tarbh	Clontarf (Dublino)
Dasht-e Margoh	Daŝti Margo
Bochotnica	Bochotnica
Taupo	Taupo
León de Greiff	León de Greiff
Universidade do Estado de Minas Gerais	Universidade do Estado de Minas Gerais
Ráth Garbh	Rathgar
Crughywel	Crickhowell
Aodh Rua Ó Dónaill	Aodh Rua Ó Dónaill
Fàsach Gleann Indus	Indus-vala dezerto
Conrad Bain	Conrad Bain
Blàr Sliabh an t-Siorraim	Batalo de Sheriffmuir
's-Hertogenbosch	's-Hertogenbosch
Bradan	Salmo
Unnlagh	Monpuno
Breac	Bruna truto
Roinn-seòrsa:Bun	Kategorio:Ĝermo
Roinn-seòrsa:Planaidean	Kategorio:Planedoj
Roinn-seòrsa:Cultar	Kategorio:Kulturo
Roinn-seòrsa:Mòr-roinnean	Kategorio:Kontinentoj
Roinn-seòrsa:Eòlas-talmhainn	Kategorio:Geologio
Roinn-seòrsa:Liostaichean	Kategorio:Listoj
10an	10-aj jaroj
Passamaquoddy (cànan)	Malesita-Pasamakvodja lingvo
Pàrras	Paradizo
Portobello	Portobello (Edinburgo)
Sark	Sark
Gobhar-adhair	Galinago
Roinn-seòrsa:Wikipedia bots	Kategorio:Vikipedio:Robotoj
Fernando González (ùghdair)	Fernando González Ochoa
Roinn-seòrsa:Cleasaichean nam film	Kategorio:Aktoroj
Roinn-seòrsa:LCDT	Kategorio:GLAT
Teamplaid:Userbox	Ŝablono:Uzantoskatolo1
Creag-ola	Petrolo
Roinn-seòrsa:Lagh	Kategorio:Juro
Roinn-seòrsa:Dùthchannan	Kategorio:Landoj
Roinn-seòrsa:Eaconomachd	Kategorio:Ekonomiko
Uicipeid:Administrators	Vikipedio:Administrantoj
Uicipeid:Bot policy	Vikipedio:Roboto
Roinn-seòrsa:Eadar-lìon	Kategorio:Interreto
Uicipeid:WikiProject Check Wikipedia	Projekto:Kontrolu Vikipedion
Roinn-seòrsa:Poileataigs	Kategorio:Politiko
Roinn-seòrsa:Foghlam	Kategorio:Edukado
Roinn-seòrsa:Ealain	Kategorio:Arto
Kaunas	Kaŭno
Cunntasachd	Kontado
Königsberg	Kenigsbergo
An Èipheit	Egiptujo
Roinn-seòrsa:Feallsanaiche	Kategorio:Filozofoj
Teamplaid:Bot	Ŝablono:Bot
Trafaig	Trafiko
Canada	Kanado
Roinn-seòrsa:An Ungair	Kategorio:Hungario
Roinn-seòrsa:A' Bheilg	Kategorio:Belgio
Roinn-seòrsa:An t-Seic	Kategorio:Ĉeĥio
Roinn-seòrsa:An Danmhairg	Kategorio:Danio
Roinn-seòrsa:Eastòinia	Kategorio:Estonio
Roinn-seòrsa:Suòmaidh	Kategorio:Finnlando
Roinn-seòrsa:A' Ghrèig	Kategorio:Grekio
Roinn-seòrsa:Innis Tìle	Kategorio:Islando
Roinn-seòrsa:Lucsamburg	Kategorio:Luksemburgo
Roinn-seòrsa:Liotuàinia	Kategorio:Litovio
Roinn-seòrsa:An t-Suain	Kategorio:Svedio
Roinn-seòrsa:An t-Slòbhac	Kategorio:Slovakio
Roinn-seòrsa:Sloibhìnia	Kategorio:Slovenio
Roinn-seòrsa:Poblachd na h-Èireann	Kategorio:Respubliko de Irlando
Teamplaid:Flagicon	Ŝablono:Flagikono
Roinn-seòrsa:An Roinn-Eòrpa	Kategorio:Eŭropo
Teamplaid:Documentation	Ŝablono:Dok
Uicipeid:Doras na coimhearsnachd	Portalo:Komunumo
Roinn-seòrsa:Cànain an luchd-cleachdaidh	Kategorio:Vikipediistoj laŭ lingvo
Sung Jae-gi	Sung Jae-gi
Gnothachas	Profitcela organizaĵo
Instituto Federal da Bahia	Federacia Instituto de Bahio
Teamplaid:Softredirect	Ŝablono:Intervikia plusendilo
Teamplaid:Delete	Ŝablono:Forigu tuj
Rìghrean Breatainn Mhòr agus an Rìoghachd Aonaichte	Listo de britaj reĝoj
Roinn-seòrsa:Teicneòlas	Kategorio:Teknologio
Breug	Mensogo
Roinn-seòrsa:Cànain	Kategorio:Lingvoj
Cairgean	Chondrus crispus
Uicipeid:General disclaimer	Vikipedio:Malgarantio
Saighdear	Soldato
Roinn-seòrsa:Bailtean anns an t-Seic	Kategorio:Urboj de Ĉeĥio
Teamplaid:-	Ŝablono:-
Teamplaid:Navbox	Ŝablono:Navigilo2
Teamplaid:Shortcut	Ŝablono:Mallongigo
Teamplaid:Dàta pearsa	Ŝablono:Informkesto biografio
Teamplaid:Fact	Ŝablono:Mankas fonto
Pana	PAN
Teamplaid:!	Ŝablono:!
Teamplaid:!-	Ŝablono:!-
Teamplaid:=	Ŝablono:=
Teamplaid:Navbar	Ŝablono:Tnavbar
Teamplaid:Unicode	Ŝablono:Unicode
Roinn-seòrsa:Afraga	Kategorio:Afriko
Roinn-seòrsa:Bìoball	Kategorio:Biblio
Teamplaid:Babel	Ŝablono:Babelejo
Teamplaid:Commons	Ŝablono:Commons
Teamplaid:Link GA	Ŝablono:LigoLeginda
Teamplaid:Reflist	Ŝablono:Referencoj
Teamplaid:Gnunote	Ŝablono:Gnunote
Teamplaid:Bun	Ŝablono:Ĝermo
Teamplaid:User af-1	Ŝablono:Vikipediisto af-1
Teamplaid:User ar-1	Ŝablono:Vikipediisto ar-1
Teamplaid:User eo-1	Ŝablono:Vikipediisto eo-1
Teamplaid:See also	Ŝablono:Vidu ankaŭ
Teamplaid:User da-2	Ŝablono:Vikipediisto da-2
Teamplaid:User da	Ŝablono:Vikipediisto da
Teamplaid:User be-2	Ŝablono:Vikipediisto be-2
Teamplaid:User da-1	Ŝablono:Vikipediisto da-1
Teamplaid:User eo-3	Ŝablono:Vikipediisto eo-3
Teamplaid:User de	Ŝablono:Vikipediisto de
Teamplaid:User de-1	Ŝablono:Vikipediisto de-1
Teamplaid:User el	Ŝablono:Vikipediisto el
Teamplaid:User es	Ŝablono:Vikipediisto es
Teamplaid:User de-3	Ŝablono:Vikipediisto de-3
Teamplaid:User en-3	Ŝablono:Vikipediisto en-3
Teamplaid:User en-1	Ŝablono:Vikipediisto en-1
Teamplaid:User en-2	Ŝablono:Vikipediisto en-2
Teamplaid:User fa-1	Ŝablono:Vikipediisto fa-1
Teamplaid:User eo-2	Ŝablono:Vikipediisto eo-2
Teamplaid:User en-4	Ŝablono:Vikipediisto en-4
Teamplaid:User fi	Ŝablono:Vikipediisto fi-D
Teamplaid:User en	Ŝablono:Vikipediisto en
Teamplaid:User de-2	Ŝablono:Vikipediisto de-2
Teamplaid:User es-1	Ŝablono:Vikipediisto es-1
Teamplaid:User fr-1	Ŝablono:Vikipediisto fr-1
Teamplaid:User he-2	Ŝablono:Vikipediisto he-2
Teamplaid:User id-3	Ŝablono:Vikipediisto id-3
Teamplaid:User io-3	Ŝablono:Vikipediisto io-3
Teamplaid:User it-3	Ŝablono:Vikipediisto it-3
Teamplaid:User grc-1	Ŝablono:Vikipediisto grc-1
Teamplaid:User ja-4	Ŝablono:Vikipediisto ja-4
Teamplaid:User tr-2	Ŝablono:Vikipediisto tr-2
Teamplaid:User ja	Ŝablono:Vikipediisto ja
Teamplaid:User ja-1	Ŝablono:Vikipediisto ja-1
Teamplaid:User it-1	Ŝablono:Vikipediisto it-1
Teamplaid:User hr-1	Ŝablono:Vikipediisto hr-1
Teamplaid:User fr	Ŝablono:Vikipediisto fr
Roinn-seòrsa:Moldàibhia	Kategorio:Moldavio
Roinn-seòrsa:Àisia	Kategorio:Azio
Roinn-seòrsa:An t-Sile	Kategorio:Ĉilio
Roinn-seòrsa:21mh linn	Kategorio:21-a jarcento
Roinn-seòrsa:User uk	Kategorio:Vikipediisto uk
Roinn-seòrsa:Aimearaga a Deas	Kategorio:Sudameriko
Roinn-seòrsa:Castilla y León	Kategorio:Kastilio kaj Leono
Roinn-seòrsa:User uk-N	Kategorio:Vikipediisto uk-D
Teamplaid:Intricate template	Ŝablono:Esotera
Roinn-seòrsa:Malaysia	Kategorio:Malajzio
Roinn-seòrsa:Ball-coise	Kategorio:Futbalo
Teamplaid:Mod	Ŝablono:Mod
Teamplaid:User it	Ŝablono:Vikipediisto it
Teamplaid:User uk	Ŝablono:Vikipediisto uk
Teamplaid:User es-2	Ŝablono:Vikipediisto es-2
Roinn-seòrsa:Cànanachas	Kategorio:Lingvoscienco
Teamplaid:CC-by-sa-3.0	Ŝablono:Cc-by-sa-3.0
Teamplaid:Userbox-2	Ŝablono:Uzantoskatolo-2
Roinn-seòrsa:User fr-1	Kategorio:Vikipediisto fr-1
Teamplaid:Infobox musical artist	Ŝablono:Informkesto muzika artisto
Teamplaid:Ambox	Ŝablono:ArtikolaMesaĝokesto
Teamplaid:Babel field	Ŝablono:Babel kadro
Teamplaid:Navigational templates	Ŝablono:Navigilaro
Teamplaid:Dùthaich	Ŝablono:Informkesto lando
Teamplaid:Column-count	Ŝablono:Kolumno-nombro
Teamplaid:Cogadh	Ŝablono:Informkesto milito
Teamplaid:Str left	Ŝablono:Lin mald
Teamplaid:Str sub long	Ŝablono:Lin sub
Teamplaid:Tmbox	Ŝablono:DiskutaMesaĝokesto
Teamplaid:Cleanup	Ŝablono:Polurinda
Teamplaid:Exzellent	Ŝablono:Elstara
Roinn-seòrsa:User en-4	Kategorio:Vikipediisto en-4
Roinn-seòrsa:User en	Kategorio:Vikipediisto en
Roinn-seòrsa:User zh	Kategorio:Vikipediisto zh
Roinn-seòrsa:Croàisia	Kategorio:Kroatio
Roinn-seòrsa:User zh-N	Kategorio:Vikipediisto zh-D
Roinn-seòrsa:User en-2	Kategorio:Vikipediisto en-2
Teamplaid:Infobox	Ŝablono:Informkesto
Teamplaid:TOCright	Ŝablono:TOC-dekstre
Teamplaid:Ns0	Ŝablono:Ĉu artikolo
Teamplaid:User zh	Ŝablono:Vikipediisto zh
Roinn-seòrsa:Aibidil	Kategorio:Alfabeto
Teamplaid:Template other	Ŝablono:Ĉu ŝablono
Roinn-seòrsa:Sgrìobhadairean Breatannach	Kategorio:Britaj verkistoj
Teamplaid:Cite web	Ŝablono:Citaĵo el la reto
Teamplaid:AZ	Ŝablono:A-Z
Teamplaid:Loch ann an Alba	Ŝablono:Informkesto maro
Teamplaid:User ru-4	Ŝablono:Vikipediisto ru-4
Teamplaid:Coor URL	Ŝablono:KoordinatojURL
Teamplaid:Pp-template	Ŝablono:Pp-ŝablono
Teamplaid:User nl-1	Ŝablono:Vikipediisto nl-1
Teamplaid:Wiktionary	Ŝablono:Vikivortaro
Teamplaid:User nl-2	Ŝablono:Vikipediisto nl-2
Roinn-seòrsa:Àiteachas	Kategorio:Agrikulturo
Teamplaid:Pp-semi-template	Ŝablono:Pp-duone-ŝablono
Teamplaid:User ru	Ŝablono:Vikipediisto ru
Roinn-seòrsa:20mh linn	Kategorio:20-a jarcento
Teamplaid:IPA	Ŝablono:IFA
Teamplaid:Cinn-suidhe nan Stàitean Aonaichte	Ŝablono:Prezidentoj de Usono
Roinn-seòrsa:Teamplaid:Cànan	Kategorio:Babelaj ŝablonoj
Teamplaid:LangWithName	Ŝablono:LingvoKunNomo
Teamplaid:Babel field N	Ŝablono:Babel kadro D
Roinn-seòrsa:Washington (stàit)	Kategorio:Vaŝingtonio
Teamplaid:Imbox	Ŝablono:BildaMesaĝokesto
Teamplaid:Beinn	Ŝablono:Informkesto monto
Teamplaid:Birth date and age	Ŝablono:Naskiĝdato kaj aĝo
Teamplaid:Babel field 1	Ŝablono:Babel kadro 1
Teamplaid:MONTHNAME	Ŝablono:Nomo de monato
Teamplaid:Neach-poileataigs	Ŝablono:Informkesto politikisto
Teamplaid:Death date and age	Ŝablono:Mortodato kaj aĝo
Teamplaid:MONTH	Ŝablono:Nombro de monato
Roinn-seòrsa:19mh linn	Kategorio:19-a jarcento
Roinn-seòrsa:Sgrìobhadairean	Kategorio:Verkistoj
Roinn-seòrsa:Oilthighean	Kategorio:Universitatoj
Teamplaid:Hidden begin	Ŝablono:Kaŝskatolo komenco
Teamplaid:Booland	Ŝablono:Booland
Teamplaid:User pt-1	Ŝablono:Vikipediisto pt-1
Roinn-seòrsa:Sgiobanan ball-coise Edailteach	Kategorio:Italaj futbalteamoj
Teamplaid:Hidden	Ŝablono:Kaŝskatolo
Teamplaid:User pl	Ŝablono:Vikipediisto pl
Teamplaid:User nl	Ŝablono:Vikipediisto nl
Teamplaid:User no-2	Ŝablono:Vikipediisto no-2
Teamplaid:Documentation subpage	Ŝablono:Ŝablona navigado
Teamplaid:Tlx	Ŝablono:Tlx
Teamplaid:Str len	Ŝablono:Lin longo
Teamplaid:Babel field 4	Ŝablono:Babel kadro 4
Teamplaid:User pl-1	Ŝablono:Vikipediisto pl-1
Teamplaid:Babel field 0	Ŝablono:Babel kadro 0
Teamplaid:User fr-3	Ŝablono:Vikipediisto fr-3
Teamplaid:Redirect	Ŝablono:Alidirekto
Teamplaid:User nds-1	Ŝablono:Vikipediisto nds-1
Teamplaid:Cc-by-sa-2.0	Ŝablono:Cc-by-sa-2.0
Teamplaid:Coord/link	Ŝablono:Koord/ligilo
Teamplaid:User is-1	Ŝablono:Vikipediisto is-1
Teamplaid:User en-5	Ŝablono:Vikipediisto en-5
Teamplaid:Làithean na seachdain	Ŝablono:Tagoj de la semajno
Roinn-seòrsa:Carolina a Tuath	Kategorio:Norda Karolino
Roinn-seòrsa:User ja-N	Kategorio:Vikipediisto ja-D
Teamplaid:URL	Ŝablono:URL
Roinn-seòrsa:Buidseachd	Kategorio:Sorĉaferoj
Teamplaid:No	Ŝablono:Ne farita
Roinn-seòrsa:Teamplaid:Infobox	Kategorio:Ŝablono:Informkesto
Roinn-seòrsa:An Ear Mheadhanach	Kategorio:Mezoriento
Teamplaid:Para	Ŝablono:Parametro
Teamplaid:Death year and age	Ŝablono:Mortojaro kaj aĝo
Teamplaid:User no	Ŝablono:Vikipediisto no
Roinn-seòrsa:Carolina a Deas	Kategorio:Suda Karolino
Teamplaid:Geobox	Ŝablono:Geokesto
Teamplaid:Death date	Ŝablono:Mortodato
Ailigeutair	Aligatoredoj
Teamplaid:Babel field 3	Ŝablono:Babel kadro 3
Roinn-seòrsa:Ailtireachd	Kategorio:Arkitekturo
Teamplaid:User sv-2	Ŝablono:Vikipediisto sv-2
Teamplaid:User it-2	Ŝablono:Vikipediisto it-2
Teamplaid:Age	Ŝablono:Aĝo
Teamplaid:Mòr-roinnean	Ŝablono:Kontinentoj
Teamplaid:Convert	Ŝablono:Convert
Teamplaid:Coord	Ŝablono:Koord
Teamplaid:User pt-2	Ŝablono:Vikipediisto pt-2
Roinn-seòrsa:Wyoming	Kategorio:Vajomingo
Teamplaid:User fr-4	Ŝablono:Vikipediisto fr-4
Roinn-seòrsa:Bailtean na h-Alba	Kategorio:Urboj en Skotlando
Teamplaid:User la-1	Ŝablono:Vikipediisto la-1
Roinn-seòrsa:User az	Kategorio:Vikipediisto az
Roinn-seòrsa:User be	Kategorio:Vikipediisto be
Roinn-seòrsa:User hr	Kategorio:Vikipediisto hr
Roinn-seòrsa:User sco	Kategorio:Vikipediisto sco
Roinn-seòrsa:User sk	Kategorio:Vikipediisto sk
Roinn-seòrsa:User sl	Kategorio:Vikipediisto sl
Roinn-seòrsa:User eo	Kategorio:Vikipediisto eo
Roinn-seòrsa:User et	Kategorio:Vikipediisto et
Roinn-seòrsa:User fr	Kategorio:Vikipediisto fr
Roinn-seòrsa:User gl	Kategorio:Vikipediisto gl
Roinn-seòrsa:User cy	Kategorio:Vikipediisto cy
Roinn-seòrsa:User id	Kategorio:Vikipediisto id
Roinn-seòrsa:User ga	Kategorio:Vikipediisto ga
Roinn-seòrsa:User ja	Kategorio:Vikipediisto ja
Roinn-seòrsa:User la	Kategorio:Vikipediisto la
Roinn-seòrsa:User nn	Kategorio:Vikipediisto nn
Roinn-seòrsa:User pt	Kategorio:Vikipediisto pt
Roinn-seòrsa:User ro	Kategorio:Vikipediisto ro
Roinn-seòrsa:User sv	Kategorio:Vikipediisto sv
Roinn-seòrsa:User cs-3	Kategorio:Vikipediisto cs-3
Roinn-seòrsa:User fr-3	Kategorio:Vikipediisto fr-3
Roinn-seòrsa:User it-3	Kategorio:Vikipediisto it-3
Roinn-seòrsa:User ja-3	Kategorio:Vikipediisto ja-3
Roinn-seòrsa:User nl-3	Kategorio:Vikipediisto nl-3
Roinn-seòrsa:User da-1	Kategorio:Vikipediisto da-1
Roinn-seòrsa:User et-1	Kategorio:Vikipediisto et-1
Roinn-seòrsa:User cy-1	Kategorio:Vikipediisto cy-1
Roinn-seòrsa:User ga-1	Kategorio:Vikipediisto ga-1
Roinn-seòrsa:User nl-1	Kategorio:Vikipediisto nl-1
Roinn-seòrsa:User pl-1	Kategorio:Vikipediisto pl-1
Roinn-seòrsa:User ro-1	Kategorio:Vikipediisto ro-1
Roinn-seòrsa:User tr-1	Kategorio:Vikipediisto tr-1
Roinn-seòrsa:User ar-1	Kategorio:Vikipediisto ar-1
Roinn-seòrsa:User fr-4	Kategorio:Vikipediisto fr-4
Roinn-seòrsa:User be-2	Kategorio:Vikipediisto be-2
Roinn-seòrsa:User da-2	Kategorio:Vikipediisto da-2
Roinn-seòrsa:User sco-2	Kategorio:Vikipediisto sco-2
Roinn-seòrsa:User sk-2	Kategorio:Vikipediisto sk-2
Roinn-seòrsa:User fr-2	Kategorio:Vikipediisto fr-2
Roinn-seòrsa:User it-2	Kategorio:Vikipediisto it-2
Roinn-seòrsa:User la-2	Kategorio:Vikipediisto la-2
Roinn-seòrsa:User nl-2	Kategorio:Vikipediisto nl-2
Roinn-seòrsa:User pl-2	Kategorio:Vikipediisto pl-2
Roinn-seòrsa:User sv-2	Kategorio:Vikipediisto sv-2
Roinn-seòrsa:User tr-2	Kategorio:Vikipediisto tr-2
Roinn-seòrsa:User cs-N	Kategorio:Vikipediisto cs-D
Roinn-seòrsa:User sl-N	Kategorio:Vikipediisto sl-D
Roinn-seòrsa:User fr-N	Kategorio:Vikipediisto fr-D
Roinn-seòrsa:User it-N	Kategorio:Vikipediisto it-D
Roinn-seòrsa:User nl-N	Kategorio:Vikipediisto nl-D
Roinn-seòrsa:User no-N	Kategorio:Vikipediisto no-D
Roinn-seòrsa:User nn-N	Kategorio:Vikipediisto nn-D
Roinn-seòrsa:User ru-N	Kategorio:Vikipediisto ru-D
Roinn-seòrsa:Prìomh-bhailtean ann an Roinn a' Chuain Shèimh	Kategorio:Ĉefurboj de Oceanio
Roinn-seòrsa:Templates using ParserFunctions	Kategorio:Ŝablonoj uzantaj ParserFunctions
Roinn-seòrsa:User af	Kategorio:Vikipediisto af
Roinn-seòrsa:User af-1	Kategorio:Vikipediisto af-1
Roinn-seòrsa:User ar	Kategorio:Vikipediisto ar
Roinn-seòrsa:User cs	Kategorio:Vikipediisto cs
Roinn-seòrsa:User da	Kategorio:Vikipediisto da
Teamplaid:UF-hcard-person	Ŝablono:UF-hcard-persono
Roinn-seòrsa:User de	Kategorio:Vikipediisto de
Roinn-seòrsa:User de-2	Kategorio:Vikipediisto de-2
Roinn-seòrsa:User de-3	Kategorio:Vikipediisto de-3
Roinn-seòrsa:User de-4	Kategorio:Vikipediisto de-4
Roinn-seòrsa:User de-N	Kategorio:Vikipediisto de-D
Roinn-seòrsa:User dsb	Kategorio:Vikipediisto dsb
Roinn-seòrsa:User dsb-1	Kategorio:Vikipediisto dsb-1
Roinn-seòrsa:User el	Kategorio:Vikipediisto el
Roinn-seòrsa:User el-N	Kategorio:Vikipediisto el-D
Roinn-seòrsa:User en-3	Kategorio:Vikipediisto en-3
Roinn-seòrsa:User en-5	Kategorio:Vikipediisto en-5
Roinn-seòrsa:User en-N	Kategorio:Vikipediisto en-D
Roinn-seòrsa:User eo-1	Kategorio:Vikipediisto eo-1
Roinn-seòrsa:User eo-2	Kategorio:Vikipediisto eo-2
Roinn-seòrsa:User eo-3	Kategorio:Vikipediisto eo-3
Roinn-seòrsa:User es	Kategorio:Vikipediisto es
Roinn-seòrsa:User es-1	Kategorio:Vikipediisto es-1
Roinn-seòrsa:User es-2	Kategorio:Vikipediisto es-2
Roinn-seòrsa:User es-3	Kategorio:Vikipediisto es-3
Roinn-seòrsa:User es-N	Kategorio:Vikipediisto es-D
Roinn-seòrsa:User fa	Kategorio:Vikipediisto fa
Roinn-seòrsa:User fa-1	Kategorio:Vikipediisto fa-1
Roinn-seòrsa:User fi	Kategorio:Vikipediisto fi
Roinn-seòrsa:User fi-N	Kategorio:Vikipediisto fi-D
Roinn-seòrsa:User he	Kategorio:Vikipediisto he
Roinn-seòrsa:User he-2	Kategorio:Vikipediisto he-2
Teamplaid:N/a	Ŝablono:N/a
Roinn-seòrsa:User hr-1	Kategorio:Vikipediisto hr-1
Roinn-seòrsa:User hu	Kategorio:Vikipediisto hu
Roinn-seòrsa:User hu-1	Kategorio:Vikipediisto hu-1
Roinn-seòrsa:User id-3	Kategorio:Vikipediisto id-3
Roinn-seòrsa:User io	Kategorio:Vikipediisto io
Roinn-seòrsa:User is	Kategorio:Vikipediisto is
Roinn-seòrsa:User is-1	Kategorio:Vikipediisto is-1
Teamplaid:User la-3	Ŝablono:Vikipediisto la-3
Roinn-seòrsa:Aibidil Eabhra	Kategorio:Hebrea alfabeto
Easbaigeachas	Anglikanismo
Roinn-seòrsa:User pl-N	Kategorio:Vikipediisto pl-D
Roinn-seòrsa:User pt-1	Kategorio:Vikipediisto pt-1
Roinn-seòrsa:Sgrìobhadairean Portagaileach	Kategorio:Portugalaj verkistoj
Roinn-seòrsa:Geoimeatras	Kategorio:Geometrio
Roinn-seòrsa:Na h-Eileanan Canàrach	Kategorio:Kanarioj
Roinn-seòrsa:User it	Kategorio:Vikipediisto it
Roinn-seòrsa:User it-1	Kategorio:Vikipediisto it-1
Roinn-seòrsa:User ja-1	Kategorio:Vikipediisto ja-1
Roinn-seòrsa:User la-1	Kategorio:Vikipediisto la-1
Roinn-seòrsa:User la-3	Kategorio:Vikipediisto la-3
Leòdhas	Lewis
Teamplaid:Information	Ŝablono:Informo por dosiero
Roinn-seòrsa:14mh linn RC	Kategorio:14-a jarcento a.K.
Breac-òtraich	Herpeto
Roinn-seòrsa:User ru-1	Kategorio:Vikipediisto ru-1
Teamplaid:Expand list	Ŝablono:Malkompleta listo
Teamplaid:Tdeprecated	Ŝablono:Evitinda
Mial	Laŭso
Teamplaid:User sv-1	Ŝablono:Vikipediisto sv-1
Teamplaid:Babel field 2	Ŝablono:Babel kadro 2
Roinn-seòrsa:Strìopachas	Kategorio:Prostituado
Roinn-seòrsa:Caistealan	Kategorio:Burgoj
Roinn-seòrsa:Sasainn	Kategorio:Anglio
Teamplaid:Babel field 5	Ŝablono:Babel kadro 5
Roinn-seòrsa:User nds	Kategorio:Vikipediisto nds
Roinn-seòrsa:User nds-1	Kategorio:Vikipediisto nds-1
Teamplaid:Coord/dms2dec	Ŝablono:Koord/gmsaldek
Roinn-seòrsa:Sgrìobhadairean Sasannach	Kategorio:Anglaj verkistoj
Teamplaid:Yes2	Ŝablono:Jes2
Roinn-seòrsa:Sgrìobhadairean Pearùthach	Kategorio:Peruaj verkistoj
Roinn-seòrsa:Uisge	Kategorio:Akvo
Roinn-seòrsa:Oklahoma	Kategorio:Oklahomo
Roinn-seòrsa:A' Bhealaruis	Kategorio:Belorusio
Roinn-seòrsa:Alba Nuadh	Kategorio:Nov-Skotio
Roinn-seòrsa:Massachusetts	Kategorio:Masaĉuseco
Teamplaid:Mòr-roinnean ann an Canada	Ŝablono:Provincoj de Kanado
Teamplaid:!)	Ŝablono:!)
Teamplaid:(!	Ŝablono:(!
Roinn-seòrsa:1910an	Kategorio:1910-1919
Roinn-seòrsa:1920an	Kategorio:1920-1929
Roinn-seòrsa:1950an	Kategorio:1950-1959
Roinn-seòrsa:1990an	Kategorio:1990-1999
Roinn-seòrsa:2000an	Kategorio:2000-aj jaroj
Roinn-seòrsa:2010an	Kategorio:2010-aj jaroj
Roinn-seòrsa:2020an	Kategorio:2020-aj jaroj
Teamplaid:User ru-2	Ŝablono:Vikipediisto ru-2
Teamplaid:User es-3	Ŝablono:Vikipediisto es-3
Roinn-seòrsa:User pt-2	Kategorio:Vikipediisto pt-2
Roinn-seòrsa:User pt-N	Kategorio:Vikipediisto pt-D
Roinn-seòrsa:User ro-2	Kategorio:Vikipediisto ro-2
Roinn-seòrsa:User ru	Kategorio:Vikipediisto ru
Roinn-seòrsa:User ru-2	Kategorio:Vikipediisto ru-2
Roinn-seòrsa:User ru-3	Kategorio:Vikipediisto ru-3
Roinn-seòrsa:User ru-4	Kategorio:Vikipediisto ru-4
Roinn-seòrsa:User sk-1	Kategorio:Vikipediisto sk-1
Roinn-seòrsa:User sr	Kategorio:Vikipediisto sr
Roinn-seòrsa:User sr-1	Kategorio:Vikipediisto sr-1
Roinn-seòrsa:User sv-1	Kategorio:Vikipediisto sv-1
Roinn-seòrsa:User sv-3	Kategorio:Vikipediisto sv-3
Roinn-seòrsa:User sv-N	Kategorio:Vikipediisto sv-D
Roinn-seòrsa:User tr	Kategorio:Vikipediisto tr
Roinn-seòrsa:User tr-N	Kategorio:Vikipediisto tr-D
Roinn-seòrsa:User uk-1	Kategorio:Vikipediisto uk-1
Roinn-seòrsa:User uk-2	Kategorio:Vikipediisto uk-2
Roinn-seòrsa:User uk-3	Kategorio:Vikipediisto uk-3
Roinn-seòrsa:User uk-4	Kategorio:Vikipediisto uk-4
Roinn-seòrsa:User uk-5	Kategorio:Vikipediisto uk-5
Roinn-seòrsa:User vi	Kategorio:Vikipediisto vi
Roinn-seòrsa:User vi-N	Kategorio:Vikipediisto vi-D
Roinn-seòrsa:1692	Kategorio:1692
Roinn-seòrsa:Eilean Mhanainn	Kategorio:Manksinsulo
Roinn-seòrsa:Luchd-ciùil	Kategorio:Muzikistoj
Teamplaid:Lang	Ŝablono:Lang
Universidade Federal do Recôncavo da Bahia	Universidade Federal do Recôncavo da Bahia
Roinn-seòrsa:Seòladairean Sasannach	Kategorio:Anglaj maristoj
Roinn-seòrsa:Sgrìobhadairean Innis Tìleach	Kategorio:Islandaj verkistoj
Roinn-seòrsa:Sgrìobhadairean Sìneach	Kategorio:Ĉinaj verkistoj
Teamplaid:User ro-1	Ŝablono:Vikipediisto ro-1
Roinn-seòrsa:Craobhan	Kategorio:Arboj
Roinn-seòrsa:3mh Linn	Kategorio:3-a jarcento
Roinn-seòrsa:11mh linn	Kategorio:11-a jarcento
Roinn-seòrsa:17mh linn	Kategorio:17-a jarcento
Roinn-seòrsa:10mh Linn	Kategorio:10-a jarcento
Roinn-seòrsa:1400an	Kategorio:1400-1409
Roinn-seòrsa:7mh Linn	Kategorio:7-a jarcento
Roinn-seòrsa:Fiamh daonna	Kategorio:Homoj
Roinn-seòrsa:Sgrìobhadairean Nirribheach	Kategorio:Norvegaj verkistoj
Teamplaid:Birth date	Ŝablono:Naskiĝdato
Roinn-seòrsa:Régions na Frainge	Kategorio:Regionoj de Francio
Teamplaid:User sv-3	Ŝablono:Vikipediisto sv-3
Roinn-seòrsa:LCDT-dualchas	Kategorio:GLAT-kulturo
Roinn-seòrsa:Florida	Kategorio:Florido
Roinn-seòrsa:Glaschu	Kategorio:Glasgovo
Roinn-seòrsa:Nevada	Kategorio:Nevado
Roinn-seòrsa:Nebraska	Kategorio:Nebrasko
Roinn-seòrsa:Dakota a Tuath	Kategorio:Norda Dakoto
Roinn-seòrsa:Meagsago Nuadh	Kategorio:Nov-Meksiko
Roinn-seòrsa:Eabhraig Nuadh (stàit)	Kategorio:Nov-Jorkio
Roinn-seòrsa:Jersey Nuadh	Kategorio:Nov-Ĵerzejo
Roinn-seòrsa:Hampshire Nuadh	Kategorio:Nov-Hampŝiro
Roinn-seòrsa:Rhode Island	Kategorio:Rod-Insulo
Roinn-seòrsa:Louisiana	Kategorio:Luiziano
Roinn-seòrsa:Maryland	Kategorio:Marilando
Roinn-seòrsa:Maine	Kategorio:Majno
Roinn-seòrsa:Minnesota	Kategorio:Minesoto
Roinn-seòrsa:Michigan	Kategorio:Miĉigano
Roinn-seòrsa:Mississippi	Kategorio:Misisipio
Roinn-seòrsa:Missouri	Kategorio:Misurio
Roinn-seòrsa:Vermont	Kategorio:Vermonto
Roinn-seòrsa:Virginia	Kategorio:Virginio
Roinn-seòrsa:Dakota a Deas	Kategorio:Suda Dakoto
Roinn-seòrsa:Idaho	Kategorio:Idaho
Roinn-seòrsa:Iowa	Kategorio:Iovao
Roinn-seòrsa:Arkansas	Kategorio:Arkansaso
Roinn-seòrsa:Alasca	Kategorio:Alasko
Roinn-seòrsa:Arizona	Kategorio:Arizono
Roinn-seòrsa:Alabama	Kategorio:Alabamo
Roinn-seòrsa:Oregon	Kategorio:Oregono
Roinn-seòrsa:Ohio	Kategorio:Ohio
Roinn-seòrsa:Virginia an Iar	Kategorio:Okcidenta Virginio
Roinn-seòrsa:Wisconsin	Kategorio:Viskonsino
Roinn-seòrsa:Utah	Kategorio:Utaho
Roinn-seòrsa:Indiana	Kategorio:Indianio
Roinn-seòrsa:Illinois	Kategorio:Ilinojo
Roinn-seòrsa:Kansas	Kategorio:Kansaso
Roinn-seòrsa:Calafòrnia	Kategorio:Kalifornio
Roinn-seòrsa:Kentucky	Kategorio:Kentukio
Roinn-seòrsa:Connecticut	Kategorio:Konektikuto
Roinn-seòrsa:Colorado	Kategorio:Koloradio
Roinn-seòrsa:Texas	Kategorio:Teksaso
Roinn-seòrsa:Pennsylvania	Kategorio:Pensilvanio
Roinn-seòrsa:Hawaii	Kategorio:Havajo
Roinn-seòrsa:An Dàrna Cogadh	Kategorio:Dua mondmilito
Roinn-seòrsa:An Cogadh Mòr	Kategorio:Unua mondmilito
Roinn-seòrsa:Sgrìobhadairean Beilgeach	Kategorio:Belgaj verkistoj
Roinn-seòrsa:Sgrìobhadairean Sileach	Kategorio:Ĉiliaj verkistoj
Roinn-seòrsa:Sgrìobhadairean Gearmailteach	Kategorio:Germanaj verkistoj
Roinn-seòrsa:Sgrìobhadairean Danmhairgeach	Kategorio:Danaj verkistoj
Roinn-seòrsa:Sgrìobhadairean Ostaireach	Kategorio:Aŭstraj verkistoj
Roinn-seòrsa:Sgrìobhadairean Frangach	Kategorio:Francaj verkistoj
Roinn-seòrsa:Sgrìobhadairean Greugach	Kategorio:Grekaj verkistoj
Roinn-seòrsa:Sgrìobhadairean Innseanach	Kategorio:Barataj verkistoj
Roinn-seòrsa:Sgrìobhadairean Èireannach	Kategorio:Irlandaj verkistoj
Roinn-seòrsa:Sgrìobhadairean Eadailteach	Kategorio:Italaj verkistoj
Roinn-seòrsa:Sgrìobhadairean Seapanach	Kategorio:Japanaj verkistoj
Roinn-seòrsa:Sgrìobhadairean Canèideanach	Kategorio:Kanadaj verkistoj
Roinn-seòrsa:Sgrìobhadairean Liotuàinianach	Kategorio:Litovaj verkistoj
Roinn-seòrsa:Sgrìobhadairean Pòlach	Kategorio:Polaj verkistoj
Roinn-seòrsa:Sgrìobhadairean Romàinianach	Kategorio:Rumanaj verkistoj
Roinn-seòrsa:Sgrìobhadairean Ruiseanach	Kategorio:Rusiaj verkistoj
Roinn-seòrsa:Sgrìobhadairean Eilbheiseach	Kategorio:Svisaj verkistoj
Roinn-seòrsa:Sgrìobhadairean Spàinnteach	Kategorio:Hispanaj verkistoj
Roinn-seòrsa:Sgrìobhadairean Seiceach	Kategorio:Ĉeĥaj verkistoj
Roinn-seòrsa:Sgrìobhadairean Aimeireaganach	Kategorio:Usonaj verkistoj
Roinn-seòrsa:Ceinia	Kategorio:Kenjo
Roinn-seòrsa:Bàsan 2011	Kategorio:Mortintoj en 2011
Roinn-seòrsa:Delaware	Kategorio:Delavaro
Roinn-seòrsa:Georgia (stàit)	Kategorio:Georgio
Roinn-seòrsa:Montana	Kategorio:Montano
Teamplaid:Merge	Ŝablono:Kunigu
Roinn-seòrsa:Tennessee	Kategorio:Tenesio
Roinn-seòrsa:1986	Kategorio:1986
Roinn-seòrsa:Poileataigs na h-Alba	Kategorio:Politiko de Skotlando
Teamplaid:Infobox Language/family-color	Ŝablono:Informkesto lingvo/Koloro
Teamplaid:User cs-3	Ŝablono:Vikipediisto cs-3
Roinn-seòrsa:Aibhnichean	Kategorio:Riveroj
Teamplaid:User pl-2	Ŝablono:Vikipediisto pl-2
Teamplaid:User pt	Ŝablono:Vikipediisto pt
Teamplaid:User ro-2	Ŝablono:Vikipediisto ro-2
Teamplaid:User ru-1	Ŝablono:Vikipediisto ru-1
Teamplaid:User sk-1	Ŝablono:Vikipediisto sk-1
Teamplaid:User sk-2	Ŝablono:Vikipediisto sk-2
Teamplaid:User sr-1	Ŝablono:Vikipediisto sr-1
Teamplaid:User tr-1	Ŝablono:Vikipediisto tr-1
Teamplaid:User uk-1	Ŝablono:Vikipediisto uk-1
Teamplaid:User zh-1	Ŝablono:Vikipediisto zh-1
Teamplaid:User zh-2	Ŝablono:Vikipediisto zh-2
Roinn-seòrsa:Lesser Antilles	Kategorio:Malgrandaj Antiloj
Roinn-seòrsa:Siombabue	Kategorio:Zimbabvo
Roinn-seòrsa:Cruinn-eòlas na h-Alba	Kategorio:Geografio de Skotlando
Roinn-seòrsa:1 mìle-bliadhna RC	Kategorio:1-a jarmilo a.K.
Roinn-seòrsa:User nl	Kategorio:Vikipediisto nl
Roinn-seòrsa:User no-2	Kategorio:Vikipediisto no-2
Roinn-seòrsa:User no	Kategorio:Vikipediisto no
Roinn-seòrsa:User zh-1	Kategorio:Vikipediisto zh-1
Roinn-seòrsa:User zh-2	Kategorio:Vikipediisto zh-2
Roinn-seòrsa:Nollaig	Kategorio:Kristnasko
Roinn-seòrsa:1 Linn	Kategorio:1-a jarcento
Roinn-seòrsa:13mh linn	Kategorio:13-a jarcento
Roinn-seòrsa:16mh linn	Kategorio:16-a jarcento
Roinn-seòrsa:12mh linn	Kategorio:12-a jarcento
Roinn-seòrsa:2na Linn	Kategorio:2-a jarcento
Roinn-seòrsa:22mh linn	Kategorio:22-a jarcento
Roinn-seòrsa:4mh Linn	Kategorio:4-a jarcento
Roinn-seòrsa:5mh Linn	Kategorio:5-a jarcento
Roinn-seòrsa:18mh linn	Kategorio:18-a jarcento
Roinn-seòrsa:6mh Linn	Kategorio:6-a jarcento
Roinn-seòrsa:8mh Linn	Kategorio:8-a jarcento
Roinn-seòrsa:2 mìle-bliadhna	Kategorio:2-a jarmilo
Roinn-seòrsa:1 mìle-bliadhna	Kategorio:1-a jarmilo
Roinn-seòrsa:4mh linn RC	Kategorio:4-a jarcento a.K.
Roinn-seòrsa:Sgrìobhadairean Turcach	Kategorio:Turklingvaj verkistoj
Roinn-seòrsa:Sgrìobhadairean Nigerianach	Kategorio:Niĝeriaj verkistoj
Roinn-seòrsa:Sgrìobhadairean Meagsagach	Kategorio:Meksikaj verkistoj
Roinn-seòrsa:Sgrìobhadairean Astràilianach	Kategorio:Aŭstraliaj verkistoj
Roinn-seòrsa:Sgrìobhadairean Èipheiteach	Kategorio:Egiptaj verkistoj
Roinn-seòrsa:Feallsanaiche Greugach	Kategorio:Grekaj filozofoj
Roinn-seòrsa:Sgrìobhadairean Albannach	Kategorio:Skotaj verkistoj
Roinn-seòrsa:Cànain Innd-Eòrpach	Kategorio:Hindeŭropa lingvaro
Roinn-seòrsa:Luchd-ciùil Albannach	Kategorio:Skotaj kantistoj
Roinn-seòrsa:Gnàthan-charachtair	Kategorio:Tipaj roluloj
Roinn-seòrsa:Duais Nobel	Kategorio:Nobel-premio
Roinn-seòrsa:5mh linn RC	Kategorio:5-a jarcento a.K.
Roinn-seòrsa:6mh Linn RC	Kategorio:6-a jarcento a.K.
Roinn-seòrsa:7mh Linn RC	Kategorio:7-a jarcento a.K.
Roinn-seòrsa:10mh linn RC	Kategorio:10-a jarcento a.K.
Roinn-seòrsa:12mh linn RC	Kategorio:12-a jarcento a.K.
Roinn-seòrsa:13mh linn RC	Kategorio:13-a jarcento a.K.
Roinn-seòrsa:15mh linn	Kategorio:15-a jarcento
Roinn-seòrsa:15mh linn RC	Kategorio:15-a jarcento a.K.
Roinn-seòrsa:A' Chairtbheil	Kategorio:Kartvelio
Roinn-seòrsa:Sgrìobhadairean à Afraga a Deas	Kategorio:Sudafrikaj verkistoj
Roinn-seòrsa:Sgrìobhadairean Guatamalach	Kategorio:Gvatemalaj verkistoj
Roinn-seòrsa:Sgrìobhadairean Bulgàirianach	Kategorio:Bulgaraj verkistoj
Roinn-seòrsa:Sgrìobhadairean Coloimbiach	Kategorio:Kolombiaj verkistoj
Roinn-seòrsa:Sgrìobhadairean Suòmach	Kategorio:Finnaj verkistoj
Roinn-seòrsa:2na linn RC	Kategorio:2-a jarcento a.K.
Roinn-seòrsa:3mh linn RC	Kategorio:3-a jarcento a.K.
Roinn-seòrsa:9mh linn RC	Kategorio:9-a jarcento a.K.
Roinn-seòrsa:11mh linn RC	Kategorio:11-a jarcento a.K.
Roinn-seòrsa:16mh linn RC	Kategorio:16-a jarcento a.K.
Roinn-seòrsa:17mh linn RC	Kategorio:17-a jarcento a.K.
Roinn-seòrsa:19mh linn RC	Kategorio:19-a jarcento a.K.
Roinn-seòrsa:Sri Lanca	Kategorio:Sri-Lanko
Roinn-seòrsa:8mh linn RC	Kategorio:8-a jarcento a.K.
Roinn-seòrsa:9mh Linn	Kategorio:9-a jarcento
Roinn-seòrsa:18mh linn RC	Kategorio:18-a jarcento a.K.
Roinn-seòrsa:Aonadh Sobhiat	Kategorio:Sovetunio
Roinn-seòrsa:An Iùgoslabh	Kategorio:Jugoslavio
Roinn-seòrsa:Template namespace templates	Kategorio:Ŝablono:Helpa ŝablono
Roinn-seòrsa:1mh linn RC	Kategorio:1-a jarcento a.K.
Roinn-seòrsa:Sgrìobhadairean Palastainiach	Kategorio:Palestinaj verkistoj
Teamplaid:User de-4	Ŝablono:Vikipediisto de-4
Roinn-seòrsa:A' Chuimrigh	Kategorio:Kimrio
Roinn-seòrsa:Cinn-suidhe nan Stàitean Aonaichte	Kategorio:Prezidantoj de Usono
Roinn-seòrsa:Trianaid agus Tobago	Kategorio:Trinidado kaj Tobago
Roinn-seòrsa:Suranam	Kategorio:Surinamo
Roinn-seòrsa:Nirribhidh	Kategorio:Norvegio
Roinn-seòrsa:Panama	Kategorio:Panamo
Roinn-seòrsa:Paraguaidh	Kategorio:Paragvajo
Roinn-seòrsa:Fìdi	Kategorio:Fiĝioj
Roinn-seòrsa:Liechtenstein	Kategorio:Liĥtenŝtejno
Roinn-seòrsa:Uruguaidh	Kategorio:Urugvajo
Roinn-seòrsa:Andorra	Kategorio:Andoro
Roinn-seòrsa:Pearù	Kategorio:Peruo
Roinn-seòrsa:Boilibhia	Kategorio:Bolivio
Roinn-seòrsa:Albàinia	Kategorio:Albanio
Roinn-seòrsa:Iasg	Kategorio:Fiŝoj
Roinn-seòrsa:Miotas-eòlas	Kategorio:Mitologio
Roinn-seòrsa:Seann Tiomnadh	Kategorio:Malnova Testamento
Roinn-seòrsa:3mh mìle-bliadhna RC	Kategorio:3-a jarmilo a.K.
Roinn-seòrsa:Beathaichean	Kategorio:Bestoj
Teamplaid:Coimhearsnachdan Fhèin-riaghlach na Spàinne	Ŝablono:Regionoj de Hispanio
Roinn-seòrsa:Na h-Eileanan Balèarach	Kategorio:Balearoj
Roinn-seòrsa:Tonga	Kategorio:Tongo
Roinn-seòrsa:Coloimbia	Kategorio:Kolombio
Roinn-seòrsa:Àirneis	Kategorio:Mebloj
Roinn-seòrsa:Aimearaga Mheadhanach	Kategorio:Mezameriko
Roinn-seòrsa:Aodach	Kategorio:Vestoj
Roinn-seòrsa:Prìomh-bhailtean	Kategorio:Ĉefurboj
Roinn-seòrsa:Afraga-an-Ear	Kategorio:Orientafriko
Roinn-seòrsa:Meatailt	Kategorio:Metaloj
Roinn-seòrsa:User pl	Kategorio:Vikipediisto pl
Roinn-seòrsa:3mh mìle-bliadhna	Kategorio:3-a jarmilo
Roinn-seòrsa:A' Chòrn	Kategorio:Kornvalo
Roinn-seòrsa:Co-mhaoineas	Kategorio:Komunismo
Roinn-seòrsa:Antargtaca	Kategorio:Antarkto
Roinn-seòrsa:Aimearaga a Tuath	Kategorio:Nordameriko
Roinn-seòrsa:Seinneadairean	Kategorio:Kantistoj
Teamplaid:Cànan	Ŝablono:Informkesto lingvo
Roinn-seòrsa:Guatamala	Kategorio:Gvatemalo
Roinn-seòrsa:Caistealan na h-Alba	Kategorio:Kasteloj en Skotlando
Roinn-seòrsa:Filmean co-cheangailte ri LCDT	Kategorio:GLAT-filmoj
Roinn-seòrsa:Macau	Kategorio:Makao
Teamplaid:User ga-1	Ŝablono:Vikipediisto ga-1
Teamplaid:User af-2	Ŝablono:Vikipediisto af-2
Roinn-seòrsa:Prìomh-bhailtean ann an Afraga	Kategorio:Ĉefurboj de Afriko
Roinn-seòrsa:Alba	Kategorio:Skotlando
Roinn-seòrsa:Prìomh-Bhailtean na Roinn Eorpa	Kategorio:Ĉefurboj de Eŭropo
Roinn-seòrsa:Prìomh-bhailtean ann an Àisia	Kategorio:Ĉefurboj de Azio
Roinn-seòrsa:Èirinn a Tuath	Kategorio:Nord-Irlando
Adhair	Aero
Teamplaid:CompactTOC	Ŝablono:Indekso
Roinn-seòrsa:Tolkien	Kategorio:J. R. R. Tolkien
Biadh meadhan-latha	Tagmanĝo
Teamplaid:Columns-list	Ŝablono:Kolumnoj-listo
Teamplaid:Coord/input/dm	Ŝablono:Koord/enigu/gm
Teamplaid:Flag	Ŝablono:Flago
Sìona	Ĉinio (apartigilo)
Roinn-seòrsa:Provincias na Spàinne	Kategorio:Provincoj de Hispanio
Roinn-seòrsa:Sgrìobhadairean Iùdhach	Kategorio:Judaj verkistoj
Teamplaid:Str right	Ŝablono:Lin dekst
Roinn-seòrsa:LCDT-litreachas	Kategorio:GLAT-literaturo
Trojany	Trojany
Roinn-seòrsa:Na Balcain	Kategorio:Balkana duoninsulo
Teamplaid:User cy-1	Ŝablono:Vikipediisto cy-1
Roinn-seòrsa:2 mìle-bliadhna RC	Kategorio:2-a jarmilo a.K.
Roinn-seòrsa:Ailseabra	Kategorio:Algebro
Roinn-seòrsa:Àireamhachd	Kategorio:Aritmetiko
Roinn-seòrsa:Prìomh-bhailtean anns a' Chairibìan	Kategorio:Ĉefurboj de Karibio
Roinn-seòrsa:Eileanan a' Chaolais	Kategorio:Manikinsuloj
Briathar	Terminologio
Roinn-seòrsa:Dùn Èideann	Kategorio:Edinburgo
Roinn-seòrsa:Boireann-dhligheachas	Kategorio:Feminismo
Roimhear	Prepozicio
Roinn-seòrsa:Aibidil Ghreugach	Kategorio:Greka alfabeto
Roinn-seòrsa:Èirinn	Kategorio:Irlando
Roinn-seòrsa:Eòlas-ur-sgeulachd na h-Eirinn	Kategorio:Irlanda mitologio
Roinn-seòrsa:Ivy League	Kategorio:Ivy League
Roinn-seòrsa:LCDT-eachdraidh	Kategorio:GLAT-historio
Roinn-seòrsa:Lochan na h-Alba	Kategorio:Lagoj de Skotlando
Roinn-seòrsa:Sgrìobhadairean Laidinneach	Kategorio:Latinlingvaj verkistoj
Roinn-seòrsa:An Ròimh	Kategorio:Romo
Roinn-seòrsa:Naomh Lùisia	Kategorio:Sankta Lucio
Roinn-seòrsa:Cànain Slàbhach	Kategorio:Slava lingvaro
Roinn-seòrsa:Shoria	Kategorio:Sorio
Roinn-seòrsa:Na Beatles	Kategorio:The Beatles
Roinn-seòrsa:TOC templates	Kategorio:Ŝablono:Indekso
Roinn-seòrsa:Cànanan Ceilteach	Kategorio:Kelta lingvaro
Roinn-seòrsa:Sir Fynwy	Kategorio:Monmouthshire
Aodach-brèige	Kostumo
Teamplaid:Contae na h-Èireann	Ŝablono:Informkesto Irlanda graflando
Roinn-seòrsa:User en-1	Kategorio:Vikipediisto en-1
Roinn-seòrsa:User de-1	Kategorio:Vikipediisto de-1
Roinn-seòrsa:Eachdraidh na h-Alba	Kategorio:Historio de Skotlando
Roinn-seòrsa:Départements na Frainge	Kategorio:Departementoj de Francio
Roinn-seòrsa:Protected templates	Kategorio:Protektitaj ŝablonoj
Roinn-seòrsa:User da-N	Kategorio:Vikipediisto da-D
1 Eachdraidh	1-a libro de la Kroniko
Roinn-seòrsa:Sgrìobhadairean Iùgoslabhach	Kategorio:Jugoslavaj verkistoj
Gartan	Iksodo
Teamplaid:Eòlas-bòdhaig	Ŝablono:Homa anatomio
Prìomh Mhinistear na Rìoghachd Aonaichte	Britaj ĉefministroj
Uicipeid:WikiProject Check Wikipedia/Translation	Projekto:Kontrolu Vikipedion/Tradukado
Teamplaid:User WMfr	Ŝablono:Vikipediisto WMfr
Teamplaid:Userbox-level	Ŝablono:Userbox-level
Teamplaid:User ru-3	Ŝablono:Vikipediisto ru-3
Teamplaid:User nl-3	Ŝablono:Vikipediisto nl-3
Teamplaid:User nn	Ŝablono:Vikipediisto nn
Teamplaid:User dsb-1	Ŝablono:Vikipediisto dsb-1
Geoimeatras raoin	Ebena geometrio
Teamplaid:Tls	Ŝablono:Tls
Dealan-dè	Rhopalocera
Buachaille	Paŝtisto
Uicipeid:Deletion log	Vikipedio:Loglibro de forigoj
Teamplaid:Tlp	Ŝablono:Tlp
Niţchidorf	Nițchidorf
Teamplaid:Yes	Ŝablono:Jes
Teamplaid:Infobox Weather/colt	Ŝablono:Veterkesto/Kolt
Teamplaid:Style/IPA	Ŝablono:Style/IPA
Teamplaid:Style/yid	Ŝablono:Style/yid
Teamplaid:Tld	Ŝablono:Tld
Cànanaiche	Lingvisto
Module:Yesno	Modulo:Yesno
Sònraichte:RecentChanges	Specialaĵo:Lastaj ŝanĝoj
Module:TableTools	Modulo:TableTools
Roinn-seòrsa:User ja-4	Kategorio:Vikipediisto ja-4
Module:Coordinates	Modulo:Coordinates
Module:Math	Modulo:Math
Àireamhan àicheil is neo-àicheil	Pozitivaj kaj negativaj nombroj
