Afrika	Afriko
Ġappun	Japanio
Norveġja	Norvegio
Ingilterra	Anglio
Skozja	Skotlando
Irlanda ta' Fuq	Nord-Irlando
Repubblika tal-Irlanda	Irlando
Ungerija	Hungario
Spanja	Hispanio
Stati Uniti	Usono
Belġju	Belgio
Lussemburgu	Luksemburgo (lando)
Art	Tero
Mewt	Morto
Bniedem	Homo
Tim Berners-Lee	Tim Berners-Lee
Finlandja	Finnlando
Żvezja	Svedio
Danimarka	Danio
Polonja	Pollando
Litwanja	Litovio
Italja	Italio
Żvizzera	Svislando
Awstrija	Aŭstrio
Greċja	Grekio
Turkija	Turkio
Portugall	Portugalio
Ewropa	Eŭropo
Asja	Azio
Wikipedija	Vikipedio
Pajjiżi l-Baxxi	Nederlando
Berlin	Berlino
Kompjuter	Komputilo
Barack Obama	Barack Obama
Urugwaj	Urugvajo
Londra	Londono
Messiku	Meksiko
Oċean Atlantiku	Atlantika Oceano
Oċean Paċifiku	Pacifika Oceano
Jannar	Januaro
Frar	Februaro
Marzu	Marto
Marte (pjaneta)	Marso
Kenja	Kenjo
Etjopja	Etiopio
Gana	Ganao
April	Aprilo
Mejju	Majo
Ġunju	Junio
Lulju	Julio
Awwissu	Aŭgusto
Settembru	Septembro
Ottubru	Oktobro
Novembru	Novembro
Diċembru	Decembro
Iljun	Leono
Franza	Francio
Kelb	Hundo
Renju Unit	Unuiĝinta Reĝlando
Qattus	Hejma kato
Ċina	Ĉina Popola Respubliko
Wikizzjunarju	Vikivortaro
Brażil	Brazilo
François Hollande	François Hollande
Russja	Rusio
Wiki	Vikio
Fondazzjoni Wikimedia	Fondaĵo Vikimedio
Jimmy Wales	Jimmy Wales
Ġermanja	Germanio
Bjelorussja	Belorusio
Il Canto degli italiani	Il Canto degli Italiani
Iżlanda	Islando
Estonja	Estonio
Saturnu (pjaneta)	Saturno (planedo)
Latvja	Latvio
Ukraina	Ukrainio
Ċekja	Ĉeĥio
Slovakkja	Slovakio
Slovenja	Slovenio
Vilnius	Vilno
Moldova	Moldava Respubliko
Rumanija	Rumanio
Bulgarija	Bulgario
Ruma	Romo
Repubblika tal-Maċedonja	Respubliko Makedonio
Albanija	Albanio
Kroazja	Kroatio
Bożnija u Ħerżegovina	Bosnio kaj Hercegovino
Ażerbajġan	Azerbajĝano
Andorra	Andoro
Ċipru	Kipro
Ġeorġja	Kartvelio
Każakistan	Kazaĥio
Malta	Malto
Monako	Monako
Montenegro	Montenegro
Belt tal-Vatikan	Vatikano
San Marino	San-Marino
Brussell	Bruselo
Kuba	Kubo
Beliże	Belizo
Torri Eiffel	Eiffel-Turo
Barbados	Barbado
Volkswagen	Volkswagen
Indoneżja	Indonezio
Wolfgang Amadeus Mozart	Wolfgang Amadeus Mozart
Ludwig van Beethoven	Ludwig van Beethoven
Afrika t'Isfel	Sud-Afriko
Alġerija	Alĝerio
Wikisors	Vikifontaro
Varsavja	Varsovio
Festival tal-Eurovision	Eŭrovido-Kantokonkurso
Injam	Ligno
Pornografija	Pornografio
Ċili	Ĉilio
Ġesù	Jesuo Kristo
Galileo Galilei	Galilejo
Merkurju (pjaneta)	Merkuro (planedo)
Storja	Historio
Venere (pjaneta)	Venuso (planedo)
Imħabba	Amo
Ġove (pjaneta)	Jupitero (planedo)
Triq ta' Sant'Anna	Lakta vojo
Uranu (pjaneta)	Urano (planedo)
Nettunu (pjaneta)	Neptuno (planedo)
Astronomija	Astronomio
Singapor	Singapuro
Xjenza	Scienco
Liechtenstein	Liĥtenŝtejno
Sport	Sporto
Adolf Hitler	Adolf Hitler
Facebook	Facebook
L-Ewwel Gwerra Dinjija	Unua mondmilito
It-Tieni Gwerra Dinjija	Dua mondmilito
Wikotba	Vikilibroj
Wikikwota	Vikicitaro
Wikiversità	Vikiversitato
Skopje	Skopjo
Szczecin	Szczecin
Matematika	Matematiko
Lingwa Latina	Latina lingvo
Baħrejn	Barejno
Armenja	Armenio
Serbja	Serbio
Qamar	Luno
Awstralja	Aŭstralio
Arġentina	Argentino
Perù	Peruo
Bijoloġija	Biologio
Kambodja	Kamboĝo
Faxxa ta' Kuiper	Kujper-zono
Koran	Korano
Dinosawru	Dinosaŭro
Iżlam	Islamo
Ljubljana	Ljubljano
Unjoni Ewropea	Eŭropa Unio
Plovdiv	Plovdiv
Mara	Virino
Poeżija	Poezio
Lumija	Citrono
Émile Zola	Émile Zola
Napuljun I ta' Franza	Napoleono Bonaparte
Vesuvju	Vezuvio
Xemx	Suno
Sena dawl	Lumjaro
Oċeanja	Oceanio
Sistema Solari	Sunsistemo
Idroġenu	Hidrogeno
Wikimedia Commons	Vikimedia Komunejo
Lejl	Nokto
Oslo	Oslo
Katowice	Katowice
Toqba sewda	Nigra truo
Lionel Messi	Lionel Messi
Karbonju	Karbono
Ażotu	Nitrogeno
Ossiġenu	Oksigeno
Inter Milan	Inter Milano
Pjaneta	Planedo
Kleopatra VII	Kleopatra
Mużika	Muziko
Moska	Moskvo
Lingwa Taljana	Itala lingvo
Ċad	Ĉado
New Zealand	Nov-Zelando
Indja	Barato
Tuvalu	Tuvalo
Ħadid	Fero
Tonga	Tongo
Samoa	Samoo
Gżejjer Solomon	Salomonoj
Vanwatu	Vanuatuo
Molière	Molière
Papwa Gwinea l-Ġdida	Papuo-Nov-Gvineo
William Shakespeare	William Shakespeare
Nawru	Nauro
Kiribati	Kiribato
Fiġi	Fiĝioj
Veneżwela	Venezuelo
Genghis Khan	Ĝingis-Ĥano
Żiemel	Ĉevalo
Annimal	Bestoj
Surinam	Surinamo
Paragwaj	Paragvajo
Gujana	Gujano
Arti	Arto
Ekwador	Ekvadoro
Kolombja	Kolombio
Buddiżmu	Budhismo
Bolivja	Bolivio
Trinidad u Tobago	Trinidado kaj Tobago
Saint Vincent u l-Grenadini	Sankta Vincento kaj Grenadinoj
Santa Luċija	Sankta Lucio
Leonardo da Vinci	Leonardo da Vinci
Saint Kitts u Nevis	Sankta-Kito kaj Neviso
Ġamajka	Jamajko
Grenada	Grenado (lando)
Gwatemala	Gvatemalo
Baħamas	Bahamoj
Antigwa u Barbuda	Antigvo-Barbudo
Ħonduras	Honduro
Dominika	Dominiko
Repubblika Dominikana	Domingo
Ħaiti	Haitio
El Salvador	Salvadoro
Iran	Irano
Iraq	Irako
Kosta Rika	Kostariko
Iżrael	Israelo
Panama	Panamo
Jemen	Jemeno
Lingwa pollakka	Pola lingvo
Ġordan	Jordanio
Nikaragwa	Nikaragvo
Libanu	Libano
Maldive	Maldivoj
Malażja	Malajzio
Burma	Birmo
Pakistan	Pakistano
Qatar	Kataro
Arabja Sawdija	Sauda Arabio
Sri Lanka	Sri-Lanko
Josif Stalin	Josif Stalin
YouTube	YouTube
Aristotli	Aristotelo
Emirati Għarab Magħquda	Unuiĝintaj Arabaj Emirlandoj
Vjetnam	Vjetnamio
Korea t'Isfel	Sud-Koreio
Afganistan	Afganio
Bangladexx	Bangladeŝo
Mali	Malio
Angola	Angolo
Butan	Butano
Brunej	Brunejo
Tanżanija	Tanzanio
Repubblika Ċentru-Afrikana	Centr-Afrika Respubliko
Isaac Newton	Isaac Newton
Isfar	Flava
Mekkanika kwantistika	Kvantuma mekaniko
Togo	Togolando
Tuneżija	Tunizio
Żambja	Zambio
Żimbabwe	Zimbabvo
Sudan t'Isfel	Sud-Sudano
Benin	Benino
Botswana	Bocvano
Wikiħbarijiet	Vikinovaĵoj
Burkina Faso	Burkino
Burundi	Burundo
Komoros	Komoroj
Repubblika tal-Kongo	Respubliko Kongo
Repubblika Demokratika tal-Kongo	Demokratia Respubliko Kongo
Ġibuti	Ĝibutio
Bavarja	Bavario
Ginea Ekwatorjali	Ekvatora Gvineo
Eritrea	Eritreo
Papa Ġwanni Pawlu II	Johano Paŭlo la 2-a
Gabon	Gabono
Mahatma Gandhi	Mohandas Karamchand Gandhi
Gambja	Gambio
Ginea	Gvineo
Ginea Bissaw	Gvineo Bisaŭa
Kosta tal-Avorju	Ebur-Bordo
Kamerun	Kameruno
Kap Verde	Kaboverdo
Lesoto	Lesoto
Liberja	Liberio
Libja	Libio
Madagaskar	Madagaskaro
Malawi	Malavio
Mawritanja	Maŭritanio
Mawrizju	Maŭricio
Marokk	Maroko
Możambik	Mozambiko
Namibja	Namibio
Niġer	Niĝero
Niġerja	Niĝerio
Charles Darwin	Charles Darwin
Uganda	Ugando
Rwanda	Ruando
São Tomé u Príncipe	Sao-Tomeo kaj Principeo
Senegal	Senegalo
Seychelles	Sejŝeloj
Sierra Leone	Siera-Leono
Somalja	Somalio
Sudan	Sudano
Sważiland	Svazilando
Amburgu	Hamburgo
Evoluzzjoni	Evoluismo
Ġnus Magħquda	Unuiĝintaj Nacioj
Dante Alighieri	Dante Alighieri
Ġeografija	Geografio
Qalb	Koro
Praga	Prago
Ikħal	Blua
Limburgu (Belġju)	Limburgo (Belgio)
Fjandri tal-Punent	Okcidenta Flandrio
Fjandri tal-Lvant	Orienta Flandrio
Antwerp (provinċja)	Antverpeno (provinco)
Brabant Fjamming	Flandra Brabanto
Merkurju (mitoloġija)	Merkuro (dio)
Hector Berlioz	Louis Hector Berlioz
Giorgio Napolitano	Giorgio Napolitano
Francesco Cossiga	Francesco Cossiga
Oċean Indjan	Hinda Oceano
Kosovo	Kosovo
Frédéric Chopin	Frédéric Chopin
Kategorija:Prinċipali	Kategorio:Ĉio
Dortmund	Dortmund
The Beatles	The Beatles
Osama Bin Laden	Usama bin Laden
Lingwa Spanjola	Hispana lingvo
Montevideo	Montevideo
Johann Sebastian Bach	Johann Sebastian Bach
Brimba	Araneuloj
Virġilju	Vergilio
Uetersen	Uetersen
Karozza	Aŭtomobilo
Żagreb	Zagrebo
Sqallija	Sicilio
Maurits Cornelis Escher	M. C. Escher
Buenos Aires	Bonaero
Belt tal-Messiku	Meksik-urbo
Tokjo	Tokio
Barċellona	Barcelono
Ateni	Ateno
AC Milan	A.C. Milan
Ħavana	Havano
Édith Piaf	Édith Piaf
Kopenħagen	Kopenhago
Stokkolma	Stokholmo
Ħelsinki	Helsinko
Dublin	Dublino
Rejkjavik	Rejkjaviko
Tallinn	Talino
Riga	Rigo
Bratislava	Bratislavo
Gdańsk	Gdańsk
Lussemburgu (belt)	Luksemburgo
Bibbja	Biblio
Ho Chi Minh (belt)	Ho-Ĉi-Min-urbo
Knisja Vera ta' Ġesù	Vera Eklezio de Jesuo
Dong Hoi	Dong Hoi
Concepción (Ċili)	Koncepciono
Bolonja	Bolonjo
Cagliari	Kaljaro
Kiev	Kievo
Końskowola	Końskowola
2014	2014
2015	2015
2007	2007
Serp	Serpento
1 ta' Jannar	1-a de januaro
2 ta' Jannar	2-a de januaro
Rivoluzzjoni Industrijali	Industria revolucio
Imperu Ruman	Romia Imperio
Minsk	Minsko
Microsoft	Microsoft
8 ta' Diċembru	8-a de decembro
Kurów	Kurów
Kimika	Kemio
19 ta' Marzu	19-a de marto
Papa Benedittu XVI	Benedikto la 16-a
Papa Piju XII	Pio la 12-a
Futbol	Futbalo
L-Olokawst	Holokaŭsto
Madrid	Madrido
Michael Jackson	Michael Jackson
5 ta' Settembru	5-a de septembro
4 ta' Settembru	4-a de septembro
Santiago (Ċili)	Santiago de Ĉilio
25 ta' Ottubru	15-a de oktobro
5 ta' Novembru	5-a de novembro
22 ta' Novembru	22-a de novembro
Aħdar	Verdo
Aħmar	Ruĝa
Lourdes	Lourdes
Rabat (Marokk)	Rabato
Kometa	Kometo
Belgrad	Beogrado
Kategorija:Mudelli	Kategorio:Vikipedio:Ŝablonoj
George Sand	George Sand
Nikosija	Nikozio
Asterojde	Asteroido
Manama	Manamo
Eklissi solari	Suna eklipso
Wikipedija:Paġna tal-provi	Vikipedio:Provejo
Nettunu (mitoloġija)	Neptuno (dio)
Alġebra	Algebro
Ajruport Dong Hoi	Flughaveno Dong Hoi
Miley Cyrus	Miley Cyrus
Curitiba	Kuritibo
Pangea	Pangeo
Kategorija:1888	Kategorio:1888
Konfuċju	Konfuceo
Corbin Bleu	Corbin Bleu
Kategorija:Matematika	Kategorio:Matematiko
Gżejjer Faroe	Ferooj
Ġove (mitoloġija)	Jupitero (dio)
Sherlock Holmes	Sherlock Holmes
Rinaxximent	Renesanco
Kategorija:Twieldu fl-1888	Kategorio:Naskiĝintoj en 1888
Ewro	Eŭro
Baħar Mediterran	Mediteraneo
Kristjaneżmu	Kristanismo
Mudell:Favur	Ŝablono:Por
Għasfur	Birdoj
Belt kapitali	Ĉefurbo
Monzón	Monzono
Mustafa Kemal Atatürk	Mustafa Kemal Atatürk
Mudell:Portal	Ŝablono:Portalo
Huang Xianfan	Huang Senfan
Bill Gates	Bill Gates
Enċiklopedija	Enciklopedio
Il-Paġna prinċipali	Vikipedio:Ĉefpaĝo
Baskitbol	Korbopilkado
Francisco Goya	Francisco de Goya
Albrecht Dürer	Albrecht Dürer
Frida Kahlo	Frida Kahlo
Mikelanġlu	Mikelanĝelo
Miguel de Cervantes	Miguel de Cervantes
Charles Dickens	Charles Dickens
Mekka	Mekko
Che Guevara	Che Guevara
Mao Zedong	Mao Zedong
Johann Wolfgang von Goethe	Johann Wolfgang von Goethe
Filosofija	Filozofio
Jimi Hendrix	Jimi Hendrix
Kategorija:Proposti għat-tħassir minnufih	Kategorio:Tujforigendaj artikoloj
Hebe Camargo	Hebe Camargo
Komuniżmu	Komunismo
Saħara tal-Punent	Okcidenta Saharo
Pajjiż	Lando
Kartaġni	Kartago
Kategorija:Astronomija	Kategorio:Astronomio
Søren Kierkegaard	Søren Kierkegaard
Bolzano	Bolzano-Bozen
Rivoluzzjoni Franċiża	Franca revolucio de 1789
Saħara	Saharo
Strażburgu	Strasburgo
Lingwa Kroata	Kroata lingvo
UTC+1	UTC+01:00
Omeru	Homero
UTC+2	UTC+02:00
UTC+3	UTC+03:00
Lena Meyer-Landrut	Lena Meyer-Landrut
Seklu XVII	17-a jarcento
Ateiżmu	Ateismo
Ekoloġija	Ekologio
FC Barcelona	Futbala Klubo de Barcelono
Marie Curie	Marie Curie
Premju Nobel	Nobel-premio
Alan Turing	Alan Turing
Ideoloġija	Ideologio
Ada Lovelace	Ada Lovelace
Franz Schubert	Franz Schubert
Igor' Stravinskij	Igor Stravinski
Pëtr Il'ič Čajkovskij	Pjotr Iljiĉ Ĉajkovskij
Giuseppe Verdi	Giuseppe Verdi
Kristofru Kolombu	Kristoforo Kolumbo
Nagħġa	Ŝafo
Mammiferu	Mamuloj
Naħla	Abelo
Speċi	Specio
Tifel	Infano
Napuljun III	Napoleono la 3-a
Vladimir Putin	Vladimir Putin
Analisi matematika	Analitiko
Commonwealth tan-Nazzjonijiet	Komunumo de Nacioj
Organizzazzjoni Dinjija tas-Saħħa	Monda Organizaĵo pri Sano
Demm	Sango
Pulmun	Pulmo
Casablanca	Kazablanko
Xjenza Naturali	Naturscienco
Santu Wistin	Aŭgusteno de Hipono
Nelson Mandela	Nelson Mandela
Martin Luther King Jr.	Martin Luther King
Ġeometrija	Geometrio
Atmosfera	Atmosfero (astro)
Kategorija:Bulgarija	Kategorio:Bulgario
Kategorija:Franza	Kategorio:Francio
Kategorija:Mużika	Kategorio:Muziko
Elf Lejla u Lejla	Mil kaj unu noktoj
Kategorija:Letteratura	Kategorio:Literaturo
Ilijade	Iliado
Alessandru Manju	Aleksandro la Granda
Edukazzjoni	Eduko
Hugo Chávez	Hugo Chávez
Raġel	Viro
Otto von Bismarck	Otto von Bismarck
Abort	Aborto
Skjavitù	Sklaveco
Logħob Olimpiku tas-sajf 2008	Somera Olimpiko 2008
Logħob Olimpiku tas-sajf 2016	Somera Olimpiko 2016
Gwerra Ċivili Amerikana	Usona Enlanda Milito
Imperu Brittaniku	Brita imperio
Real Madrid CF	Real Madrid
Sivilja	Sevilo
Rivoluzzjoni Russa	Rusia revolucio de 1917
Arkimede	Arkimedo
Thomas Edison	Thomas Alva Edison
Ewklide	Eŭklido
Bit	Bito
Parlament Ewropew	Eŭropa Parlamento
Kostellazzjoni	Konstelacio
Karl Marx	Karl Marx
Voltaire	Voltaire
Ħinduiżmu	Hinduismo
Erwin Schrödinger	Erwin Schrödinger
Lingwa Maltija	Malta lingvo
Reliġjon	Religio
René Descartes	René Descartes
Pawlu minn Tarsu	Paŭlo de Tarso
Immanuel Kant	Immanuel Kant
Guy de Maupassant	Guy de Maupassant
Friedrich Nietzsche	Friedrich Wilhelm Nietzsche
Fwied	Hepato
Kilwa	Reno
Fenek	Kuniklo
Psikoloġija	Psikologio
Gautama Buddha	Sidarto Gotamo
Premier League	F.A. Supra Ligo
Muħammed	Mohamedo
Probabbiltà	Probablo
Martin Luteru	Marteno Lutero
Xigħa	Ŝijaismo
Knisja Kattolika	Katolika Eklezio
Chelsea FC	Chelsea F.C.
Arsenal FC	Arsenal F.C.
Sistema diġestiva	Digesta sistemo
Logħob Olimpiku tax-xitwa 2010	Vintra Olimpiko 2010
Reġina Eliżabetta II	Elizabeto la 2-a (Britio)
Alfabett	Alfabeto
Ronald Reagan	Ronald Reagan
Festival tal-Eurovision 2005	Eŭrovido-Kantokonkurso 2005
Festival tal-Eurovision 2006	Eŭrovido-Kantokonkurso 2006
Festival tal-Eurovision 2007	Eŭrovido-Kantokonkurso 2007
Festival tal-Eurovision 2008	Eŭrovido-Kantokonkurso 2008
Festival tal-Eurovision 2009	Eŭrovido-Kantokonkurso 2009
Festival tal-Eurovision 2010	Eŭrovido-Kantokonkurso 2010
Festival tal-Eurovision 2011	Eŭrovido-Kantokonkurso 2011
Festival tal-Eurovision 2012	Eŭrovido-Kantokonkurso 2012
Festival tal-Eurovision 2013	Eŭrovido-Kantokonkurso 2013
Main-Spessart	Distrikto Main-Spessart
Catherine Middleton	Kate Middleton
David Beckham	David Beckham
Frankonja t'Isfel	Malsupra Frankonio
Kim Jong-il	Kim Ĝong-il
Kategorija:Veneżwela	Kategorio:Venezuelo
Belfast	Belfasto
Tavla perjodika	Perioda tabelo
Tórshavn	Tórshavn
Attakki tal-11 ta' Settembru	Atencoj de la 11-a de septembro 2001
Chordata	Ĥorduloj
Kultura	Kulturo
Trattat ta' Maastricht	Traktato de Mastriĥto
Mediċina	Medicino
Sarajevo	Sarajevo
Ekwazzjoni differenzjali	Diferenciala ekvacio
Kategorija:Brażil	Kategorio:Brazilo
Kategorija:Rumanija	Kategorio:Rumanio
Element kimiku	Kemia elemento
Funzjonijiet (matematika)	Funkcio (matematiko)
Kimika organika	Organika kemio
Mekkanika klassika	Klasika mekaniko
Klassifikazzjoni bijoloġika	Biologia klasado
Arti marzjali	Luktoarto
Rota	Biciklo
Relatività ristretta	Speciala teorio de relativeco
Ħġieġ	Vitro
Karta	Papero
Kilogramm	Kilogramo
Cristiano Ronaldo	Cristiano Ronaldo
Metru	Metro
Pittura	Pentrado
Skultura	Skulptarto
Żfin	Danco
Pajjiżi tad-dinja	Listo de sendependaj ŝtatoj
Preistorja	Prahistorio
Silvio Berlusconi	Silvio Berlusconi
4′33″	4′33″
Kolera	Ĥolero
Skerma	Skermo
Sfera ċelesti	Ĉielosfero
Malarja	Malario
AIDS	Aidoso
Tuberkulożi	Tuberkulozo
Mona Lisa	La Gioconda
Teorija tan-numri	Nombroteorio
Kileb	Konzolo
Biżantini	Bizanca imperio
Kruċjata	Krucmilitoj
Imperu Ottoman	Otomana Imperio
Malgrat de Mar	Malgrat de Mar
Lampuna	Frambo
Kurgan (belt)	Kurgano (urbo)
Trapani	Trapani
Wikispeċi	Vikispecioj
Lingwa Għarbija	Araba lingvo
Jum ir-Ringrazzjament	Dankotago
Lingwa Oċċitanija	Okcitana lingvo
Lingwa tas-Sinjali Amerikana	Usona signolingvo
Kategorija:Provinċji tal-Italja	Regionoj kaj provincoj de Italio
Alkoħoliżmu	Alkoholismo
FC Bayern Munich	FC Bayern München
Queen	Queen
Provinċja ta' Agrigento	Provinco de Agrigento
Provinċja ta' Bergamo	Provinco Bergamo
Provinċja ta' Kaltanissetta	Provinco de Kaltaniseto
Provinċja ta' Lodi	Provinco de Lodi
Wikipedija:Vetrina	Vikipedio:Elstaraj artikoloj
Mudell:Link FA	Ŝablono:LigoElstara
Dinja	Mondo
Wikipedija:Pjazza	Vikipedio:Diskutejo
Takson	Taksono
Papa Pawlu VI	Paŭlo la 6-a
Etna	Etna
Clube de Regatas do Flamengo	Clube de Regatas do Flamengo
Gerard Piqué	Gerard Piqué
San Lawrenz	Laŭrenco de Romo
Martin Schulz	Martin Schulz
Mudell Standard	Norma modelo
Mafja	Mafio
Manchester United FC	Manchester United
Aston Villa FC	Aston Villa
West Ham United FC	West Ham United
UEFA Champions League	Ligo de Ĉampionoj de UEFA
UEFA Europa League	Eŭropa Ligo de UEFA
Tazza tad-Dinja tal-Futbol	Futbala Mondpokalo
Rafael Correa	Rafael Correa
FC Twente	FC Twente
Motorhead	Motörhead
Milied	Kristnasko
Lingwi Romaniċi	Latinida lingvaro
Steve Jobs	Steve Jobs
Lady Gaga	Lady Gaga
Indoewropew	Hindeŭropa lingvaro
Muammar al-Gaddafi	Muamar Kadafi
Francesco Totti	Francesco Totti
Chișinău	Kiŝinevo
Soċjoloġija	Sociologio
Şalom	Şalom
Didelphidae	Didelfedoj
Trojja	Trojo
The Pirate Bay	The Pirate Bay
Kampjonati Ewropej tal-Futbol 2012	Eŭropa Futbal-Ĉampionado 2012
Audi	Audi
Abkażja	Abĥazio
Antropoloġija	Antropologio
Baħar l-Aħmar	Ruĝa Maro
Octave Mirbeau	Octave Mirbeau
Abjad	Blanko
Iswed	Nigro
Lordi	Lordi
Lingwa uffiċjali	Oficiala lingvo
Provinċja ta' Quảng Bình	Provinco Quang Binh
Entrena	Entrena
Mérida (Veneżwela)	Merido (Venezuelo)
Benito Mussolini	Benito Mussolini
LOST (Serje televiżiva)	Lost (televida serio)
Ġebla tal-ġir	Kalkoŝtono
Valletta	La-Valeto
Papa Ġwanni XXIII	Johano la 23-a
Prixtina	Priŝtino
Curaçao	Curaçao
Coccinellidae	Kokcinelo
Metatheria	Marsupiulo
Pangolin	Maniso
Lagomorpha	Leporuloj
Baqra tal-baħar	Sireno (besto)
Eutheria	Placentuloj
Imperu Kushan	Kuŝana imperio
Qlugħ	Velo
Klaas-Jan Huntelaar	Klaas-Jan Huntelaar
Proboscidea	Rostruloj
Università Niccolò Cusano	Università degli Studi Niccolò Cusano
Fażijiet lunari	Luna fazo
Fariżej	Fariseoj
Liebru Ewropew	Eŭropa leporo
Lepisma saccharina	Lepismo
Membru tal-Parlament Ewropew	Membro de la Eŭropa Parlamento
Ewropa t'Isfel	Suda Eŭropo
Ewropa Ċentrali	Mezeŭropo
Kristadelfjani	Kristadelfianoj
Maja	Majaoj
Chow Chow	Ĉaŭĉaŭo
FC Kuban Krasnodar	FK Kuban Krasnodar
Derivata	Derivaĵo (matematiko)
Lingwa tas-Sinjali Awstraljana	Aŭstralia signolingvo
Multilingwiżmu	Plurlingveco
Lingwa Sileżjana	Silezia lingvo
Avril Lavigne	Avril Lavigne
Mikhail Gorbachev	Miĥail Gorbaĉov
Slogan	Slogano
Madre Tereża ta' Kalkutta	Patrino Teresa
Rudolf Clausius	Rudolf Clausius
Auguste Rodin	Auguste Rodin
Blogg	Blogo
Oscar Wilde	Oscar Wilde
Krakovja	Krakovo
Malala Yousafzai	Malala Yousafzai
Lingwa tas-Sinjali Finlandiża	Finna signolingvo
Lingwa tas-Sinjali Franċiża	Franca signolingvo
Mużew	Muzeo
Du Fu	Du Fu
Popolazzjoni	Loĝantaro
Arċipelagu	Insularo
Lingwa Sqallija	Sicilia lingvo
Valparaíso	Valparaiso
Nju	Niuo
Tim nazzjonali tal-futbol tal-Iskozja	Skota nacia teamo de futbalo
Lingwa Leoniża	Leona lingvo
Żews	Zeŭso
Lingwa tas-Sinjali	Signolingvo
Astroloġija	Astrologio
Mošovce	Mošovce
Saint-Dié-des-Vosges	Saint-Dié-des-Vosges
Boris Yeltsin	Boris Jelcin
Hirohito	Hirohito
Baħar Eġew	Egea Maro
J.K. Rowling	J. K. Rowling
Hiroshima	Hiroŝimo
Mitoloġija Griega	Helena mitologio
Ġeneru (tassonomija)	Genro (biologio)
Xjenzi soċjali	Socia scienco
Lista ta' kodiċi telefoniċi	Telefona landokodo
Lista ta' bliet kapitali	Listo de ĉefurboj
Noemi (kantanta)	Noemi
Sit elettroniku	TTT-ejo
Odissea	Odiseado
Lingwa Ido	Ido (lingvo)
Etimoloġija	Etimologio
Nikita Krushchev	Nikita Ĥruŝĉov
Familja (bijoloġija)	Familio (biologio)
UEFA	UEFA
Arthur Conan Doyle	Arthur Conan Doyle
Sport Club Corinthians Paulista	Corinthians
Lingwa Kopta	Egipta-kopta lingvo
Folklor	Folkloro
Siligo	Siligo
Mark Zuckerberg	Mark Zuckerberg
Lingwa tas-Sinjali Newzealander	Novzelanda signolingvo
Neolitiku	Neolitiko
Katerina II tar-Russja	Katerina la 2-a (Rusio)
Guglielmo Marconi	Guglielmo Marconi
Ordni (bijoloġija)	Ordo (biologio)
Cork	Cork
Renju (bijoloġija)	Regno (biologio)
Novial	Novialo
Aung San Suu Kyi	Aung San Suu Kyi
Kompożitur	Komponisto
Influwenza tal-majjali	Porka gripo
Serbja u Montenegro	Serbujo kaj Montenegro
Romantiċiżmu	Romantikismo
It-Trinita' Mqaddsa	Sankta Triunuo
Faragħun	Faraono
Mariupol	Mariupolo
Tazza tad-Dinja tal-Futbol 2006	Futbala Mondpokalo 2006
Klaus Ebner	Klaus Ebner
Klassi (bijoloġija)	Klaso (biologio)
Campora San Giovanni	Campora San Giovanni
Bălţi	Bălți
Auckland Grammar School	Auckland Grammar School
Bolla postali	Poŝtmarko
Era (mitoloġija)	Hera
Premju Nobel għall-Fiżika	Nobel-premio pri fiziko
Enya	Enya
Phylum	Filumo
Enriku VIII tal-Ingilterra	Henriko la 8-a (Anglio)
São Paulo FC	São Paulo Futebol Clube
Baħar Tirren	Tirena maro
Leeds	Leeds
Surrealiżmu	Superrealismo
Ħal Qormi	Qormi
Radio Studio 54 Network	Radio Studio 54 Network
Atti ta' l-Appostli	Agoj de la Apostoloj
Żodjaku	Zodiako
Paulínia	Paulinjo
Il-100 ktieb tas-seklu skont Le Monde	La 100 libroj de la 20-a jarcento laŭ Le Monde
Fonoloġija	Fonologio
Kim Il-sung	Kim Il-sung
Jan Vermeer	Johannes Vermeer
Borussia Dortmund	Borussia Dortmund
Għenba tax-xewk	Groso
Michel de Montaigne	Michel de Montaigne
Golf ta' Biskaja	Biskaja Golfo
Sorċid	Soriko
Feniċi	Fenicio
Akille	Aĥilo
Gramma	Gramo
.mt	.mt
Michelangelo Merisi da Caravaggio	Michelangelo Merisi da Caravaggio
Tim nazzjonali tal-futbol ta' Spanja	Hispana nacia teamo de futbalo
Martin Weinek	Martin Weinek
Björk	Björk
H. G. Wells	Herbert Wells
Tumas More	Thomas More
Fernando Torres	Fernando Torres
Lamantin	Manato
Baħar Liguri	Ligura maro
Dima Bilan	Dima Bilan
Lega Anżejatika	Hansa ligo
Kubiżmu	Kubismo
Qawwiet tal-Assi tat-Tieni Gwerra Dinjija	Akso Berlino-Romo-Tokio
Wikipedija:Mistoqsijiet rikorrenti	Helpo:Oftaj demandoj
Għar ta' Thien Duong	Kaverno Thien Duong
Arg-é Bam	Bam-Citadelo
Tim nazzjonali tal-futbol tal-Ġermanja	Germana nacia teamo de futbalo
Gustave Flaubert	Gustave Flaubert
San Mattew	Sankta Mateo
Sant'Ambroġju	Ambrozio de Milano
Ġwanni Kriżostmu	Johano Krizostomo
Papa Piju X	Pio la 10-a
Papa Ljun XIII	Leono la 13-a
Rasputin	Grigorij Rasputin
San Girgor Nażjanżenu	Gregorio de Nazianco
Egon Schiele	Egon Schiele
Duminku ta' Guzmán	Domingo de Guzmán
Maximilien Robespierre	Robespiero
Ġlormu	Sankta Hieronimo
San Bażilju	Sankta Bazilo
Michel Foucault	Michel Foucault
Ilarju ta' Poitiers	Hilaro
John Henry Newman	John Henry Newman
Morus (botanika)	Moruso
Son Doong	Kaverno Son Doong
Arkanġlu Mikiel	Ĉefanĝelo Miĥaelo
Titan	Titanoj
Kardinal	Kardinalo
Iżabella ta' Kastilja	Izabela la 1-a (Kastilio)
Liebru	Leporo
Felix Mendelssohn	Felix Mendelssohn Bartholdy
Orikteropu	Orikteropo
Metodu xjentifiku	Scienca metodo
Espoo	Espoo
Bijodiversità	Biodiverseco
Kannella (kulur)	Bruna
Tizjanu	Ticiano
Venere (mitoloġija)	Venuso (diino)
Tazza tad-Dinja tal-Futbol 2002	Futbala Mondpokalo 2002
Tim nazzjonali tal-futbol tal-Ingilterra	Angla nacia teamo de futbalo
Tim nazzjonali tal-futbol ta' Franza	Franca nacia teamo de futbalo
Sid Vicious	Sid Vicious
Mario Monti	Mario Monti
Stojċiżmu	Stoikismo
Martin Heidegger	Martin Heidegger
Tazza tad-Dinja tal-Futbol 1930	Futbala Mondpokalo 1930
Università ta' New York	Universitato de Novjorko
Giulio Andreotti	Giulio Andreotti
Slaten Maġi	Tri reĝoj
Charles de Foucauld	Charles de Foucauld
Pajjiżi Nordiċi	Nordio
Kategorija:Mudelli tal-kimika	Kategorio:Ŝablono:Kemio
Trattat ta' Liżbona	Traktato de Lisbono
Claudio Monteverdi	Claudio Monteverdi
Iraċ	Prokaviuloj
Sami Khedira	Sami Khedira
Provinċja ta' Soria	Provinco Sorio
Arkanġlu Rafel	Rafael
George Abela	George Abela
Moħammed VI	Mohamedo la 6-a (Maroko)
Jum l-Indipendenza	Nacia tago
Lawrence Gonzi	Lawrence Gonzi
CONMEBOL	CONMEBOL
Erbivoru	Herbovorulo
Schönhausen	Schönhausen (Elbo)
Oskar Schindler	Oskar Schindler
Enejide	Eneado
Affiss	Afikso
L-Għanja tal-Milied	Kristnaska kanto (Dickens)
Semitiku	Semidoj
Marrara	Gala veziko
Sottospeċi	Subspecio
Ħassan II	Hasano la 2-a (Maroko)
It-Tielet Repubblika Franċiża	Tria Respubliko de Francio
Joyeux Noël	Joyeux Noël
Alfred Wegener	Alfred Wegener
Żingari	Romaoj
Edith Stein	Edith Stein
Wilhelm von Humboldt	Wilhelm von Humboldt
Wikipedija:Vetrina/Senjalazzjonijiet	Vikipedio:Proponoj por elstaraj artikoloj
Tazza tad-Dinja tal-Futbol 2014	Futbala Mondpokalo 2014
Coronel Fabriciano	Coronel Fabriciano
L-Integral	Integralo
Miroslav Klose	Miroslav Klose
Alla Pugacheva	Alla Pugaĉova
Dante Bonfim Costa Santos	Dante Bonfim Costa Santos
Fes	Fez
Liebru taż-żarbuna tas-silġ	Neĝoŝua leporo
Greenpeace	Greenpeace
Ragħaj	Ŝafisto
Arkanġlu Gabrijel	Ĉefanĝelo Gabrielo
Mata Hari	Mata Hari
Fußball-Bundesliga	Unua germania ligo de futbalo (Bundesliga)
Pressjoni tad-demm	Sangopremo
Feria del Sol (Mérida)	Feria del Sol (Mérida)
Enea	Eneo
Politiku	Politikisto
David Villa	David Villa
Demenzja	Demenco
Tazza tan-Nazzjonijiet Afrikani	Afrika Pokalo de Nacioj
Romeo u Ġuljetta	Romeo kaj Julieta
Konfederazzjoni Ażjatika tal-Futbol	AFC
Robin Williams	Robin Williams
Normanni	Normandoj
Tim nazzjonali tal-futbol tal-Brażil	Brazila nacia teamo de futbalo
Grupp (matematika)	Grupo (algebro)
Mesut Özil	Mesut Özil
Isabel Allende	Isabel Allende
It-Tempesta	La Ventego
Mudell:Ċita ktieb	Ŝablono:Citaĵo el libro
Divorzju	Eksgeedziĝo
Chrzanów	Chrzanów
Suffiss	Sufikso
Artiklu (grammatika)	Artikolo (gramatiko)
Australopithecus	Aŭstralopitekoj
Festival tal-Eurovision tat-Tfal	Junulara Eŭrovido-Kantokonkurso
Kaspar Capparoni	Kaspar Capparoni
Ħolma ta’ Lejla Sajfija	Somermeznokta sonĝo
Berthe Morisot	Berthe Morisot
Manuel Neuer	Manuel Neuer
Armistizju	Armistico
Heiko Westermann	Heiko Westermann
Papa Ċelestinu V	Celesteno la 5-a
Nektarivoru	Nektaromanĝulo
Amedeo Modigliani	Amedeo Modigliani
Appendiċite	Apendicito
Daniel Bernoulli	Daniel Bernoulli
Jacob Bernoulli	Jakob Bernoulli
Dziecinów	Dziecinów (poviato Otwock)
Pajjiż interkjuż	Lando sen maraliro
Gwerer Puniċi	Punikaj Militoj
Ġunone	Junono
Massimo Oddo	Massimo Oddo
Allianz Arena	Allianz Arena
San Ġużepp	Sankta Jozefo
L-Aħħar Ċena (Leonardo)	La Lasta Vespermanĝo (Leonardo)
Macroscelididae	Makrosceliduloj
Dugongu	Dugongo
Galway	Galivo
Mario Balotelli	Mario Balotelli
Macbeth	Makbeto
Theria	Vivonaskuloj
Akropoli ta' Ateni	Akropolo (Ateno)
Filatelija	Filatelo
Stromboli	Strombolo
IMMAGINE&POESIA	Immagine & Poesia
Venere ta' Willendorf	Venuso de Willendorf
Bandiera ta' Malta	Flago de Malto
Teorija tal-grafi	Grafeteorio
Lola Pagnani	Lola Pagnani
Bitcoin	Bitmono
Tim nazzjonali tal-futbol tad-Danimarka	Dana nacia teamo de futbalo
Black metal	Nigra metalroko
Ġeroglifiċi Eġizzjani	Hieroglifoj
Sataniżmu	Satanismo
Grawnd Nazzjonali ta' Bejġing	Nacia stadiono de Pekino
Plotinu	Plotino
Tim nazzjonali tal-futbol tal-Kroazja	Kroata nacia teamo de futbalo
Tim nazzjonali tal-futbol tal-Greċja	Greka nacia teamo de futbalo
Eklissi	Eklipso
Neymar	Neymar
Dominju (bijoloġija)	Domajno (biologio)
Kassisa	Nigra ribo
Daniel Schneidermann	Daniel Schneidermann
Robert Lewandowski	Robert Lewandowski
Għajnuna:Kif timmodifika artiklu	Helpo:Redakti
Lidl	Lidl
Plutone (mitoloġija)	Plutono (dio)
Ludmilla Radchenko	Ljudmila Radĉenko
Riccardo Montolivo	Riccardo Montolivo
Ġnien Botaniku ta' Mérida	Botanika ĝardeno Mérido
Cristian Zaccardo	Cristian Zaccardo
Gwerra totali	Totala milito
Ugo Grozju	Hugo Grotius
René Adler	René Adler
Eruka	Kultiva eruko
Ablativ	Ablativo
Tazza Ażjatika tal-Futbol	Azia Pokalo
Internazzjonali Soċjalista	Socialista Internacio
Santa Sede	Apostola Seĝo
Ettore	Hektoro
WK	A. D.
Reġina ta' Saba	Reĝino de Ŝeba
Alġebra astratta	Abstrakta algebro
CONCACAF	CONCACAF
Skanderbeg	Gjergj Kastrioti Skanderbeg
Tim nazzjonali tal-futbol tal-Iżvezja	Sveda nacia teamo de futbalo
Raducz	Raducz
Paul Allen	Paul Allen
Eroj	Heroo
Kuopio	Kuopio
Sirt	Sirto
Tim nazzjonali tal-futbol tal-Awstrija	Aŭstra nacia teamo de futbalo
Tim nazzjonali tal-futbol tal-Irlanda	Irlanda nacia teamo de futbalo
Derry	Derry
Ġuvni	Bakalaŭro
Drużiżmu	Druzoj
Omnivoru	Ĉiomanĝanto
George Best	George Best
Oliver Twist	Oliver Twist
Tim nazzjonali tal-futbol tal-Iżvizzera	Svisa nacia teamo de futbalo
Ekwazzjoni ta' Schrödinger	Ekvacio de Schrödinger
Priżma	Prismo (optiko)
Ballun tad-Deheb	Ora Pilko
Tim nazzjonali tal-futbol tal-Polonja	Pola nacia teamo de futbalo
Foviżmu	Faŭvismo
Tim nazzjonali tal-futbol tal-Belġju	Belga nacia teamo de futbalo
Sant'Antnin ta' Padova	Antonio de Padovo
Konfederazzjoni Afrikana tal-Futbol	CAF
Tim nazzjonali tal-futbol tar-Rumanija	Rumana nacia teamo de futbalo
Zeca Pagodinho	Zeca Pagodinho
Tim nazzjonali tal-futbol tal-Ukrajna	Ukraina nacia teamo de futbalo
Għawdex	Gozo
Tim nazzjonali tal-futbol tal-Ungerija	Hungara nacia teamo de futbalo
Natura mejta	Aĵpentraĵo
Laura Pausini	Laura Pausini
Gwerra Anglo-Żanżibarjana	Angla-zanzibara milito
Children of Bodom	Children of Bodom
Festival tal-Eurovision 1956	Eŭrovido-Kantokonkurso 1956
Tazza tal-Konfederazzjonijiet	Pokalo de FIFA-konfederacioj
Tim nazzjonali tal-futbol tas-Slovenja	Slovena nacia teamo de futbalo
Gowler	Golulo
Mary Cassatt	Mary Cassatt
Frankinċens	Olibano
Xenarthra	Ksenartroj
Lista ta' kimiċi organiċi	Organika kombinaĵo
Lira Maltija	Malta liro
Tim nazzjonali tal-futbol tas-Slovakkja	Slovaka nacia teamo de futbalo
Tereża ta' Ávila	Tereza el Avilo
Guernica (pittura)	Gerniko (pentraĵo)
Tim nazzjonali tal-futbol ta' New Zealand	Nov-Zelanda nacia teamo de futbalo
Tazza tad-Dinja tal-Futbol 2010	Futbala Mondpokalo 2010
Kantant	Kantisto
Andrea Palladio	Andrea Palladio
Apparat Periferali	Flankaparato
Meknès	Meknes
Copa América	Amerika Pokalo
Serje ta' Fourier	Vico de Fourier
Santa Katarina ta' Lixandra	Katarina de Aleksandrio
Lipari	Liparaj insuloj
Liebru tal-muntanji	Neĝleporo
Konfederazzjoni Oċeanika tal-Futbol	OFC
Tim nazzjonali tal-futbol tal-Ażerbajġan	Azera nacia teamo de futbalo
Atomium	Atomium
Tereża ta' Lisieux	Tereza de Lisieux
Tabella tal-midalji tal-Logħob Olimpiku tas-sajf 2008	Medaltabelo de la Somera Olimpiko 2008
Tazza Interkontinentali (futbol)	Interkontinenta Pokalo
Bing	Bing (retejo)
Tim nazzjonali tal-futbol tal-Armenja	Armena nacia teamo de futbalo
San Bastjan	Sankta Sebastiano
Kolugo	Dermopteroj
Gareth Bale	Gareth Bale
Manuel Rivera-Ortiz	Manuel Rivera-Ortiz
Immakulata Kunċizzjoni	Senmakula koncipiĝo
Nigel de Jong	Nigel de Jong
Tim nazzjonali tal-futbol tal-Litwanja	Litova nacia teamo de futbalo
Karmelitani	Karmelanoj
Barriera	Ŝtonminejo
Oroskopju	Horoskopo
Fatt	Fakto
Supereroj	Superheroo
Andrey Korotayev	Andrej Korotajev
Tim nazzjonali tal-futbol tal-Unjoni Sovjetika	Sovetunia nacia teamo de futbalo
Soċjaliżmu Demokratiku	Demokrata socialismo
CONCACAF Gold Cup	Ora Pokalo
Pont du Gard	Pont du Gard
Sligo	Sligo
Emblema ta' Malta	Blazono de Malto
Benvenuto Cellini	Benvenuto Cellini
Ordni Militari Sovran ta' Malta	Malta Ordeno
Club Brugge KV	Club Brugge
Jóhanna Guðrún Jónsdóttir	Jóhanna Guðrún Jónsdóttir
Edward Sapir	Edward Sapir
Kemmuna	Comino
Lucrezia Borgia	Lucrezia Borgia
Klara ta' Assisi	Klara el Asizo
San Valentinu	Valenteno de Terni
Mini ta' Cu Chi	Củ-Chi-tuneloj
L-Innu Malti	L-Innu Malti
Kate Ryan	Kate Ryan
Patri Piju	Pio el Pietrelcina
Analisi komplessa	Kompleksa analitiko
Łobez	Łobez
Magnificat	Magnificat
Ażerbajġan fil-Festival tal-Eurovision	Azerbajĝano en la Eŭrovido-Kantokonkurso
Papat ta' Avignon	Papado en Avinjono
Armenja fil-Festival tal-Eurovision	Armenio en la Eŭrovido-Kantokonkurso
Dundalk	Dundalk
Kumitat tar-Reġjuni	Komitato de regionoj
Mandejżmu	Mandeoj
Il-Merkant ta’ Venezja	La venecia komercisto
Olympe de Gouges	Olympe de Gouges
Giovanni Falcone	Giovanni Falcone
Mdina	Medino (Malto)
Vulcano	Vulcano (insulo)
Liġi tan-numri kbar	Leĝo de grandaj nombroj
Batterija	Baterio
Kung fu	Kungfuo
Las Meninas	Las Meninas
Ingólfr Arnarson	Ingólfur Arnarson
Elezzjonijiet Ewropej 2009	Eŭropaj balotoj de 2009
Kewkba ta' Betlehem	Stelo de Bet-Leĥem
FC Dinamo Minsk	Dinamo Minsko
Golf	Golf (apartigilo)
Ignazio Abate	Ignazio Abate
Dasyuromorphia	Dasiuro
Antonio Nocerino	Antonio Nocerino
Mohamed Bouazizi	Mohamed Bouazizi
Anna Bergendahl	Anna Bergendahl
Emerson Ferreira da Rosa	Emerson Ferreira da Rosa
Kalkulu tal-varjazzjonijiet	Variada kalkulo
Ġgantija	Ĝgantija
Filippu Neri	Filipo Neri
Tazza tad-Dinja tal-Futbol tal-Klabbs	Kluba Mondpokalo de FIFA
No (teatru)	Noo
CAF	Caf
Alessandro Nesta	Alessandro Nesta
Johann Bernoulli	Johann Bernoulli
Tribù (bijoloġija)	Tribo (biologio)
Santa Katerina ta' Siena	Katarina de Sieno
Alexa Internet	Alexa Internet
Tupaja	Tupajuloj
Liebru tal-Artiku	Arkta leporo
Incertae sedis	Incertae sedis
Ġużeppina Bakhita	Jozefino Baĥita
Sofonisba Anguissola	Sofonisba Anguissola
Hadise	Hadise
Nicole Hohloch	Nicole Hohloch
Aysel Teymurzadeh	Aysel Teymurzadə
Al-naxid al-xarif	Maroka himno
Ġeorġja fil-Festival tal-Eurovision	Kartvelio en la Eŭrovido-Kantokonkurso
Muniti tal-ewro ta' Malta	Maltaj eŭro-moneroj
Kampjonati Ewropej tal-Futbol 2008	Eŭropa Futbal-Ĉampionado 2008
Papessa Ġovanna	Johana (papino)
Ottorino Respighi	Ottorino Respighi
Storja ta' Malta	Historio de Malto
Mikrostat	Mikroŝtato
Vinċenz de Paul	Sankta Vincento de Paul
Halloween	Halloween
FIFA	FIFA
Lista ta' pajjiżi skont l-erja	Listo de landoj laŭ areo
Kampjonati Ewropej tal-Futbol	Eŭropa Futbal-Ĉampionado
Palazz Leopoldskron	Palaco Leopoldskron
Tim nazzjonali tal-futbol tal-Awstralja	Aŭstralia nacia teamo de futbalo
Nouvelle Fédération-Board	NF-Ligo
Alfonsu Marija de Liguori	Alfonso Maria de Liguori
Fenetika	Fenetiko
Forma (botanika)	Formo (botaniko)
Nihat Kahveci	Nihat Kahveci
Didelphis	Didelfo
Karl Shuker	Karl Shuker
Gianluca Ramazzotti	Gianluca Ramazzotti
Robertu Bellarmino	Roberto Bellarmino
Salve Reġina	Salve Regina
Paolo Borsellino	Paolo Borsellino
Martin de Porres	Martín de Porres
Jô	Jô
San Ġennaru	Sankta Januaro
Frans Sammut	Frans Sammut
Tazza tad-Dinja VIVA	Futbala Pokalo VIVA
Mike Bongiorno	Mike Bongiorno
Alleati tat-Tieni Gwerra Dinjija	Aliancanoj
Jerzy Grotowski	Jerzy Grotowski
Joe Sacco	Joe Sacco
Anthony Mamo	Anthony Mamo
Cercle Brugge KSV	Cercle Brugge
Memorial Day	Tago de la Falintoj
Life of Pi	Life of Pi
Lingwa tas-Sinjali Taljana	Itala signolingvo
Semih Şentürk	Semih Şentürk
Helder Camara	Hélder Câmara
San Gejtanu	Gaetano Thiene
Kurt Calleja	Kurt Calleja
Servizz Awstrijak barra l-pajjiż	Aŭstria Eksterlanda Servo
Inga u Anush Arshakyans	Inga kaj Anuŝ
Lista ta' vulkani fl-Italja	Listo de vulkanoj de Italio
Liebru xkupa	Leonmontara leporo
Alternattiva Demokratika	Alternativo Demokratia (Malto)
Papa Franġisku	Francisko (papo)
Il-Ktieb ta' Mormon	Libro de Mormon
Prospero Grech	Prosper Grech
Klabb tal-futbol	Futbalteamo
Festival tal-Eurovision taż-Żgħar 2008	Junulara Eŭrovido-Kantokonkurso 2008
Coritiba Foot Ball Club	Coritiba Foot Ball Club
Ajruport Internazzjonali ta' Tan Son Nhat	Flughaveno Tan Son Nhat
Edwin van der Sar	Edwin van der Sar
Loreen	Loreen
Gonzalo Higuaín	Gonzalo Higuaín
Tim nazzjonali tal-futbol tat-Turkija	Turka nacia teamo de futbalo
Tim nazzjonali tal-futbol tar-Repubblika Ċeka	Ĉeĥa nacia teamo de futbalo
Charles Manson	Charles Manson
Oġġett (filosofija)	Objekto (filozofio)
Linosa	Linosa
Nichi Vendola	Nichi Vendola
Liebru ta' Granada	Iberia leporo
Tibdil fil-Lingwa	Lingvoŝanĝiĝo
Ronaldo	Ronaldo
Kaká	Kaká
Giuseppe Merisi	Giuseppe Merisi
Dun Karm Psaila	Dun Karm
Tupaja komuni	Arbosoriko
Wikipedija:Abbrevjazzjoni	Vikipedio:Simbola ligilo
Victoria Lines	Victoria Lines
Liebru ta' denbu iswed	Nigravosta leporo
Madonna ta' Coromoto	Virgulino de Coromoto
Qerda tal-innoċenti	Masakro de la Senpekuloj
Cinco de Mayo	Cinco de Mayo
Liebru ta' Tehuantepec	Flavgorĝa leporo
Fenek tal-vulkan	Vulkankuniklo
Ouija Board	Literumita tabulo
San Franġisk t'Assisi	Sankta Francisko el Asizo
Tim nazzjonali tal-futbol tal-Italja	Itala nacia teamo de futbalo
Insettivoru	Insektomanĝulo
Trzebinia	Trzebinia
De facto	De facto
Lista ta' pajjiżi skont il-popolazzjoni	Listo de landoj laŭ loĝantaro
Klad	Klado
Kunsilli lokali ta' Malta	Teritoria organizado de Malto
AS (gazzetta)	As (ĵurnalo)
Tim nazzjonali tal-futbol tar-Russja	Rusia nacia teamo de futbalo
Filfla	Filfla
Ħal Tarxien	Tarxien
Ġużeppi Mercieca	Joseph Mercieca
Liebru ta' Kap	Kaboleporo
Mellieħa	Mellieħa
Għajnsielem	Għajnsielem
Varjetà (botanika)	Vario
Lingwa Awżiljari Internazzjonali	Internacia planlingvo
Transnistrija	Ĉednestrio
Għajnuna:Kontenut	Helpo:Enhavo
Logħob tal-Pajjiżi ż-Żgħar tal-Ewropa	Olimpiaj ludoj de la etaj eŭropaj ŝtatoj
Marca (gazzetta)	Marca (sportĵurnalo)
Xewkija	Xewkija
Liebru Taljan	Korsika leporo
Joseph Muscat	Joseph Muscat
Achal Prabhala	Achal Prabhala
Madonna tal-Karmnu	Madono de Monto Karmelo
Liverpool FC	Liverpool FC
Wikipedija:Ambaxxata	Vikipedio:Ambasadorejo
Raimondo Vianello	Raimondo Vianello
Candies (grupp)	Candies
Wikipedija:Glossarju	Helpo:Vikipedia terminaro
Kategorija:Ġermanja	Kategorio:Germanio
Kategorija:Italja	Kategorio:Italio
Kategorija:Stati Uniti	Kategorio:Usono
Kategorija:Russja	Kategorio:Rusio
Kategorija:Renju Unit	Kategorio:Unuiĝinta Reĝlando
Kategorija:Spanja	Kategorio:Hispanio
Kategorija:Indja	Kategorio:Barato
Kategorija:Turkija	Kategorio:Turkio
Kategorija:New Zealand	Kategorio:Nov-Zelando
Pixxivoru	Fiŝomanĝanto
Kategorija:Afganistan	Kategorio:Afganio
Kategorija:Alġerija	Kategorio:Alĝerio
Kategorija:Awstrija	Kategorio:Aŭstrio
Kategorija:Pajjiżi l-Baxxi	Kategorio:Nederlando
Kategorija:Niġerja	Kategorio:Niĝerio
Kategorija:Polonja	Kategorio:Pollando
Kategorija:Portugall	Kategorio:Portugalio
Kategorija:Żvizzera	Kategorio:Svislando
Kategorija:Ukraina	Kategorio:Ukrainio
Kategorija:Vjetnam	Kategorio:Vjetnamio
Kategorija:Fiżika	Kategorio:Fiziko
Kategorija:Bijoloġija	Kategorio:Biologio
Kategorija:Kimika	Kategorio:Kemio
Kategorija:Storja	Kategorio:Historio
Kategorija:Ġeografija	Kategorio:Geografio
Kategorija:Arti viżiva	Kategorio:Vidaj artoj
Kategorija:Reliġjon	Kategorio:Religio
Kategorija:Sport	Kategorio:Sporto
Kategorija:Xjenza	Kategorio:Scienco
Kategorija:Unjoni Ewropea	Kategorio:Eŭropa Unio
Kategorija:Ċinema	Kategorio:Kino
Kategorija:Komunikazzjoni	Kategorio:Komunikado
Kategorija:Mietu fl-2012	Kategorio:Mortintoj en 2012
Mudell:Portal tmiem	Portalo:Box-footer
Superspeċi	Superspecio
Wikijunior	Wikijunior
Juan Antonio Villacañas	Juan Antonio Villacañas
Kategorija:Ekoloġija	Kategorio:Ekologio
Granivoru	Grenovorado
Kategorija:Diżambigwazzjoni	Kategorio:Apartigiloj
Kategorija:Olimpjadi	Kategorio:Olimpikoj
Kategorija:Filosofija	Kategorio:Filozofio
Kategorija:Psikoloġija	Kategorio:Psikologio
Kategorija:Buddiżmu	Kategorio:Budhismo
Kategorija:Kristjaneżmu	Kategorio:Kristanismo
Kategorija:Induiżmu	Kategorio:Hinduismo
Kategorija:Iżlam	Kategorio:Islamo
Kategorija:Ġudaiżmu	Kategorio:Judismo
Oġġett	Objekto
Lingwa tas-Sinjali Olandiża	Nederlanda signolingvo
Bochotnica	Bochotnica
Stat Iżlamiku	Islama Ŝtato de Irako kaj Sirio
Benedicta Boccoli	Benedicta Boccoli
Orycteropodidae	Tubetodentuloj
Kategorija:Abbozzi	Kategorio:Ĝermo
Kategorija:Pjaneti	Kategorio:Planedoj
Kategorija:Abbozzi tal-mużika	Kategorio:Ĝermoj pri muziko
Kategorija:Abbozzi tal-kultura	Kategorio:Ĝermoj pri kulturo
Kategorija:Kultura	Kategorio:Kulturo
Kategorija:Snin	Kategorio:Jaroj
Kategorija:Xjenzi soċjali	Kategorio:Homa scienco
Kategorija:Kontinenti	Kategorio:Kontinentoj
Mudell:SistemaSolari	Ŝablono:Sunsistemo
Sezzjoni (botanika)	Sekcio (botaniko)
Wikipedija:Konvenzjonijiet ta' nomenklatura	Vikipedio:Titoloj de artikoloj
Sottoġeneru	Subgenro
Għajnuna:Kif tirreġistra	Helpo:Registriĝo
Għajnuna:Wikiketta	Vikipedio:Etiko de Vikipedio
Kategorija:Bots tal-Wikipedija	Kategorio:Vikipedio:Robotoj
Mudell:Kwota	Ŝablono:Citaĵo
Kategorija:Nies Taljani	Kategorio:Italoj
Kategorija:Mużiċisti Amerikani	Kategorio:Usonaj muzikistoj
Kategorija:Futbolers Ġermaniżi	Kategorio:Germanaj futbalistoj
Mudell:Tl	Ŝablono:Ŝ
Mudell:Kaxxa tal-utent	Ŝablono:Uzantoskatolo1
Sergio Mattarella	Sergio Mattarella
Kategorija:Pajjiżi	Kategorio:Landoj
Wikipedija:Amministraturi	Vikipedio:Administrantoj
Kategorija:Każakistan	Kategorio:Kazaĥio
Wikipedija:Amministraturi/Kandidati	Vikipedio:Administrantoj/kandidatoj
Kategorija:Kategoriji skont in-nazzjonalità	Kategorio:Kategorioj laŭ nacieco
Wikipedija:Bot	Vikipedio:Roboto
Kategorija:Kategoriji moħbija	Kategorio:Kaŝitaj kategorioj
Kategorija:Internet	Kategorio:Interreto
Kategorija:Botanika	Kategorio:Botaniko
Kategorija:Politika	Kategorio:Politiko
Kategorija:Arti	Kategorio:Arto
Eġittu	Egiptujo
Kategorija:2013	Kategorio:2013
Mudell:Bot	Ŝablono:Bot
Kanada	Kanado
Kategorija:Ungerija	Kategorio:Hungario
Kategorija:Belġju	Kategorio:Belgio
Kategorija:Ċekja	Kategorio:Ĉeĥio
Kategorija:Danimarka	Kategorio:Danio
Kategorija:Estonja	Kategorio:Estonio
Kategorija:Finlandja	Kategorio:Finnlando
Kategorija:Latvja	Kategorio:Latvio
Kategorija:Iżlanda	Kategorio:Islando
Kategorija:Litwanja	Kategorio:Litovio
Kategorija:Malta	Kategorio:Malto
Kategorija:Żvezja	Kategorio:Svedio
Kategorija:Slovakkja	Kategorio:Slovakio
Kategorija:Slovenja	Kategorio:Slovenio
Kategorija:Repubblika tal-Irlanda	Kategorio:Respubliko de Irlando
Kategorija:Artikli fil-vetrina	Kategorio:Elstaraj artikoloj
Kategorija:Gwerer	Kategorio:Militoj
Kategorija:Logħob elettroniku	Kategorio:Videoludoj
Wikipedija:Bot/Rikjesti	Vikipedio:Roboto/Laboroj
Mudell:Flagicon	Ŝablono:Flagikono
Kategorija:Pajjiżi tal-Ewropa	Kategorio:Eŭropaj landoj
Kategorija:Ewropa	Kategorio:Eŭropo
Kategorija:Għajnuna	Kategorio:Helpo
Mudell:Dokumentazzjoni	Ŝablono:Dok
Wikipedija:Bot/Rikjesti għall-approvazzjoni	Vikipedio:Roboto/Permespeto
Wikipedija:Politika dwar il-protezzjoni	Vikipedio:Ŝlosendaj paĝoj
Kategorija:Wikipedjani	Kategorio:Vikipediistoj
Wikipedija:Kunsens	Vikipedio:Interkonsento
Wikipedija:L-ebda attakk personali	Vikipedio:Neniu persona atako
Wikipedija:Kuntatt	Vikipedio:Kontaktoj
Kategorija:Utenti skont il-lingwa	Kategorio:Vikipediistoj laŭ lingvo
Kategorija:Politiki tal-Wikipedija	Kategorio:Vikipedio:Reguloj
Wikipedija:Sondaġġi	Vikipedio:Baloto
Wikipedija:Firem	Helpo:Subskribo
Wikipedija:Abbozz	Vikipedio:Ĝermo
Wikipedija:Artikli rikjesti	Vikipedio:Dezirataj artikoloj
Mudell:Softredirect	Ŝablono:Intervikia plusendilo
Mudell:Ħassar minnufih	Ŝablono:Forigu tuj
Kategorija:Teknoloġija	Kategorio:Teknologio
Kategorija:Lingwa	Kategorio:Lingvoj
Għajnuna:Kif tibda artiklu	Helpo:Kiel krei paĝon
Kategorija:Wikipedija	Kategorio:Vikipedio
Kanċillier tal-Ġermanja	Federacia Kanceliero (Germanio)
Wikipedija:Ċaħda ġenerali	Vikipedio:Malgarantio
Kategorija:Paġni mhux indiċizzati	Kategorio:Neindeksitaj paĝoj
Kategorija:Avvenimenti kurrenti	Kategorio:Aktualaĵoj
Wikipedija:Manwal tal-istil	Vikipedio:Stilogvido
Mudell:-	Ŝablono:-
Mudell:Navbox	Ŝablono:Navigilo2
Mudell:Abbrevjazzjoni	Ŝablono:Mallongigo
Kategorija:Żoni tal-ħin	Kategorio:Horzonoj
Kategorija:Nies ħajjin	Kategorio:Vivantaj homoj
Festival tal-Eurovision 2014	Eŭrovido-Kantokonkurso 2014
Mudell:!	Ŝablono:!
Kategorija:Mudelli ta' bnadar	Kategorio:Ŝablonoj landonomoj kun flageto
Mudell:!-	Ŝablono:!-
Mudell:!!	Ŝablono:!!
Mudell:=	Ŝablono:=
Mudell:Tnavbar	Ŝablono:Tnavbar
Mudell:Ċiklu	Ŝablono:Loop
Kategorija:Mudelli ta' formattjar	Kategorio:Ŝablono:Formatigo
Mudell:Kulur	Ŝablono:Kolorteksto
Mudell:Deskrizzjoni kmand	Ŝablono:Diskreta mallongigo
Wikipedija:Lista ta' artikli li kull Wikipedija għandu jkollha	Vikipedio:Listo de havendaj artikoloj
Kategorija:Afrika	Kategorio:Afriko
Kategorija:Elettronika	Kategorio:Elektroniko
Kategorija:Xhur tas-sena	Kategorio:Monatoj
Mudell:Wikisors	Ŝablono:Vikifontaro
Mudell:Babel	Ŝablono:Babelejo
Mudell:Commons	Ŝablono:Commons
Mudell:Link GA	Ŝablono:LigoLeginda
Mudell:Referenzi	Ŝablono:Referencoj
Għajnuna:Esplora lill-Wikipedija	Helpo:Serĉado
Mudell:Pajjiżi tal-Commonwealth	Ŝablono:Komunumo de Nacioj
Mudell:Stub	Ŝablono:Ĝermo
Mudell:Utent ar-1	Ŝablono:Vikipediisto ar-1
Mudell:Utent be-2	Ŝablono:Vikipediisto be-2
Mudell:Utent da-1	Ŝablono:Vikipediisto da-1
Mudell:Utent bg-1	Ŝablono:Vikipediisto bg-1
Mudell:Utent eo-3	Ŝablono:Vikipediisto eo-3
Mudell:Utent de	Ŝablono:Vikipediisto de
Mudell:Utent de-1	Ŝablono:Vikipediisto de-1
Mudell:Utent el	Ŝablono:Vikipediisto el
Mudell:Utent es	Ŝablono:Vikipediisto es
Mudell:Utent de-3	Ŝablono:Vikipediisto de-3
Mudell:Utent en-3	Ŝablono:Vikipediisto en-3
Mudell:Utent en-1	Ŝablono:Vikipediisto en-1
Mudell:Utent en-2	Ŝablono:Vikipediisto en-2
Mudell:Utent en-4	Ŝablono:Vikipediisto en-4
Mudell:Utent en-0	Ŝablono:Vikipediisto en-0
Mudell:Utent en	Ŝablono:Vikipediisto en
Mudell:Utent de-2	Ŝablono:Vikipediisto de-2
Mudell:Utent es-1	Ŝablono:Vikipediisto es-1
Mudell:Utent fa	Ŝablono:Vikipediisto fa
Mudell:Utent fr-1	Ŝablono:Vikipediisto fr-1
Mudell:Utent ia-2	Ŝablono:Vikipediisto ia-2
Mudell:Utent hr	Ŝablono:Vikipediisto hr
Mudell:Utent it-3	Ŝablono:Vikipediisto it-3
Mudell:Utent grc-1	Ŝablono:Vikipediisto grc-1
Mudell:Utent ja-4	Ŝablono:Vikipediisto ja-4
Mudell:Utent sk	Ŝablono:Vikipediisto sk
Mudell:Utent tr-2	Ŝablono:Vikipediisto tr-2
Mudell:Utent ja	Ŝablono:Vikipediisto ja
Mudell:Utent it-1	Ŝablono:Vikipediisto it-1
Mudell:Utent fr	Ŝablono:Vikipediisto fr
Mudell:Ebda firma	Ŝablono:Subskribo
Mudell:Pl	Ŝablono:Pl
Kategorija:Turiżmu	Kategorio:Turismo
Kategorija:1957	Kategorio:1957
Kategorija:1949	Kategorio:1949
Kategorija:1927	Kategorio:1927
Kategorija:1919	Kategorio:1919
Kategorija:Moldova	Kategorio:Moldavio
Kategorija:Ażerbajġan	Kategorio:Azerbajĝano
Mudell:Plejers fit-tim tal-futbol/nofs	Ŝablono:Fs mid
Kategorija:Asja	Kategorio:Azio
Kategorija:Ċili	Kategorio:Ĉilio
Kategorija:Seklu 21	Kategorio:21-a jarcento
Kategorija:Mudelli ta' servizz	Kategorio:Ŝablono:Zorgilo
Kategorija:Utenti uk	Kategorio:Vikipediisto uk
Kategorija:1930	Kategorio:1930
Kategorija:Utenti uk-N	Kategorio:Vikipediisto uk-D
Kategorija:1936	Kategorio:1936
Kategorija:1947	Kategorio:1947
Mudell:Mudell ikkumplikat	Ŝablono:Esotera
Kategorija:1937	Kategorio:1937
Kategorija:1940	Kategorio:1940
Kategorija:1934	Kategorio:1934
Kategorija:1960	Kategorio:1960
Kategorija:1943	Kategorio:1943
Kategorija:1951	Kategorio:1951
Kategorija:1942	Kategorio:1942
Kategorija:1959	Kategorio:1959
Kategorija:1938	Kategorio:1938
Kategorija:1928	Kategorio:1928
Kategorija:1913	Kategorio:1913
Kategorija:1918	Kategorio:1918
Kategorija:1954	Kategorio:1954
Kategorija:1941	Kategorio:1941
Kategorija:1955	Kategorio:1955
Kategorija:1950	Kategorio:1950
Kategorija:1921	Kategorio:1921
Kategorija:1977	Kategorio:1977
Kategorija:1946	Kategorio:1946
Kategorija:1948	Kategorio:1948
Kategorija:1932	Kategorio:1932
Mudell:Plejers fit-tim tal-futbol	Ŝablono:Fs player
Kategorija:Futbol	Kategorio:Futbalo
Kategorija:1945	Kategorio:1945
Mudell:Mod	Ŝablono:Mod
Kategorija:1923	Kategorio:1923
Kategorija:1935	Kategorio:1935
Kategorija:1910	Kategorio:1910
Kategorija:1917	Kategorio:1917
Kategorija:1904	Kategorio:1904
Kategorija:1926	Kategorio:1926
Kategorija:1907	Kategorio:1907
Kategorija:1914	Kategorio:1914
Kategorija:1929	Kategorio:1929
Kategorija:1920	Kategorio:1920
Mudell:Utent it	Ŝablono:Vikipediisto it
Kategorija:1925	Kategorio:1925
Mudell:Utent uk	Ŝablono:Vikipediisto uk
Kategorija:1905	Kategorio:1905
Kategorija:1915	Kategorio:1915
Mudell:Utent es-2	Ŝablono:Vikipediisto es-2
Kategorija:1908	Kategorio:1908
Kategorija:Mudelli ta' avviż	Kategorio:Ŝablono:Averto por uzantoj
Kategorija:1901	Kategorio:1901
Kategorija:1903	Kategorio:1903
Kategorija:1902	Kategorio:1902
Kategorija:1900	Kategorio:1900
Mudell:Ru	Ŝablono:Ru
Mudell:PaġnaPrinċipali/Proġetti	Ŝablono:ĈefPaĝo/AliajProjektoj
Kategorija:1933	Kategorio:1933
Kategorija:1912	Kategorio:1912
Mudell:Xhur	Ŝablono:MonatEnkonduko
Kategorija:Klabbs tal-futbol Ingliżi	Kategorio:Anglaj futbalteamoj
Kategorija:Mudelli tal-koordinati	Kategorio:Ŝablono:Kun koordinatoj
Kategorija:Klabbs tal-futbol Spanjoli	Kategorio:Hispanaj futbalteamoj
Kategorija:1952	Kategorio:1952
Kategorija:Klabbs tal-futbol Ġermaniżi	Kategorio:Germanaj futbalteamoj
Kategorija:Lingwistika	Kategorio:Lingvoscienco
Mudell:Football kit	Ŝablono:Ĉemizo
Kategorija:1911	Kategorio:1911
Kategorija:1922	Kategorio:1922
Kategorija:1924	Kategorio:1924
Kategorija:1906	Kategorio:1906
Kategorija:Klabbs tal-futbol	Kategorio:Futbalteamoj
Kategorija:Mudelli tal-futbol	Kategorio:Ŝablono:Futbalo
Kategorija:Utenti fr-1	Kategorio:Vikipediisto fr-1
Mudell:Wikiquote	Ŝablono:Vikicitaro
Kategorija:Innijiet Nazzjonali	Kategorio:Naciaj himnoj
Mudell:Edizzjoni Olimpika	Ŝablono:Informkesto olimpiko
Mudell:Wikimedia	Ŝablono:Vikimedia fondaĵo
Mudell:Infobox artist mużikali	Ŝablono:Informkesto muzika artisto
Mudell:WIP	Ŝablono:Redaktas
Mudell:Es	Ŝablono:Es
Mudell:Ambox	Ŝablono:ArtikolaMesaĝokesto
Mudell:Cs	Ŝablono:Cs
Mudell:Infobox Pajjiż	Ŝablono:Informkesto lando
Mudell:Mas	Ŝablono:Max
Mudell:Fi	Ŝablono:Fi
Mudell:Stampa kbira	Ŝablono:Granda dosiero
Mudell:Sar	Ŝablono:Farita
Mudell:Awdjo	Ŝablono:Aŭdio
Mudell:Tmbox	Ŝablono:DiskutaMesaĝokesto
Mudell:Navbox with columns	Ŝablono:Navigilo kun kolumnoj
Mudell:Kaxxa tal-bidu	Ŝablono:Komencskatolo
Mudell:Biżestili	Ŝablono:ISLEAPYEAR
Mudell:Politika	Ŝablono:Regulo
Mudell:Vetrina	Ŝablono:Elstara
Kategorija:Utenti en-4	Kategorio:Vikipediisto en-4
Kategorija:Utenti en	Kategorio:Vikipediisto en
Kategorija:Utenti zh	Kategorio:Vikipediisto zh
Kategorija:Kroazja	Kategorio:Kroatio
Kategorija:Utenti zh-N	Kategorio:Vikipediisto zh-D
Kategorija:Utenti en-2	Kategorio:Vikipediisto en-2
Mudell:TOCright	Ŝablono:TOC-dekstre
Kategorija:Mietu fl-1902	Kategorio:Mortintoj en 1902
Mudell:Utent zh	Ŝablono:Vikipediisto zh
Mudell:Leġenda	Ŝablono:Priskribo
Mudell:Ċita web	Ŝablono:Citaĵo el la reto
Mudell:Lx	Ŝablono:Lx
Kategorija:Kċina	Kategorio:Kuirarto
Mudell:Coor URL	Ŝablono:KoordinatojURL
Mudell:Pp-mudell	Ŝablono:Pp-ŝablono
Mudell:Min	Ŝablono:Minimumo
Mudell:Subon	Ŝablono:Eniris
Mudell:Wikizzjunarju	Ŝablono:Vikivortaro
Mudell:Utent nl-2	Ŝablono:Vikipediisto nl-2
Mudell:Bar box	Ŝablono:Strikesto
Mudell:Languageicon	Ŝablono:Ref-lang
Kategorija:Agrikoltura	Kategorio:Agrikulturo
Kategorija:Seklu 20	Kategorio:20-a jarcento
Kategorija:Politiċi	Kategorio:Politikistoj
Kategorija:Amerika	Kategorio:Ameriko
Mudell:Użioħra	Ŝablono:Aliaj signifoj
Kategorija:Mudelli tal-lingwi tal-utenti	Kategorio:Babelaj ŝablonoj
Kategorija:Bliet tal-Marokk	Kategorio:Urboj de Maroko
Mudell:Imbox	Ŝablono:BildaMesaĝokesto
Mudell:Data tat-twelid u età	Ŝablono:Naskiĝdato kaj aĝo
Mudell:Clade	Ŝablono:Klado
Mudell:ISEMXAHAR	Ŝablono:Nomo de monato
Mudell:Rindirizzament kategorija	Ŝablono:Kategoria alidirekto
Mudell:Infobox Kariga pubblika	Ŝablono:Informkesto politikisto
Mudell:Proġetti oħra	Ŝablono:Projektoj
Mudell:Sortname	Ŝablono:Ordiginomo
Mudell:Data tal-mewt u età	Ŝablono:Mortodato kaj aĝo
Kategorija:Twieldu fl-1879	Kategorio:Naskiĝintoj en 1879
Mudell:NUMRUXAHAR	Ŝablono:Nombro de monato
Kategorija:Abbozzi ta' bijografiji	Kategorio:Ĝermoj pri biografio
Kategorija:Twieldu fl-1955	Kategorio:Naskiĝintoj en 1955
Mudell:Ikoni tat-titlu	Ŝablono:Titola ikono
Kategorija:Twieldu fl-1963	Kategorio:Naskiĝintoj en 1963
Kategorija:Twieldu fl-1817	Kategorio:Naskiĝintoj en 1817
Kategorija:Twieldu fl-1998	Kategorio:Naskiĝintoj en 1998
Mudell:Wikifikazzjoni	Ŝablono:Vikiigenda
Mudell:Siġra ġenealoġika/tmiem	Ŝablono:Genealogia arbo/fino
Kategorija:Seklu 19	Kategorio:19-a jarcento
Kategorija:Kittieba	Kategorio:Verkistoj
Mudell:Yel	Ŝablono:Flava kardo
Mudell:Utent pt-1	Ŝablono:Vikipediisto pt-1
Kategorija:1931	Kategorio:1931
Kategorija:1958	Kategorio:1958
Kategorija:1956	Kategorio:1956
Kategorija:1944	Kategorio:1944
Kategorija:Jiem ta' Jannar	Kategorio:Januaro
Kategorija:1916	Kategorio:1916
Kategorija:1939	Kategorio:1939
Kategorija:1909	Kategorio:1909
Kategorija:Klabbs tal-futbol Taljani	Kategorio:Italaj futbalteamoj
Kategorija:Mietu fl-1221	Kategorio:Mortintoj en 1221
Mudell:Utent no-2	Ŝablono:Vikipediisto no-2
Mudell:Kategorijamoħbija	Ŝablono:Kaŝita kategorio
Mudell:Dokumentazzjoni mudell	Ŝablono:Ŝablona navigado
Mudell:CcTLD	Ŝablono:Naciaj domajnoj de plej alta nivelo
Mudell:Div col	Ŝablono:Div col
Mudell:Klassifikazzjoni	Ŝablono:Steloj
Kategorija:Pittura	Kategorio:Pentrado
Mudell:TħassirKategorija	Ŝablono:Neforigenda kategorio
Kategorija:Pajjiżi mhux rikonoxxuti	Kategorio:Memdeklaritaj ŝtatoj
Mudell:Goal	Ŝablono:Golo
Mudell:Paġna utent	Ŝablono:Uzula paĝo
Mudell:Logo	Ŝablono:Emblemo
Mudell:Infobox Album	Ŝablono:Informkesto muzikalbumo
Mudell:Utent	Ŝablono:Uzanto2
Kategorija:Ajruporti fil-Vjetnam	Kategorio:Flughavenoj de Vietnamio
Mudell:Logħba futbol	Ŝablono:Tabelo futbalo
Mudell:Emerġenza-buttuna-tifi	Ŝablono:Butono por forbari robotojn
Mudell:Imdb	Ŝablono:IMDb nomo
Kategorija:Tuneżija	Kategorio:Tunizio
Mudell:It	Ŝablono:It
Mudell:Infobox Stadju	Ŝablono:Informkesto stadiono
Mudell:Wikibarijiet	Ŝablono:Vikinovaĵoj
Mudell:Rindirizz	Ŝablono:Alidirekto
Mudell:Kontra	Ŝablono:Kontraŭ
Mudell:Coord/link	Ŝablono:Koord/ligilo
Mudell:LTU	Ŝablono:LTU
Mudell:Utent SUL	Ŝablono:Uzanto SUL
Kategorija:Utenti ja-N	Kategorio:Vikipediisto ja-D
Mudell:Pdf	Ŝablono:PDFligilo
Kategorija:Twieldu fl-1903	Kategorio:Naskiĝintoj en 1903
Kategorija:Imperi	Kategorio:Imperioj
Kategorija:Twieldu fl-1925	Kategorio:Naskiĝintoj en 1925
Kategorija:Twieldu fl-1936	Kategorio:Naskiĝintoj en 1936
Kategorija:Twieldu fl-1916	Kategorio:Naskiĝintoj en 1916
Kategorija:Twieldu fl-1910	Kategorio:Naskiĝintoj en 1910
Kategorija:Twieldu fl-1939	Kategorio:Naskiĝintoj en 1939
Mudell:Utent it-0	Ŝablono:Vikipediisto it-0
Mudell:Siġra ġenealoġika/bidu	Ŝablono:Genealogia arbo/komenco
Mudell:Diżambigwazzjoni	Ŝablono:Apartigilo
Kategorija:1962	Kategorio:1962
Mudell:Ma sarx	Ŝablono:Ne farita
Mudell:QasamKat	Ŝablono:Svarmoplena kategorio
Mudell:Uk	Ŝablono:Uk
Kategorija:Mudelli infobox	Kategorio:Ŝablono:Informkesto
Mudell:Penmiss	Ŝablono:Misa punŝoto
Kategorija:Storja ta' l-isport	Kategorio:Historio de sporto
Kategorija:Futbol fi Spanja	Kategorio:Futbalo en Hispanio
Mudell:Pengoal	Ŝablono:Pungolo
Kategorija:Mietu fl-2013	Kategorio:Mortintoj en 2013
Mudell:Fb	Ŝablono:Fb
Kategorija:Twieldu fl-1938	Kategorio:Naskiĝintoj en 1938
Kategorija:Meta-mudelli tal-Wikipedija	Kategorio:Vikipedio:Porŝablonaj ŝablonoj
Mudell:Is	Ŝablono:Is
Mudell:Utent no-3	Ŝablono:Vikipediisto no-3
Kategorija:Mudelli ta' ikoni tal-lingwi	Kategorio:Ŝablono:Lingvo
Mudell:Infobox Filosfu	Ŝablono:Informkesto filozofo
Mudell:Hy	Ŝablono:Hy
Kategorija:Teoloġija	Kategorio:Teologio
Mudell:Infobox Organizzazzjoni	Ŝablono:Informkesto organizaĵo
Kategorija:1663	Kategorio:1663
Kategorija:Mietu fl-1663	Kategorio:Mortintoj en 1663
Mudell:Hr	Ŝablono:Hr
Mudell:Az	Ŝablono:Az
Kategorija:Arkitettura	Kategorio:Arkitekturo
Mudell:Nl	Ŝablono:Nl
Mudell:NATO	Ŝablono:NATO
Mudell:Utent it-2	Ŝablono:Vikipediisto it-2
Mudell:Lingwi	Ŝablono:Lingvokodo
Mudell:De	Ŝablono:De
Kategorija:Bliet tal-Italja	Kategorio:Komunumoj de Italio
Mudell:Età	Ŝablono:Aĝo
Mudell:Għoti tal-penalties	Ŝablono:Tabelo punŝoto
Mudell:Infobox Ċelebrità	Ŝablono:Informkesto homoj
Kategorija:1953	Kategorio:1953
Mudell:Lista ta' kapitali Ewropej skont ir-reġjun	Ŝablono:Eŭropaj ĉefurboj
Kategorija:Isqfijiet Kattoliċi Rumani	Kategorio:Romkatolikaj episkopoj
Mudell:Coord	Ŝablono:Koord
Kategorija:Twieldu fis-seklu 20	Kategorio:Naskiĝintoj en la 20-a jarcento
Kategorija:Twieldu fis-seklu 19	Kategorio:Naskiĝintoj en la 19-a jarcento
Kategorija:Twieldu fis-seklu 21	Kategorio:Naskiĝintoj en la 21-a jarcento
Kategorija:Twieldu fis-seklu 18	Kategorio:Naskiĝintoj en la 18-a jarcento
Kategorija:Twieldu fis-seklu 17	Kategorio:Naskiĝintoj en la 17-a jarcento
Kategorija:Twieldu fis-seklu 16	Kategorio:Naskiĝintoj en la 16-a jarcento
Kategorija:Twieldu fis-seklu 15	Kategorio:Naskiĝintoj en la 15-a jarcento
Kategorija:Futbolers Ivorjani	Kategorio:Eburbordaj futbalistoj
Mudell:Utent bg	Ŝablono:Vikipediisto bg
Kategorija:Mietu fl-1622	Kategorio:Mortintoj en 1622
Mudell:Ewropa	Ŝablono:Ŝtatoj en Eŭropo
Kategorija:Futbolers skont in-nazzjonalità	Kategorio:Futbalistoj laŭ landoj
Kategorija:Utenti yue	Kategorio:Vikipediisto zh-yue
Kategorija:Utenti az	Kategorio:Vikipediisto az
Kategorija:Utenti be	Kategorio:Vikipediisto be
Kategorija:Utenti hr	Kategorio:Vikipediisto hr
Kategorija:Utenti eo	Kategorio:Vikipediisto eo
Kategorija:Utenti fr	Kategorio:Vikipediisto fr
Kategorija:Utenti cy	Kategorio:Vikipediisto cy
Kategorija:Utenti id	Kategorio:Vikipediisto id
Kategorija:Utenti ga	Kategorio:Vikipediisto ga
Kategorija:Utenti ja	Kategorio:Vikipediisto ja
Kategorija:Utenti nn	Kategorio:Vikipediisto nn
Kategorija:Utenti pt	Kategorio:Vikipediisto pt
Kategorija:Utenti sv	Kategorio:Vikipediisto sv
Kategorija:Utenti fr-3	Kategorio:Vikipediisto fr-3
Kategorija:Utenti it-3	Kategorio:Vikipediisto it-3
Kategorija:Utenti no-3	Kategorio:Vikipediisto no-3
Kategorija:Utenti pl-3	Kategorio:Vikipediisto pl-3
Kategorija:Utenti da-1	Kategorio:Vikipediisto da-1
Kategorija:Utenti ga-1	Kategorio:Vikipediisto ga-1
Kategorija:Utenti mt-1	Kategorio:Vikipediisto mt-1
Kategorija:Utenti nl-1	Kategorio:Vikipediisto nl-1
Kategorija:Utenti tr-1	Kategorio:Vikipediisto tr-1
Kategorija:Utenti ar-1	Kategorio:Vikipediisto ar-1
Kategorija:Utenti id-4	Kategorio:Vikipediisto id-4
Kategorija:Utenti it-4	Kategorio:Vikipediisto it-4
Kategorija:Utenti pl-4	Kategorio:Vikipediisto pl-4
Kategorija:Utenti be-2	Kategorio:Vikipediisto be-2
Kategorija:Utenti da-2	Kategorio:Vikipediisto da-2
Kategorija:Utenti fr-2	Kategorio:Vikipediisto fr-2
Kategorija:Utenti it-2	Kategorio:Vikipediisto it-2
Kategorija:Utenti ja-2	Kategorio:Vikipediisto ja-2
Kategorija:Utenti nl-2	Kategorio:Vikipediisto nl-2
Kategorija:Utenti pl-2	Kategorio:Vikipediisto pl-2
Kategorija:Utenti tr-2	Kategorio:Vikipediisto tr-2
Kategorija:Utenti cs-N	Kategorio:Vikipediisto cs-D
Kategorija:Utenti fr-N	Kategorio:Vikipediisto fr-D
Kategorija:Utenti it-N	Kategorio:Vikipediisto it-D
Kategorija:Utenti nl-N	Kategorio:Vikipediisto nl-D
Kategorija:Utenti no-N	Kategorio:Vikipediisto no-D
Kategorija:Utenti ru-N	Kategorio:Vikipediisto ru-D
Kategorija:Divertiment	Kategorio:Distrado
Kategorija:Għall-wikifikazzjoni	Kategorio:Vikiigendaj artikoloj
Kategorija:UEFA	Kategorio:UEFA
Kategorija:Utenti af	Kategorio:Vikipediisto af
Kategorija:Utenti ar	Kategorio:Vikipediisto ar
Kategorija:Utenti bg	Kategorio:Vikipediisto bg
Kategorija:Utenti bg-1	Kategorio:Vikipediisto bg-1
Kategorija:Utenti bg-N	Kategorio:Vikipediisto bg-D
Kategorija:Mużiċisti Awstrijaċi	Kategorio:Aŭstraj muzikistoj
Kategorija:Utenti cs	Kategorio:Vikipediisto cs
Kategorija:Utenti da	Kategorio:Vikipediisto da
Kategorija:Provinċja ta' Quang Binh	Kategorio:Provinco Quang Binh
Kategorija:Utenti de	Kategorio:Vikipediisto de
Kategorija:Utenti de-2	Kategorio:Vikipediisto de-2
Kategorija:Utenti de-3	Kategorio:Vikipediisto de-3
Kategorija:Utenti de-4	Kategorio:Vikipediisto de-4
Kategorija:Utenti de-N	Kategorio:Vikipediisto de-D
Kategorija:Utenti el	Kategorio:Vikipediisto el
Kategorija:Utenti el-N	Kategorio:Vikipediisto el-D
Kategorija:Utenti en-3	Kategorio:Vikipediisto en-3
Kategorija:Utenti en-N	Kategorio:Vikipediisto en-D
Kategorija:Utenti eo-3	Kategorio:Vikipediisto eo-3
Kategorija:Utenti es	Kategorio:Vikipediisto es
Kategorija:Utenti es-1	Kategorio:Vikipediisto es-1
Mudell:Pajjiżi tal-Unjoni Ewropea	Ŝablono:Eŭropa Unio
Kategorija:Utenti es-2	Kategorio:Vikipediisto es-2
Kategorija:Utenti es-3	Kategorio:Vikipediisto es-3
Kategorija:Utenti es-N	Kategorio:Vikipediisto es-D
Kategorija:Utenti fa	Kategorio:Vikipediisto fa
Kategorija:Utenti fa-N	Kategorio:Vikipediisto fa-D
Kategorija:Utenti fi	Kategorio:Vikipediisto fi
Kategorija:Utenti fi-N	Kategorio:Vikipediisto fi-D
Kategorija:Utenti grc	Kategorio:Vikipediisto grc
Kategorija:Utenti grc-1	Kategorio:Vikipediisto grc-1
Kategorija:Utenti hu	Kategorio:Vikipediisto hu
Kategorija:Utenti hu-1	Kategorio:Vikipediisto hu-1
Kategorija:1452	Kategorio:1452
Kategorija:Mietu fl-1904	Kategorio:Mortintoj en 1904
Kategorija:Politiċi Veneżwelani	Kategorio:Venezuelaj politikistoj
Kategorija:Utenti pl-N	Kategorio:Vikipediisto pl-D
Kategorija:Utenti pt-1	Kategorio:Vikipediisto pt-1
Kategorija:Mietu fl-1852	Kategorio:Mortintoj en 1852
Kategorija:Mietu fl-1880	Kategorio:Mortintoj en 1880
Kategorija:Ġeometrija	Kategorio:Geometrio
Kategorija:Mietu fl-1942	Kategorio:Mortintoj en 1942
Kategorija:Klabbs tal-futbol stabbiliti fl-1899	Kategorio:Futbalteamoj fonditaj en 1899
Kategorija:Utenti it	Kategorio:Vikipediisto it
Kategorija:Utenti it-1	Kategorio:Vikipediisto it-1
Kategorija:Vulkani	Kategorio:Vulkanoj
Kategorija:Mietu fl-1564	Kategorio:Mortintoj en 1564
Kategorija:1564	Kategorio:1564
Kategorija:Provinċji tal-Vjetnam	Kategorio:Provincoj de Vjetnamio
Kategorija:1592	Kategorio:1592
Kategorija:Kompetizzjonijiet tal-futbol skont il-pajjiż	Kategorio:Futbalaj konkursoj laŭ landoj
Kategorija:Arti marzjali	Kategorio:Luktoarto
Mudell:Informazzjoni	Ŝablono:Informo por dosiero
Kategorija:Pitturi tar-Rinaxximent	Kategorio:Renesancaj pentristoj
Kategorija:Bijoloġi evoluzzjonarji	Kategorio:Evoluistoj
Kategorija:Knisja Kattolika Rumana	Kategorio:Romkatolika Eklezio
Kategorija:Mużiċisti Olandiżi	Kategorio:Nederlandaj muzikistoj
Kategorija:Kantanti Olandiżi	Kategorio:Nederlandaj kantistoj
Mudell:Klassifikazzjoni xjentifika	Ŝablono:Biologia klasifikado
Kategorija:Mietu fl-1794	Kategorio:Mortintoj en 1794
Kategorija:Mietu fl-1931	Kategorio:Mortintoj en 1931
Kategorija:Mietu fl-1827	Kategorio:Mortintoj en 1827
Kategorija:Utenti ru-1	Kategorio:Vikipediisto ru-1
Mudell:TOClimit	Ŝablono:LimigitaIndekso
Wikipedija:Babel	Vikipedio:Babelejo
Kategorija:Mietu fl-1829	Kategorio:Mortintoj en 1829
Kategorija:Mietu fl-1778	Kategorio:Mortintoj en 1778
Kategorija:Mietu fl-1547	Kategorio:Mortintoj en 1547
Kategorija:Abbozzi tal-kimika	Kategorio:Ĝermoj pri kemio
Kategorija:1687	Kategorio:1687
Kategorija:1614	Kategorio:1614
Kategorija:1612	Kategorio:1612
Kategorija:Mietu fl-1612	Kategorio:Mortintoj en 1612
Kategorija:Mietu fl-1655	Kategorio:Mortintoj en 1655
Kategorija:Mietu fl-1616	Kategorio:Mortintoj en 1616
Kategorija:Mietu fl-1614	Kategorio:Mortintoj en 1614
Kategorija:Futbolers Olandiżi	Kategorio:Nederlandaj futbalistoj
Kategorija:1655	Kategorio:1655
Kategorija:Utenti mt	Kategorio:Vikipediisto mt
Kategorija:Mietu fl-1994	Kategorio:Mortintoj en 1994
Kategorija:Twieldu fl-1906	Kategorio:Naskiĝintoj en 1906
Kategorija:Kompożituri tal-opra	Kategorio:Operkomponistoj
Kategorija:Ibħra	Kategorio:Maroj
Kategorija:Bliet tal-Polonja	Kategorio:Urboj de Pollando
Kategorija:Kompożituri skont in-nazzjonalità	Kategorio:Komponistoj laŭ landoj
Kategorija:Atturi skont in-nazzjonalità	Kategorio:Aktoroj laŭ landoj
Kategorija:Mietu fl-2009	Kategorio:Mortintoj en 2009
Kategorija:Sistema solari	Kategorio:Sunsistemo
Trasformata ta' Fourier	Konverto de Fourier
Mudell:Coord/dms2dec	Ŝablono:Koord/gmsaldek
Kategorija:Entomoloġija	Kategorio:Entomologio
Mudell:PD-old-70	Ŝablono:Bildo malnova, pli ol 70 jaroj
Kategorija:Carnivora	Kategorio:Karnomanĝuloj
Kategorija:Klabbs tal-futbol Torok	Kategorio:Turkaj futbalteamoj
Kategorija:Mietu fl-1321	Kategorio:Mortintoj en 1321
Kategorija:Mietu fl-2005	Kategorio:Mortintoj en 2005
Kategorija:Twieldu fl-1983	Kategorio:Naskiĝintoj en 1983
Kategorija:Mietu fl-1592	Kategorio:Mortintoj en 1592
Kategorija:Mużiċisti Bulgari	Kategorio:Bulgaraj muzikistoj
Kategorija:Mietu fl-1991	Kategorio:Mortintoj en 1991
Kategorija:Mietu fl-1992	Kategorio:Mortintoj en 1992
Kategorija:Twieldu fl-1992	Kategorio:Naskiĝintoj en 1992
Kategorija:Twieldu fl-1970	Kategorio:Naskiĝintoj en 1970
Kategorija:Mietu fl-1980	Kategorio:Mortintoj en 1980
Kategorija:Mietu fl-2008	Kategorio:Mortintoj en 2008
Kategorija:Mietu fl-1966	Kategorio:Mortintoj en 1966
Kategorija:Mietu fl-1946	Kategorio:Mortintoj en 1946
Kategorija:Mietu fl-1938	Kategorio:Mortintoj en 1938
Kategorija:Twieldu fl-1984	Kategorio:Naskiĝintoj en 1984
Kategorija:Mietu fl-1962	Kategorio:Mortintoj en 1962
Kategorija:Twieldu fl-1990	Kategorio:Naskiĝintoj en 1990
Kategorija:Mietu fl-1934	Kategorio:Mortintoj en 1934
Kategorija:Twieldu fl-1974	Kategorio:Naskiĝintoj en 1974
Kategorija:Mietu fl-1947	Kategorio:Mortintoj en 1947
Kategorija:Mietu fl-2007	Kategorio:Mortintoj en 2007
Kategorija:Twieldu fl-1965	Kategorio:Naskiĝintoj en 1965
Kategorija:Twieldu fl-1940	Kategorio:Naskiĝintoj en 1940
Kategorija:Twieldu fl-1898	Kategorio:Naskiĝintoj en 1898
Kategorija:Twieldu fl-1867	Kategorio:Naskiĝintoj en 1867
Kategorija:Twieldu fl-1871	Kategorio:Naskiĝintoj en 1871
Kategorija:Twieldu fl-1862	Kategorio:Naskiĝintoj en 1862
Kategorija:Twieldu fl-1977	Kategorio:Naskiĝintoj en 1977
Kategorija:Twieldu fl-1899	Kategorio:Naskiĝintoj en 1899
Kategorija:1844	Kategorio:1844
Kategorija:Twieldu fl-1931	Kategorio:Naskiĝintoj en 1931
Kategorija:Twieldu fl-1915	Kategorio:Naskiĝintoj en 1915
Kategorija:Twieldu fl-1929	Kategorio:Naskiĝintoj en 1929
Kategorija:Poeti Spanjoli	Kategorio:Hispanaj poetoj
Kategorija:Twieldu fl-1954	Kategorio:Naskiĝintoj en 1954
Kategorija:Xjenza soċjali	Kategorio:Socia scienco
Kategorija:Bjelorussja	Kategorio:Belorusio
Kategorija:Twieldu fl-1960	Kategorio:Naskiĝintoj en 1960
Kategorija:Kantanti Kanadiżi	Kategorio:Kanadaj kantistoj
Kategorija:Mietu fl-1830	Kategorio:Mortintoj en 1830
Kategorija:Ewropa tal-Lvant	Kategorio:Orienta Eŭropo
Kategorija:Mietu fl-1993	Kategorio:Mortintoj en 1993
Kategorija:Pajjiżi tal-Afrika	Kategorio:Afrikaj landoj
Kategorija:Mietu fl-1998	Kategorio:Mortintoj en 1998
Kategorija:Twieldu fl-1170	Kategorio:Naskiĝintoj en 1170
Kategorija:Twieldu fl-1182	Kategorio:Naskiĝintoj en 1182
Kategorija:Twieldu fl-1185	Kategorio:Naskiĝintoj en 1185
Kategorija:1226	Kategorio:1226
Kategorija:Mietu fl-1226	Kategorio:Mortintoj en 1226
Kategorija:Mietu fl-1227	Kategorio:Mortintoj en 1227
Kategorija:Twieldu fl-1951	Kategorio:Naskiĝintoj en 1951
Kategorija:Mietu fl-1882	Kategorio:Mortintoj en 1882
Kategorija:Mietu fl-1883	Kategorio:Mortintoj en 1883
Kategorija:Twieldu fl-1265	Kategorio:Naskiĝintoj en 1265
Kategorija:Mietu fl-1296	Kategorio:Mortintoj en 1296
Mudell:Utent da-3	Ŝablono:Vikipediisto da-3
Didelphimorphia	Didelfuloj
Mudell:Utent ja-2	Ŝablono:Vikipediisto ja-2
Kategorija:1528	Kategorio:1528
Kategorija:1405	Kategorio:1405
Mudell:Utent ru-2	Ŝablono:Vikipediisto ru-2
Kategorija:Twieldu fl-1405	Kategorio:Naskiĝintoj en 1405
Kategorija:1522	Kategorio:1522
Kategorija:1419	Kategorio:1419
Mudell:Lv	Ŝablono:Lv
Kategorija:1508	Kategorio:1508
Kategorija:1519	Kategorio:1519
Kategorija:Futbol fil-Polonja	Kategorio:Futbalo en Pollando
Kategorija:Twieldu fl-1452	Kategorio:Naskiĝintoj en 1452
Kategorija:1466	Kategorio:1466
Kategorija:1468	Kategorio:1468
Kategorija:Mietu fl-1468	Kategorio:Mortintoj en 1468
Kategorija:1471	Kategorio:1471
Kategorija:Twieldu fl-1471	Kategorio:Naskiĝintoj en 1471
Mudell:Skwadra Taljana Tazza tad-Dinja tal-Futbol 2010	Ŝablono:Itala nacia teamo - Futbala Mondpokalo 2010
Kategorija:1478	Kategorio:1478
Kategorija:Twieldu fl-1478	Kategorio:Naskiĝintoj en 1478
Kategorija:Twieldu fl-1480	Kategorio:Naskiĝintoj en 1480
Kategorija:1483	Kategorio:1483
Kategorija:1494	Kategorio:1494
Kategorija:Twieldu fl-1494	Kategorio:Naskiĝintoj en 1494
Kategorija:Utenti ru	Kategorio:Vikipediisto ru
Kategorija:Utenti ru-2	Kategorio:Vikipediisto ru-2
Kategorija:Utenti ru-3	Kategorio:Vikipediisto ru-3
Kategorija:Twieldu fl-1508	Kategorio:Naskiĝintoj en 1508
Kategorija:Twieldu fl-1515	Kategorio:Naskiĝintoj en 1515
Kategorija:Mietu fl-1519	Kategorio:Mortintoj en 1519
Kategorija:1532	Kategorio:1532
Kategorija:Twieldu fl-1532	Kategorio:Naskiĝintoj en 1532
Kategorija:Twieldu fl-1533	Kategorio:Naskiĝintoj en 1533
Kategorija:Mietu fl-1535	Kategorio:Mortintoj en 1535
Kategorija:Mietu fl-1539	Kategorio:Mortintoj en 1539
Kategorija:1542	Kategorio:1542
Kategorija:Utenti sv-3	Kategorio:Vikipediisto sv-3
Kategorija:1547	Kategorio:1547
Kategorija:Utenti sv-N	Kategorio:Vikipediisto sv-D
Kategorija:Twieldu fl-1552	Kategorio:Naskiĝintoj en 1552
Kategorija:1562	Kategorio:1562
Kategorija:Twieldu fl-1564	Kategorio:Naskiĝintoj en 1564
Kategorija:1567	Kategorio:1567
Kategorija:1568	Kategorio:1568
Kategorija:Mietu fl-1568	Kategorio:Mortintoj en 1568
Kategorija:1573	Kategorio:1573
Kategorija:Twieldu fl-1573	Kategorio:Naskiĝintoj en 1573
Kategorija:1581	Kategorio:1581
Kategorija:Twieldu fl-1582	Kategorio:Naskiĝintoj en 1582
Kategorija:1591	Kategorio:1591
Kategorija:1593	Kategorio:1593
Kategorija:1597	Kategorio:1597
Kategorija:1600	Kategorio:1600
Kategorija:1616	Kategorio:1616
Kategorija:1621	Kategorio:1621
Kategorija:Utenti tr	Kategorio:Vikipediisto tr
Kategorija:Mietu fl-1621	Kategorio:Mortintoj en 1621
Kategorija:1625	Kategorio:1625
Kategorija:Mietu fl-1625	Kategorio:Mortintoj en 1625
Kategorija:Utenti uk-4	Kategorio:Vikipediisto uk-4
Kategorija:1636	Kategorio:1636
Kategorija:1643	Kategorio:1643
Kategorija:Mietu fl-1643	Kategorio:Mortintoj en 1643
Kategorija:1654	Kategorio:1654
Kategorija:Twieldu fl-1654	Kategorio:Naskiĝintoj en 1654
Kategorija:1656	Kategorio:1656
Kategorija:Mietu fl-1656	Kategorio:Mortintoj en 1656
Kategorija:1660	Kategorio:1660
Kategorija:1667	Kategorio:1667
Kategorija:Mietu fl-1667	Kategorio:Mortintoj en 1667
Kategorija:1670	Kategorio:1670
Kategorija:Mietu fl-1670	Kategorio:Mortintoj en 1670
Kategorija:1675	Kategorio:1675
Kategorija:1685	Kategorio:1685
Kategorija:Twieldu fl-1687	Kategorio:Naskiĝintoj en 1687
Mudell:En	Ŝablono:En
Kategorija:1694	Kategorio:1694
Kategorija:1695	Kategorio:1695
Kategorija:Twieldu fl-1696	Kategorio:Naskiĝintoj en 1696
Kategorija:Twieldu fl-1699	Kategorio:Naskiĝintoj en 1699
Kategorija:1700	Kategorio:1700
Kategorija:Mietu fl-1705	Kategorio:Mortintoj en 1705
Kategorija:1709	Kategorio:1709
Kategorija:1710	Kategorio:1710
Kategorija:Twieldu fl-1715	Kategorio:Naskiĝintoj en 1715
Kategorija:Twieldu fl-1724	Kategorio:Naskiĝintoj en 1724
Mudell:Spazji	Ŝablono:Spacoj
Kategorija:Mużiċisti	Kategorio:Muzikistoj
Kategorija:Logħob ta' abilità mentali	Kategorio:Logikaj enigmoj
Kategorija:Twieldu fl-1881	Kategorio:Naskiĝintoj en 1881
Mudell:Da	Ŝablono:Da
Kategorija:Kantanti Irlandiżi	Kategorio:Irlandaj kantistoj
Mudell:Skwadra Ġermaniża Tazza tad-Dinja tal-Futbol 2010	Ŝablono:Germana nacia teamo - Futbala Mondpokalo 2010
Mudell:Skwadra Ġermaniża Kampjonati Ewropej tal-Futbol 2008	Ŝablono:Germana nacia teamo - Eŭropa Futbal-Ĉampionado 2008
Kategorija:Twieldu fl-1944	Kategorio:Naskiĝintoj en 1944
Kategorija:Twieldu fl-1932	Kategorio:Naskiĝintoj en 1932
Kategorija:Twieldu fl-1934	Kategorio:Naskiĝintoj en 1934
Kategorija:Twieldu fl-1935	Kategorio:Naskiĝintoj en 1935
Kategorija:Twieldu fl-1941	Kategorio:Naskiĝintoj en 1941
Kategorija:Matematiċi Russi	Kategorio:Matematikistoj de Rusio
Kategorija:Soċjoloġija	Kategorio:Sociologio
Kategorija:Twieldu fis-seklu 12	Kategorio:Naskiĝintoj en la 12-a jarcento
Kategorija:Twieldu fis-seklu 13	Kategorio:Naskiĝintoj en la 13-a jarcento
Kategorija:Twieldu fis-seklu 14	Kategorio:Naskiĝintoj en la 14-a jarcento
Kategorija:Twieldu fl-1466	Kategorio:Naskiĝintoj en 1466
Kategorija:Twieldu fl-1483	Kategorio:Naskiĝintoj en 1483
Kategorija:Twieldu fl-1542	Kategorio:Naskiĝintoj en 1542
Kategorija:Twieldu fl-1547	Kategorio:Naskiĝintoj en 1547
Kategorija:Twieldu fl-1562	Kategorio:Naskiĝintoj en 1562
Kategorija:Twieldu fl-1567	Kategorio:Naskiĝintoj en 1567
Kategorija:Twieldu fl-1581	Kategorio:Naskiĝintoj en 1581
Kategorija:Twieldu fl-1591	Kategorio:Naskiĝintoj en 1591
Kategorija:Twieldu fl-1593	Kategorio:Naskiĝintoj en 1593
Kategorija:Twieldu fl-1600	Kategorio:Naskiĝintoj en 1600
Kategorija:Twieldu fl-1636	Kategorio:Naskiĝintoj en 1636
Kategorija:Twieldu fl-1643	Kategorio:Naskiĝintoj en 1643
Kategorija:Twieldu fl-1667	Kategorio:Naskiĝintoj en 1667
Kategorija:Twieldu fl-1675	Kategorio:Naskiĝintoj en 1675
Kategorija:Twieldu fl-1685	Kategorio:Naskiĝintoj en 1685
Kategorija:Twieldu fl-1694	Kategorio:Naskiĝintoj en 1694
Kategorija:Twieldu fl-1695	Kategorio:Naskiĝintoj en 1695
Kategorija:Twieldu fl-1700	Kategorio:Naskiĝintoj en 1700
Kategorija:Twieldu fl-1710	Kategorio:Naskiĝintoj en 1710
Kategorija:Twieldu fl-1744	Kategorio:Naskiĝintoj en 1744
Kategorija:Twieldu fl-1748	Kategorio:Naskiĝintoj en 1748
Kategorija:Twieldu fl-1749	Kategorio:Naskiĝintoj en 1749
Kategorija:Twieldu fl-1756	Kategorio:Naskiĝintoj en 1756
Kategorija:Twieldu fl-1758	Kategorio:Naskiĝintoj en 1758
Kategorija:Twieldu fl-1759	Kategorio:Naskiĝintoj en 1759
Kategorija:Twieldu fl-1764	Kategorio:Naskiĝintoj en 1764
Kategorija:Twieldu fl-1767	Kategorio:Naskiĝintoj en 1767
Kategorija:Twieldu fl-1769	Kategorio:Naskiĝintoj en 1769
Kategorija:Twieldu fl-1770	Kategorio:Naskiĝintoj en 1770
Kategorija:Twieldu fl-1772	Kategorio:Naskiĝintoj en 1772
Kategorija:Twieldu fl-1773	Kategorio:Naskiĝintoj en 1773
Kategorija:Twieldu fl-1779	Kategorio:Naskiĝintoj en 1779
Kategorija:Twieldu fl-1786	Kategorio:Naskiĝintoj en 1786
Kategorija:Twieldu fl-1797	Kategorio:Naskiĝintoj en 1797
Kategorija:Twieldu fl-1801	Kategorio:Naskiĝintoj en 1801
Kategorija:Twieldu fl-1803	Kategorio:Naskiĝintoj en 1803
Kategorija:Twieldu fl-1808	Kategorio:Naskiĝintoj en 1808
Kategorija:Twieldu fl-1809	Kategorio:Naskiĝintoj en 1809
Kategorija:Twieldu fl-1813	Kategorio:Naskiĝintoj en 1813
Kategorija:Twieldu fl-1815	Kategorio:Naskiĝintoj en 1815
Kategorija:Twieldu fl-1818	Kategorio:Naskiĝintoj en 1818
Kategorija:Twieldu fl-1821	Kategorio:Naskiĝintoj en 1821
Kategorija:Twieldu fl-1822	Kategorio:Naskiĝintoj en 1822
Kategorija:Twieldu fl-1824	Kategorio:Naskiĝintoj en 1824
Kategorija:Twieldu fl-1840	Kategorio:Naskiĝintoj en 1840
Kategorija:Twieldu fl-1841	Kategorio:Naskiĝintoj en 1841
Kategorija:Twieldu fl-1844	Kategorio:Naskiĝintoj en 1844
Kategorija:Twieldu fl-1846	Kategorio:Naskiĝintoj en 1846
Kategorija:Twieldu fl-1847	Kategorio:Naskiĝintoj en 1847
Kategorija:Twieldu fl-1848	Kategorio:Naskiĝintoj en 1848
Kategorija:Twieldu fl-1849	Kategorio:Naskiĝintoj en 1849
Kategorija:Twieldu fl-1853	Kategorio:Naskiĝintoj en 1853
Kategorija:Twieldu fl-1854	Kategorio:Naskiĝintoj en 1854
Kategorija:Twieldu fl-1859	Kategorio:Naskiĝintoj en 1859
Kategorija:Twieldu fl-1860	Kategorio:Naskiĝintoj en 1860
Kategorija:Twieldu fl-1861	Kategorio:Naskiĝintoj en 1861
Kategorija:Twieldu fl-1864	Kategorio:Naskiĝintoj en 1864
Kategorija:Twieldu fl-1866	Kategorio:Naskiĝintoj en 1866
Kategorija:Twieldu fl-1869	Kategorio:Naskiĝintoj en 1869
Kategorija:Twieldu fl-1873	Kategorio:Naskiĝintoj en 1873
Kategorija:Twieldu fl-1874	Kategorio:Naskiĝintoj en 1874
Kategorija:Twieldu fl-1876	Kategorio:Naskiĝintoj en 1876
Kategorija:Twieldu fl-1877	Kategorio:Naskiĝintoj en 1877
Kategorija:Twieldu fl-1880	Kategorio:Naskiĝintoj en 1880
Kategorija:Twieldu fl-1883	Kategorio:Naskiĝintoj en 1883
Kategorija:Twieldu fl-1884	Kategorio:Naskiĝintoj en 1884
Kategorija:Twieldu fl-1885	Kategorio:Naskiĝintoj en 1885
Kategorija:Twieldu fl-1886	Kategorio:Naskiĝintoj en 1886
Kategorija:Twieldu fl-1887	Kategorio:Naskiĝintoj en 1887
Kategorija:Twieldu fl-1889	Kategorio:Naskiĝintoj en 1889
Kategorija:Twieldu fl-1890	Kategorio:Naskiĝintoj en 1890
Kategorija:Twieldu fl-1891	Kategorio:Naskiĝintoj en 1891
Kategorija:Twieldu fl-1892	Kategorio:Naskiĝintoj en 1892
Kategorija:Twieldu fl-1893	Kategorio:Naskiĝintoj en 1893
Kategorija:Twieldu fl-1894	Kategorio:Naskiĝintoj en 1894
Kategorija:Twieldu fl-1895	Kategorio:Naskiĝintoj en 1895
Kategorija:Twieldu fl-1896	Kategorio:Naskiĝintoj en 1896
Kategorija:Twieldu fl-1897	Kategorio:Naskiĝintoj en 1897
Kategorija:Twieldu fl-1900	Kategorio:Naskiĝintoj en 1900
Kategorija:Twieldu fl-1901	Kategorio:Naskiĝintoj en 1901
Kategorija:Twieldu fl-1902	Kategorio:Naskiĝintoj en 1902
Kategorija:Twieldu fl-1904	Kategorio:Naskiĝintoj en 1904
Kategorija:Twieldu fl-1905	Kategorio:Naskiĝintoj en 1905
Kategorija:Twieldu fl-1907	Kategorio:Naskiĝintoj en 1907
Kategorija:Twieldu fl-1908	Kategorio:Naskiĝintoj en 1908
Kategorija:Twieldu fl-1909	Kategorio:Naskiĝintoj en 1909
Kategorija:Twieldu fl-1912	Kategorio:Naskiĝintoj en 1912
Kategorija:Twieldu fl-1913	Kategorio:Naskiĝintoj en 1913
Kategorija:Twieldu fl-1914	Kategorio:Naskiĝintoj en 1914
Kategorija:Twieldu fl-1917	Kategorio:Naskiĝintoj en 1917
Kategorija:Twieldu fl-1918	Kategorio:Naskiĝintoj en 1918
Kategorija:Twieldu fl-1919	Kategorio:Naskiĝintoj en 1919
Kategorija:Twieldu fl-1922	Kategorio:Naskiĝintoj en 1922
Kategorija:Twieldu fl-1923	Kategorio:Naskiĝintoj en 1923
Kategorija:Twieldu fl-1927	Kategorio:Naskiĝintoj en 1927
Kategorija:Twieldu fl-1928	Kategorio:Naskiĝintoj en 1928
Kategorija:Twieldu fl-1942	Kategorio:Naskiĝintoj en 1942
Kategorija:Twieldu fl-1943	Kategorio:Naskiĝintoj en 1943
Kategorija:Twieldu fl-1945	Kategorio:Naskiĝintoj en 1945
Kategorija:Twieldu fl-1947	Kategorio:Naskiĝintoj en 1947
Kategorija:Twieldu fl-1949	Kategorio:Naskiĝintoj en 1949
Kategorija:Twieldu fl-1952	Kategorio:Naskiĝintoj en 1952
Kategorija:Twieldu fl-1953	Kategorio:Naskiĝintoj en 1953
Kategorija:Twieldu fl-1957	Kategorio:Naskiĝintoj en 1957
Kategorija:Twieldu fl-1958	Kategorio:Naskiĝintoj en 1958
Kategorija:Twieldu fl-1959	Kategorio:Naskiĝintoj en 1959
Kategorija:Twieldu fl-1961	Kategorio:Naskiĝintoj en 1961
Kategorija:Twieldu fl-1962	Kategorio:Naskiĝintoj en 1962
Kategorija:Twieldu fl-1966	Kategorio:Naskiĝintoj en 1966
Kategorija:Twieldu fl-1967	Kategorio:Naskiĝintoj en 1967
Kategorija:Twieldu fl-1968	Kategorio:Naskiĝintoj en 1968
Kategorija:Twieldu fl-1969	Kategorio:Naskiĝintoj en 1969
Kategorija:Twieldu fl-1971	Kategorio:Naskiĝintoj en 1971
Kategorija:Twieldu fl-1972	Kategorio:Naskiĝintoj en 1972
Kategorija:Twieldu fl-1973	Kategorio:Naskiĝintoj en 1973
Kategorija:Twieldu fl-1975	Kategorio:Naskiĝintoj en 1975
Kategorija:Twieldu fl-1976	Kategorio:Naskiĝintoj en 1976
Kategorija:Twieldu fl-1978	Kategorio:Naskiĝintoj en 1978
Kategorija:Twieldu fl-1979	Kategorio:Naskiĝintoj en 1979
Kategorija:Twieldu fl-1980	Kategorio:Naskiĝintoj en 1980
Kategorija:Twieldu fl-1981	Kategorio:Naskiĝintoj en 1981
Kategorija:Twieldu fl-1982	Kategorio:Naskiĝintoj en 1982
Kategorija:Twieldu fl-1985	Kategorio:Naskiĝintoj en 1985
Kategorija:Twieldu fl-1986	Kategorio:Naskiĝintoj en 1986
Kategorija:Twieldu fl-1987	Kategorio:Naskiĝintoj en 1987
Kategorija:Twieldu fl-1988	Kategorio:Naskiĝintoj en 1988
Kategorija:Twieldu fl-1989	Kategorio:Naskiĝintoj en 1989
Kategorija:Twieldu fl-1991	Kategorio:Naskiĝintoj en 1991
Kategorija:Twieldu fl-1993	Kategorio:Naskiĝintoj en 1993
Kategorija:Twieldu fl-1994	Kategorio:Naskiĝintoj en 1994
Kategorija:Twieldu fl-1995	Kategorio:Naskiĝintoj en 1995
Kategorija:Twieldu fl-1996	Kategorio:Naskiĝintoj en 1996
Kategorija:Twieldu fl-1997	Kategorio:Naskiĝintoj en 1997
Kategorija:Twieldu fl-1999	Kategorio:Naskiĝintoj en 1999
Kategorija:Twieldu fl-2000	Kategorio:Naskiĝintoj en 2000
Kategorija:1715	Kategorio:1715
Kategorija:1797	Kategorio:1797
Kategorija:1787	Kategorio:1787
Kategorija:1539	Kategorio:1539
Kategorija:Seklu 17	Kategorio:17-a jarcento
Kategorija:Proġetti tal-Wikimedia	Kategorio:Projektoj de la Fondaĵo Vikimedio
Mudell:Bar percent	Ŝablono:Strikesto/procentoj
Kategorija:2014	Kategorio:2014
Mudell:Skwadra Brażiljana Tazza tad-Dinja tal-Futbol 2010	Ŝablono:Brazila nacia teamo - Futbala Mondpokalo 2010
Mudell:Utent sv-3	Ŝablono:Vikipediisto sv-3
Mudell:Fr	Ŝablono:Fr
Kategorija:1515	Kategorio:1515
Mudell:Twitter	Ŝablono:Twitter
Kategorija:Mietu fl-1522	Kategorio:Mortintoj en 1522
Kategorija:Portali	Kategorio:Vikipedio:Portaloj
Kategorija:Mietu fl-1528	Kategorio:Mortintoj en 1528
Kategorija:1533	Kategorio:1533
Kategorija:1535	Kategorio:1535
Kategorija:1546	Kategorio:1546
Kategorija:1552	Kategorio:1552
Kategorija:1580	Kategorio:1580
Kategorija:Mietu fl-1580	Kategorio:Mortintoj en 1580
Kategorija:1582	Kategorio:1582
Kategorija:1595	Kategorio:1595
Mudell:Utent af-3	Ŝablono:Vikipediisto af-3
Kategorija:1622	Kategorio:1622
Kategorija:1642	Kategorio:1642
Kategorija:Mietu fl-1642	Kategorio:Mortintoj en 1642
Kategorija:Mietu fl-1660	Kategorio:Mortintoj en 1660
Kategorija:1696	Kategorio:1696
Kategorija:1699	Kategorio:1699
Kategorija:1705	Kategorio:1705
Kategorija:1726	Kategorio:1726
Kategorija:Mietu fl-1726	Kategorio:Mortintoj en 1726
Kategorija:Mietu fl-1727	Kategorio:Mortintoj en 1727
Marie Louise Coleiro Preca	Marie Louise Coleiro Preca
Kategorija:Mietu fl-1748	Kategorio:Mortintoj en 1748
Kategorija:Mietu fl-1757	Kategorio:Mortintoj en 1757
Kategorija:Mietu fl-1759	Kategorio:Mortintoj en 1759
Kategorija:Mietu fl-1760	Kategorio:Mortintoj en 1760
Kategorija:1764	Kategorio:1764
Kategorija:1767	Kategorio:1767
Kategorija:1769	Kategorio:1769
Kategorija:Mietu fl-1772	Kategorio:Mortintoj en 1772
Kategorija:1779	Kategorio:1779
Kategorija:Mietu fl-1782	Kategorio:Mortintoj en 1782
Kategorija:Mietu fl-1787	Kategorio:Mortintoj en 1787
Kategorija:Mietu fl-1789	Kategorio:Mortintoj en 1789
Kategorija:Mietu fl-1790	Kategorio:Mortintoj en 1790
Kategorija:1778	Kategorio:1778
Mudell:Artiklu prinċipali	Ŝablono:Ĉefartikolo
Mudell:Coord/dec2dms/dm	Ŝablono:Koord/dekalgms/gm
Mudell:Plejers fit-tim tal-futbol/tmiem	Ŝablono:Fs end
Kategorija:Avvenimenti sportivi	Kategorio:Sportaj eventoj
Mudell:Plejers fit-tim tal-futbol/bidu	Ŝablono:Fs start
Kategorija:It-Tieni Gwerra Dinjija	Kategorio:Dua mondmilito
Kategorija:L-Ewwel Gwerra Dinjija	Kategorio:Unua mondmilito
Kategorija:Logħob tal-mejda	Kategorio:Tabulludoj
Kategorija:Mudelli ta' ċitazzjoni tas-sorsi	Kategorio:Citŝablonoj
Mudell:PD-utent	Ŝablono:PD-mem
Kategorija:Kittieba Spanjoli	Kategorio:Hispanaj verkistoj
Kategorija:Klabbs tal-futbol Bjelorussi	Kategorio:Belorusaj futbalteamoj
Kategorija:Klabbs tal-futbol stabbiliti skont is-sena	Kategorio:Futbalteamoj fonditaj laŭ jarcento
Mudell:Cquote	Ŝablono:Citaĵo1
Kategorija:Mietu fl-1937	Kategorio:Mortintoj en 1937
Kategorija:Mietu fl-1950	Kategorio:Mortintoj en 1950
Kategorija:Angola	Kategorio:Angolo
Kategorija:Libja	Kategorio:Libio
Kategorija:Marokk	Kategorio:Maroko
Kategorija:1480	Kategorio:1480
Kategorija:Mietu fl-1595	Kategorio:Mortintoj en 1595
Kategorija:Mietu fl-1597	Kategorio:Mortintoj en 1597
Kategorija:1610	Kategorio:1610
Kategorija:Mietu fl-1610	Kategorio:Mortintoj en 1610
Mudell:Kaxxa ġenb	Ŝablono:Flanka kesto
Kategorija:Mietu fl-2011	Kategorio:Mortintoj en 2011
Kategorija:Kantanti Taljani	Kategorio:Italaj kantistoj
Kategorija:Mietu fl-1546	Kategorio:Mortintoj en 1546
Kategorija:1724	Kategorio:1724
Kategorija:1748	Kategorio:1748
Kategorija:1749	Kategorio:1749
Kategorija:1750	Kategorio:1750
Kategorija:Mietu fl-1750	Kategorio:Mortintoj en 1750
Kategorija:1756	Kategorio:1756
Kategorija:1757	Kategorio:1757
Kategorija:1758	Kategorio:1758
Kategorija:1759	Kategorio:1759
Kategorija:1760	Kategorio:1760
Kategorija:1770	Kategorio:1770
Kategorija:1772	Kategorio:1772
Kategorija:1773	Kategorio:1773
Kategorija:1782	Kategorio:1782
Kategorija:1786	Kategorio:1786
Kategorija:1791	Kategorio:1791
Kategorija:Mietu fl-1791	Kategorio:Mortintoj en 1791
Kategorija:1792	Kategorio:1792
Kategorija:Mietu fl-1792	Kategorio:Mortintoj en 1792
Kategorija:1794	Kategorio:1794
Kategorija:1801	Kategorio:1801
Kategorija:1803	Kategorio:1803
Kategorija:1804	Kategorio:1804
Kategorija:Mietu fl-1804	Kategorio:Mortintoj en 1804
Kategorija:1807	Kategorio:1807
Kategorija:Mietu fl-1807	Kategorio:Mortintoj en 1807
Kategorija:1809	Kategorio:1809
Kategorija:1813	Kategorio:1813
Kategorija:1815	Kategorio:1815
Kategorija:1818	Kategorio:1818
Kategorija:Mietu fl-1818	Kategorio:Mortintoj en 1818
Kategorija:Mietu fl-1821	Kategorio:Mortintoj en 1821
Kategorija:1827	Kategorio:1827
Kategorija:Mietu fl-1828	Kategorio:Mortintoj en 1828
Kategorija:1830	Kategorio:1830
Kategorija:Mietu fl-1832	Kategorio:Mortintoj en 1832
Kategorija:1835	Kategorio:1835
Kategorija:1840	Kategorio:1840
Kategorija:1842	Kategorio:1842
Kategorija:Mietu fl-1842	Kategorio:Mortintoj en 1842
Kategorija:1846	Kategorio:1846
Kategorija:1847	Kategorio:1847
Kategorija:Mietu fl-1847	Kategorio:Mortintoj en 1847
Kategorija:1848	Kategorio:1848
Kategorija:1849	Kategorio:1849
Kategorija:1852	Kategorio:1852
Kategorija:1853	Kategorio:1853
Kategorija:1854	Kategorio:1854
Kategorija:1859	Kategorio:1859
Kategorija:Mietu fl-1859	Kategorio:Mortintoj en 1859
Kategorija:1860	Kategorio:1860
Kategorija:1861	Kategorio:1861
Kategorija:Mietu fl-1861	Kategorio:Mortintoj en 1861
Kategorija:1862	Kategorio:1862
Kategorija:1864	Kategorio:1864
Kategorija:1866	Kategorio:1866
Kategorija:1869	Kategorio:1869
Kategorija:Mietu fl-1869	Kategorio:Mortintoj en 1869
Kategorija:1870	Kategorio:1870
Kategorija:1871	Kategorio:1871
Kategorija:1872	Kategorio:1872
Kategorija:Mietu fl-1873	Kategorio:Mortintoj en 1873
Kategorija:1874	Kategorio:1874
Kategorija:1875	Kategorio:1875
Kategorija:1876	Kategorio:1876
Kategorija:1877	Kategorio:1877
Kategorija:1879	Kategorio:1879
Kategorija:1880	Kategorio:1880
Kategorija:1881	Kategorio:1881
Kategorija:1882	Kategorio:1882
Kategorija:1883	Kategorio:1883
Kategorija:1884	Kategorio:1884
Kategorija:1885	Kategorio:1885
Kategorija:1886	Kategorio:1886
Kategorija:1887	Kategorio:1887
Kategorija:1889	Kategorio:1889
Kategorija:1890	Kategorio:1890
Kategorija:Mietu fl-1890	Kategorio:Mortintoj en 1890
Kategorija:1891	Kategorio:1891
Kategorija:1892	Kategorio:1892
Kategorija:1893	Kategorio:1893
Kategorija:Mietu fl-1893	Kategorio:Mortintoj en 1893
Kategorija:1894	Kategorio:1894
Kategorija:Mietu fl-1894	Kategorio:Mortintoj en 1894
Kategorija:1895	Kategorio:1895
Kategorija:Mietu fl-1895	Kategorio:Mortintoj en 1895
Kategorija:1897	Kategorio:1897
Kategorija:Mietu fl-1897	Kategorio:Mortintoj en 1897
Kategorija:Mietu fl-1898	Kategorio:Mortintoj en 1898
Kategorija:1899	Kategorio:1899
Kategorija:Mietu fl-1900	Kategorio:Mortintoj en 1900
Kategorija:Mietu fl-1901	Kategorio:Mortintoj en 1901
Kategorija:Mietu fl-1905	Kategorio:Mortintoj en 1905
Kategorija:Mietu fl-1915	Kategorio:Mortintoj en 1915
Kategorija:Mietu fl-1916	Kategorio:Mortintoj en 1916
Kategorija:Mietu fl-1917	Kategorio:Mortintoj en 1917
Kategorija:Mietu fl-1918	Kategorio:Mortintoj en 1918
Kategorija:Mietu fl-1920	Kategorio:Mortintoj en 1920
Kategorija:Mietu fl-1921	Kategorio:Mortintoj en 1921
Kategorija:Mietu fl-1925	Kategorio:Mortintoj en 1925
Kategorija:Mietu fl-1926	Kategorio:Mortintoj en 1926
Kategorija:Mietu fl-1927	Kategorio:Mortintoj en 1927
Kategorija:Mietu fl-1935	Kategorio:Mortintoj en 1935
Kategorija:Mietu fl-1936	Kategorio:Mortintoj en 1936
Kategorija:Mietu fl-1939	Kategorio:Mortintoj en 1939
Kategorija:Mietu fl-1940	Kategorio:Mortintoj en 1940
Kategorija:Mietu fl-1954	Kategorio:Mortintoj en 1954
Kategorija:1961	Kategorio:1961
Kategorija:1964	Kategorio:1964
Kategorija:Mietu fl-1964	Kategorio:Mortintoj en 1964
Kategorija:1965	Kategorio:1965
Kategorija:1966	Kategorio:1966
Kategorija:1967	Kategorio:1967
Kategorija:Mietu fl-1967	Kategorio:Mortintoj en 1967
Kategorija:Mietu fl-1968	Kategorio:Mortintoj en 1968
Kategorija:1969	Kategorio:1969
Kategorija:1970	Kategorio:1970
Kategorija:Mietu fl-1970	Kategorio:Mortintoj en 1970
Kategorija:Mietu fl-1971	Kategorio:Mortintoj en 1971
Kategorija:1972	Kategorio:1972
Kategorija:Mietu fl-1972	Kategorio:Mortintoj en 1972
Kategorija:1973	Kategorio:1973
Kategorija:Mietu fl-1973	Kategorio:Mortintoj en 1973
Kategorija:1974	Kategorio:1974
Kategorija:1975	Kategorio:1975
Kategorija:1976	Kategorio:1976
Kategorija:Mietu fl-1977	Kategorio:Mortintoj en 1977
Kategorija:1978	Kategorio:1978
Kategorija:1979	Kategorio:1979
Kategorija:1980	Kategorio:1980
Kategorija:1981	Kategorio:1981
Kategorija:1982	Kategorio:1982
Kategorija:Mietu fl-1982	Kategorio:Mortintoj en 1982
Kategorija:1983	Kategorio:1983
Kategorija:Mietu fl-1983	Kategorio:Mortintoj en 1983
Kategorija:1984	Kategorio:1984
Kategorija:Mietu fl-1984	Kategorio:Mortintoj en 1984
Kategorija:1985	Kategorio:1985
Kategorija:1986	Kategorio:1986
Kategorija:1987	Kategorio:1987
Kategorija:Mietu fl-1987	Kategorio:Mortintoj en 1987
Kategorija:1988	Kategorio:1988
Kategorija:1989	Kategorio:1989
Kategorija:Mietu fl-1989	Kategorio:Mortintoj en 1989
Kategorija:1990	Kategorio:1990
Kategorija:Mietu fl-1990	Kategorio:Mortintoj en 1990
Kategorija:1991	Kategorio:1991
Kategorija:1992	Kategorio:1992
Kategorija:1993	Kategorio:1993
Kategorija:1994	Kategorio:1994
Kategorija:1995	Kategorio:1995
Kategorija:Mietu fl-1995	Kategorio:Mortintoj en 1995
Kategorija:1996	Kategorio:1996
Kategorija:Mietu fl-1996	Kategorio:Mortintoj en 1996
Kategorija:1997	Kategorio:1997
Kategorija:Mietu fl-1997	Kategorio:Mortintoj en 1997
Kategorija:1999	Kategorio:1999
Kategorija:2000	Kategorio:2000
Kategorija:Mietu fl-2000	Kategorio:Mortintoj en 2000
Kategorija:2001	Kategorio:2001
Kategorija:Mietu fl-2001	Kategorio:Mortintoj en 2001
Kategorija:2002	Kategorio:2002
Kategorija:Mietu fl-2002	Kategorio:Mortintoj en 2002
Kategorija:Mietu fl-2003	Kategorio:Mortintoj en 2003
Kategorija:2004	Kategorio:2004
Kategorija:Mietu fl-2004	Kategorio:Mortintoj en 2004
Kategorija:2005	Kategorio:2005
Kategorija:2006	Kategorio:2006
Kategorija:Mietu fl-2006	Kategorio:Mortintoj en 2006
Kategorija:2007	Kategorio:2007
Kategorija:2008	Kategorio:2008
Kategorija:2009	Kategorio:2009
Kategorija:2010	Kategorio:2010
Kategorija:2011	Kategorio:2011
Kategorija:Ajruporti skont il-pajjiż	Kategorio:Flughavenoj laŭ landoj
Kategorija:Politika ta' Malta	Kategorio:Politiko de Malto
Kategorija:Ġurnalisti Franċiżi	Kategorio:Francaj ĵurnalistoj
Kategorija:Storja tal-futbol	Kategorio:Historio de futbalo
Kategorija:Futbol fl-Istati Uniti	Kategorio:Futbalo en Usono
Kategorija:Futbol fil-Belġju	Kategorio:Futbalo en Belgio
Kategorija:Futbol fis-Serbja	Kategorio:Futbalo en Serbio
Kategorija:Futbol fl-Iżvizzera	Kategorio:Futbalo en Svislando
Kategorija:Futbol fl-Arġentina	Kategorio:Futbalo en Argentino
Kategorija:Futbol fl-Irlanda	Kategorio:Futbalo en Irlando
Kategorija:Futbol fiċ-Ċina	Kategorio:Futbalo en Ĉinio
Mudell:Utent be	Ŝablono:Vikipediisto be
Mudell:Utent ru-1	Ŝablono:Vikipediisto ru-1
Mudell:Utent tr-1	Ŝablono:Vikipediisto tr-1
Mudell:Utent uk-4	Ŝablono:Vikipediisto uk-4
Mudell:Utent zh-1	Ŝablono:Vikipediisto zh-1
Kategorija:Poeti skont in-nazzjonalità	Kategorio:Poetoj laŭ landoj
Kategorija:Mużiċisti skont in-nazzjonalità	Kategorio:Muzikistoj laŭ landoj
Kategorija:Skulturi skont in-nazzjonalità tagħhom	Kategorio:Skulptistoj laŭ landoj
Kategorija:Filosfi skont in-nazzjonalità	Kategorio:Filozofoj laŭ landoj
Kategorija:Vulkani skont il-pajjiż	Kategorio:Vulkanoj laŭ landoj
Kategorija:Storja ta' Malta	Kategorio:Historio de Malto
Kategorija:Futbol fl-Olanda	Kategorio:Futbalo en Nederlando
Kategorija:Futbol fil-Ġermanja	Kategorio:Futbalo en Germanio
Kategorija:Futbol fil-Bjelorussja	Kategorio:Futbalo en Belorusio
Kategorija:Futbol fil-Brażil	Kategorio:Futbalo en Brazilo
Kategorija:Futbol fl-Armenja	Kategorio:Futbalo en Armenio
Kategorija:Futbol fl-Ażerbajġan	Kategorio:Futbalo en Azerbajĝano
Kategorija:Futbol fl-Awstrija	Kategorio:Futbalo en Aŭstrio
Kategorija:Futbol fl-Italja	Kategorio:Futbalo en Italio
Kategorija:Futbol fir-Repubblika Ċeka	Kategorio:Futbalo en Ĉeĥio
Kategorija:Futbol fil-Kolombja	Kategorio:Futbalo en Kolombio
Kategorija:Futbol fit-Turkija	Kategorio:Futbalo en Turkio
Kategorija:Futbol fil-Portugall	Kategorio:Futbalo en Portugalio
Kategorija:Futbol fl-Ungerija	Kategorio:Futbalo en Hungario
Kategorija:Festival tal-Eurovision	Kategorio:Eŭrovido-Kantokonkurso
Kategorija:Teatru	Kategorio:Teatro
Kategorija:Kantanti skont in-nazzjonalità	Kategorio:Kantistoj laŭ landoj
Kategorija:Futbolers Arġentini	Kategorio:Argentinaj futbalistoj
Kategorija:Immaġini tal-Creative Commons Attribution-ShareAlike 2.5	Kategorio:CC-BY-SA-2.5
Kategorija:Futbolers Brażiljani	Kategorio:Brazilaj futbalistoj
Mudell:Newtrali	Ŝablono:Sindetena
Kategorija:Kantanti Żvediżi	Kategorio:Svedaj kantistoj
Kategorija:Kantanti Iżlandiżi	Kategorio:Islandaj kantistoj
Kategorija:Kantanti Iżraeljani	Kategorio:Israelaj kantistoj
Kategorija:Kantanti Pollakki	Kategorio:Polaj kantistoj
Kategorija:Kantanti Franċiżi	Kategorio:Francaj kantistoj
Kategorija:Utenti nl	Kategorio:Vikipediisto nl
Kategorija:Ekonomisti Russi	Kategorio:Rusiaj ekonomikistoj
Kategorija:Utenti nn-3	Kategorio:Vikipediisto nn-3
Kategorija:Utenti no-2	Kategorio:Vikipediisto no-2
Kategorija:Utenti no	Kategorio:Vikipediisto no
Kategorija:Utenti zh-1	Kategorio:Vikipediisto zh-1
Kategorija:Armenja	Kategorio:Armenio
Kategorija:Fiżiċi Brittaniċi	Kategorio:Britaj fizikistoj
Kategorija:Pajjiżi tal-Baħar Mediterran	Kategorio:Mediteraneaj landoj
Kategorija:Pajjiżi stabbiliti fl-1992	Kategorio:Ŝtatoj kaj teritorioj fonditaj en 1992
Kategorija:Atturi Taljani	Kategorio:Italaj aktoroj
Kategorija:Pajjiżi skond is-sena li ġew stabbiliti	Kategorio:Ŝtatoj kaj teritorioj laŭ fondojaro
Kategorija:Finanza	Kategorio:Financoj
Kategorija:Diskografiji	Kategorio:Diskaroj
Kategorija:Kompetizzjonijiet tal-futbol	Kategorio:Futbalaj konkursoj
Kategorija:Sports individwali	Kategorio:Unupersonaj sportoj
Kategorija:Televiżjoni	Kategorio:Televido
Kategorija:Prim Ministri ta' Malta	Kategorio:Ĉefministroj de Malto
Kategorija:Mietu fl-1945	Kategorio:Mortintoj en 1945
Kategorija:Mietu fl-1963	Kategorio:Mortintoj en 1963
Kategorija:1832	Kategorio:1832
Kategorija:Mietu fl-1930	Kategorio:Mortintoj en 1930
Kategorija:1822	Kategorio:1822
Kategorija:Skulturi	Kategorio:Skulptistoj
Kategorija:Seklu 14	Kategorio:14-a jarcento
Kategorija:Sekli	Kategorio:Jarcentoj
Kategorija:Seklu 13	Kategorio:13-a jarcento
Kategorija:Seklu 16	Kategorio:16-a jarcento
Kategorija:Seklu 12	Kategorio:12-a jarcento
Kategorija:Seklu 18	Kategorio:18-a jarcento
Kategorija:Kompożituri Russi	Kategorio:Komponistoj de Rusio
Kategorija:Kompożituri Franċiżi	Kategorio:Francaj komponistoj
Kategorija:Kompożituri Barokki	Kategorio:Barokaj komponistoj
Kategorija:Kompożituri Pollakki	Kategorio:Polaj komponistoj
Kategorija:Kompożituri Ġermaniżi	Kategorio:Germanaj komponistoj
Kategorija:Kompożituri Awstrijaċi	Kategorio:Aŭstraj komponistoj
Kategorija:Mużiċisti Pollakki	Kategorio:Polaj muzikistoj
Kategorija:Skulturi Taljani	Kategorio:Italaj skulptistoj
Kategorija:Storiċi Russi	Kategorio:Historiistoj de Rusio
Kategorija:Mużiċisti Norveġiżi	Kategorio:Norvegaj muzikistoj
Kategorija:Mużiċisti Daniżi	Kategorio:Danaj muzikistoj
Kategorija:Mużiċisti Russi	Kategorio:Rusiaj muzikistoj
Kategorija:Mużiċisti Brażiljani	Kategorio:Brazilaj muzikistoj
Kategorija:Mużiċisti Żvediżi	Kategorio:Svedaj muzikistoj
Kategorija:Mużiċisti Irlandiżi	Kategorio:Irlandaj muzikistoj
Kategorija:Mużiċisti Brittaniċi	Kategorio:Britaj muzikistoj
Kategorija:Mużiċisti Taljani	Kategorio:Italaj muzikistoj
Kategorija:Mużiċisti Ġeorġjani	Kategorio:Kartvelaj muzikistoj
Kategorija:Mużiċisti Kanadiżi	Kategorio:Kanadaj muzikistoj
Kategorija:Mużiċisti Franċiżi	Kategorio:Francaj muzikistoj
Kategorija:1829	Kategorio:1829
Kategorija:Kompożituri Rumeni	Kategorio:Rumanaj komponistoj
Kategorija:Kompożituri Taljani	Kategorio:Italaj komponistoj
Kategorija:Mużiċisti Ġermaniżi	Kategorio:Germanaj muzikistoj
Kategorija:Politiċi Maltin	Kategorio:Maltaj politikistoj
Kategorija:Politiċi Taljani	Kategorio:Italaj politikistoj
Kategorija:Politiċi Franċiżi	Kategorio:Francaj politikistoj
Kategorija:Filosfi Griegi	Kategorio:Grekaj filozofoj
Kategorija:Filosfi Ġermaniżi	Kategorio:Germanaj filozofoj
Kategorija:Filosfi Brittaniċi	Kategorio:Britaj filozofoj
Kategorija:Bavarja	Kategorio:Bavario
Kategorija:Futbolers Żvediżi	Kategorio:Svedaj futbalistoj
Kategorija:Futbolers Skoċċiżi	Kategorio:Skotaj futbalistoj
Kategorija:Futbolers Franċiżi	Kategorio:Francaj futbalistoj
Kategorija:Teorija tal-logħob	Kategorio:Ludoteorio
Kategorija:1789	Kategorio:1789
Kategorija:Mietu fl-1809	Kategorio:Mortintoj en 1809
Kategorija:1821	Kategorio:1821
Kategorija:1828	Kategorio:1828
Kategorija:1841	Kategorio:1841
Kategorija:1867	Kategorio:1867
Kategorija:1873	Kategorio:1873
Kategorija:1878	Kategorio:1878
Kategorija:1896	Kategorio:1896
Kategorija:1963	Kategorio:1963
Kategorija:Mietu fl-1981	Kategorio:Mortintoj en 1981
Kategorija:Mietu fl-1999	Kategorio:Mortintoj en 1999
Kategorija:2012	Kategorio:2012
Kategorija:Imprendituri Amerikani	Kategorio:Usonaj entreprenistoj
Kategorija:Inventuri Brittaniċi	Kategorio:Britaj inventistoj
Kategorija:Futbolers Torok	Kategorio:Turkaj futbalistoj
Kategorija:Futbolers Żvizzeri	Kategorio:Svisaj futbalistoj
Kategorija:Futbolers Spanjoli	Kategorio:Hispaniaj futbalistoj
Kategorija:Futbolers Ungeriżi	Kategorio:Hungaraj futbalistoj
Kategorija:Futbolers Serbi	Kategorio:Serbaj futbalistoj
Kategorija:Futbolers Taljani	Kategorio:Italaj futbalistoj
Kategorija:Futbolers Daniżi	Kategorio:Danaj futbalistoj
Kategorija:Futbolers Nord-Irlandiżi	Kategorio:Futbalistoj de Nord-Irlando
Kategorija:Futbolers Kroati	Kategorio:Kroataj futbalistoj
Kategorija:Futbolers Portugiżi	Kategorio:Portugalaj futbalistoj
Kategorija:Kantanti Norveġiżi	Kategorio:Norvegaj kantistoj
Kategorija:Kantanti Brażiljani	Kategorio:Brazilaj kantistoj
Kategorija:Kantanti Russi	Kategorio:Kantistoj de Rusio
Kategorija:Kantanti Daniżi	Kategorio:Danaj kantistoj
Kategorija:Denominazzjonijiet Kristjani	Kategorio:Kristanaj konfesioj
Kategorija:Abbozzi tal-matematika	Kategorio:Ĝermoj pri matematiko
Kategorija:Abbozzi tal-bijoloġija	Kategorio:Ĝermoj pri biologio
Kategorija:Abbozzi tal-ġeografija	Kategorio:Ĝermoj pri geografio
Kategorija:Seklu 15	Kategorio:15-a jarcento
Kategorija:Mietu fis-seklu 16	Kategorio:Mortintoj en la 16-a jarcento
Kategorija:Mietu fis-seklu 17	Kategorio:Mortintoj en la 17-a jarcento
Kategorija:Mietu fis-seklu 18	Kategorio:Mortintoj en la 18-a jarcento
Kategorija:Mietu fis-seklu 19	Kategorio:Mortintoj en la 19-a jarcento
Kategorija:Mietu fis-seklu 20	Kategorio:Mortintoj en la 20-a jarcento
Kategorija:Mietu fis-seklu 21	Kategorio:Mortintoj en la 21-a jarcento
Kategorija:Futbol fil-Messiku	Kategorio:Futbalo en Meksiko
Kategorija:Futbol fl-Iżvezja	Kategorio:Futbalo en Svedio
Kategorija:Futbol fl-Ukrajna	Kategorio:Futbalo en Ukrainio
Kategorija:Futbol fil-Kroazja	Kategorio:Futbalo en Kroatio
Kategorija:Futbol fi Franza	Kategorio:Futbalo en Francio
Kategorija:Ġeorġja	Kategorio:Kartvelio
Kategorija:Kantanti Amerikani	Kategorio:Usonaj kantistoj
Kategorija:Bijoloġi Brittaniċi	Kategorio:Britaj biologoj
Kategorija:Probabbiltà u statistika	Kategorio:Probablo kaj statistiko
Kategorija:Naturalisti Brittaniċi	Kategorio:Britaj natursciencistoj
Kategorija:Mużiċisti Żvizzeri	Kategorio:Svisaj muzikistoj
Kategorija:Mużiċisti Armeni	Kategorio:Armenaj muzikistoj
Kategorija:Mużiċisti Ażerbajġani	Kategorio:Azeraj muzikistoj
Kategorija:Mużiċisti Iżraeljani	Kategorio:Israelaj muzikistoj
Kategorija:Ġeoloġi Brittaniċi	Kategorio:Britaj geologoj
Kategorija:1727	Kategorio:1727
Kategorija:1744	Kategorio:1744
Kategorija:1808	Kategorio:1808
Kategorija:1824	Kategorio:1824
Kategorija:Mietu fl-1835	Kategorio:Mortintoj en 1835
Kategorija:Mietu fl-1868	Kategorio:Mortintoj en 1868
Kategorija:Mietu fl-1888	Kategorio:Mortintoj en 1888
Kategorija:Mietu fl-1933	Kategorio:Mortintoj en 1933
Kategorija:Mietu fl-1961	Kategorio:Mortintoj en 1961
Kategorija:1968	Kategorio:1968
Kategorija:Futbol fir-Russja	Kategorio:Futbalo en Rusio
Kategorija:Kantanti Torok	Kategorio:Turkaj kantistoj
Kategorija:Nies Maltin	Kategorio:Maltanoj
Kategorija:Matematiċi Brittaniċi	Kategorio:Britaj matematikistoj
Kategorija:Mużiċisti Belġjani	Kategorio:Belgaj muzikistoj
Kategorija:1817	Kategorio:1817
Kategorija:1898	Kategorio:1898
Kategorija:1998	Kategorio:1998
Kategorija:Libanu	Kategorio:Libano
Kategorija:Mietu fis-seklu 15	Kategorio:Mortintoj en la 15-a jarcento
Kategorija:Kantanti Ġermaniżi	Kategorio:Germanaj kantistoj
Kategorija:Kantanti Belġjani	Kategorio:Belgaj kantistoj
Kategorija:Mużiċisti Iżlandiżi	Kategorio:Islandaj muzikistoj
Kategorija:Kompożituri Irlandiżi	Kategorio:Irlandaj komponistoj
Kategorija:Futbolers Messikani	Kategorio:Meksikaj futbalistoj
Kategorija:2003	Kategorio:2003
Kategorija:Mietu fis-seklu 14	Kategorio:Mortintoj en la 14-a jarcento
Kategorija:Futbol fid-Danimarka	Kategorio:Futbalo en Danio
Kategorija:Xjenzati Brittaniċi	Kategorio:Britaj sciencistoj
Kategorija:1971	Kategorio:1971
Kategorija:Mietu fis-seklu 13	Kategorio:Mortintoj en la 13-a jarcento
Kategorija:Mudelli kkumplikati	Kategorio:Ŝablono:Esoteraj
Mudell:Isem tal-lingwa	Ŝablono:Lingv/o
Kategorija:Abbozzi tal-politika	Kategorio:Ĝermoj pri politiko
Kategorija:Abbozzi tal-astronomija	Kategorio:Ĝermoj pri astronomio
Kategorija:Abbozzi tal-istorja	Kategorio:Ĝermoj pri historio
Kategorija:Abbozzi tal-arti	Kategorio:Ĝermoj pri arto
Kategorija:Abbozzi tar-reliġjon	Kategorio:Ĝermoj pri religio
Mudell:Utent de-4	Ŝablono:Vikipediisto de-4
Kategorija:Abbozzi tat-teknoloġija	Kategorio:Ĝermoj pri teknologio
Kategorija:Abbozzi tal-ekonomija	Kategorio:Ĝermoj pri ekonomiko
Kategorija:Futbol Asjatiku	Kategorio:Futbalo en Azio
Kategorija:Futbol fl-Afrika	Kategorio:Futbalo en Afriko
Kategorija:Futbol fl-Amerika t'Isfel	Kategorio:Futbalo en Sudameriko
Kategorija:Futbol fl-Ewropa	Kategorio:Futbalo en Eŭropo
Kategorija:Futbol fl-Oċeanja	Kategorio:Futbalo en Oceanio
Kategorija:Futbol skont il-kontinent	Kategorio:Futbalo laŭ kontinentoj
Kategorija:Imwiet skont is-sena	Kategorio:Mortintoj laŭ jaroj
Kategorija:San Marino	Kategorio:San-Marino
Kategorija:Liechtenstein	Kategorio:Liĥtenŝtejno
Kategorija:Andorra	Kategorio:Andoro
Kategorija:Serbja	Kategorio:Serbio
Kategorija:Pajjiżi skont il-kontinent	Kategorio:Landoj laŭ kontinentoj
Kategorija:Albanija	Kategorio:Albanio
Kategorija:Pajjiżi tal-Karibew	Kategorio:Karibiaj landoj
Kategorija:Pajjiżi tal-Oċeanja	Kategorio:Oceaniaj landoj
Kategorija:Pajjiżi tal-Amerika ta' Fuq	Kategorio:Nordamerikaj landoj
Kategorija:Timijiet nazzjonali tal-futbol	Kategorio:Naciaj teamoj de futbalo
Kategorija:Immaġini b'xejn	Kategorio:Liberaj bildoj
Kategorija:Reġjuni tal-Ewropa	Kategorio:Regionoj en Eŭropo
Kategorija:Vulkani tal-Italja	Kategorio:Vulkanoj en Italio
Kategorija:Oċeani	Kategorio:Oceanoj
Kategorija:Antropoloġija	Kategorio:Antropologio
Kategorija:Pajjiżi stabbiliti fl-1946	Kategorio:Ŝtatoj kaj teritorioj fonditaj en 1946
Kategorija:Bliet tal-Veneżwela	Kategorio:Urboj de Venezuelo
Kategorija:Repubbliki	Kategorio:Respublikoj
Kategorija:Klabbs tal-futbol Olandiżi	Kategorio:Nederlandaj futbalteamoj
Kategorija:Tupaja	Kategorio:Tupajuloj
Kategorija:Lagomorpha	Kategorio:Leporuloj
Kategorija:Proboscidea	Kategorio:Rostruloj
Kategorija:Hyracoidea	Kategorio:Prokaviuloj
Kategorija:Kantanti Albaniżi	Kategorio:Albanaj kantistoj
Kategorija:Kantanti Rumeni	Kategorio:Rumanaj kantistoj
Kategorija:Pajjiżi tal-Amerika t'Isfel	Kategorio:Sudamerikaj landoj
Kategorija:Abbozzi tal-isport	Kategorio:Ĝermoj pri sporto
Kategorija:Teoristi	Kategorio:Teoriistoj
Kategorija:Presidenti ta' Malta	Kategorio:Prezidantoj de Malto
Mudell:Utent id-4	Ŝablono:Vikipediisto id-4
Kategorija:Analisi matematika	Kategorio:Analitiko
Kategorija:Mitoloġija Griega	Kategorio:Helena mitologio
Kategorija:Bliet kapitali	Kategorio:Ĉefurboj
Kategorija:Avvenimenti	Kategorio:Eventoj
Kategorija:HIV/AIDS	Kategorio:Aidoso
Kategorija:Mudelli tal-vetrina tal-Wikipedija	Kategorio:Ŝablono:Indaj artikoloj
Kategorija:Filatelija	Kategorio:Filatelo
Kategorija:Arkeoloġija	Kategorio:Arkeologio
Kategorija:Astroloġija	Kategorio:Astrologio
Kategorija:Logħob Olimpiku tas-sajf 2008	Kategorio:Somera Olimpiko 2008
Kategorija:Ho Chi Minh (belt)	Kategorio:Ho-Chi-Minh-urbo
Kategorija:Elettriċità	Kategorio:Elektro
Kategorija:Posta	Kategorio:Poŝto
Kategorija:Utenti pl	Kategorio:Vikipediisto pl
Kategorija:Trasport	Kategorio:Transporto
Kategorija:Ir-Rivoluzzjoni Franċiża	Kategorio:Franca Revolucio
Kategorija:Żfin	Kategorio:Danco
Kategorija:Sports tat-timijiet	Kategorio:Teama sporto
Kategorija:Teorija tal-grafi	Kategorio:Grafeteorio
Kategorija:Teorija tan-numri	Kategorio:Nombroteorio
Kategorija:Kantanti	Kategorio:Kantistoj
Kategorija:Futbolers	Kategorio:Futbalistoj
Kategorija:Matematiċi	Kategorio:Matematikistoj
Mudell:Coord/dec2dms/d	Ŝablono:Koord/dekalgms/g/dokumentado
Kategorija:Presidenti tal-Italja	Kategorio:Prezidantoj de Italio
Kategorija:Sportivi	Kategorio:Sportistoj
Kategorija:Dermoptera	Kategorio:Dermopteroj
Kategorija:Skultura	Kategorio:Skulptado
Kategorija:Montenegro	Kategorio:Montenegro
Mudell:Hu	Ŝablono:Hu
Kategorija:Ewropa tat-Tramuntana	Kategorio:Norda Eŭropo
Mudell:Utent ga-1	Ŝablono:Vikipediisto ga-1
Kategorija:Kultura tal-Veneżwela	Kategorio:Kulturo de Venezuelo
Kategorija:Bliet ta' Malta	Kategorio:Urboj de Malto
Kategorija:Bliet tal-Vjetnam	Kategorio:Urboj de Vjetnamio
Għajnuna:Sintassi	Helpo:Kiel redakti paĝon por spertuloj
Kategorija:Bliet kapitali fl-Ewropa	Kategorio:Ĉefurboj de Eŭropo
Kategorija:Partiti politiċi ta' Malta	Kategorio:Politikaj partioj de Malto
Kategorija:Logħob tal-ballun	Kategorio:Pilkosportoj
Kategorija:Kittieba Maltin	Kategorio:Maltaj verkistoj
Kategorija:Ewropa tal-Punent	Kategorio:Okcidenta Eŭropo
Kategorija:Ewropa tan-Nofsinhar	Kategorio:Suda Eŭropo
Kategorija:Mediterran	Kategorio:Mediteraneo
Kategorija:Mużiċisti Albaniżi	Kategorio:Albanaj muzikistoj
Kategorija:Storja tal-matematika	Kategorio:Historio de matematiko
Mudell:Fb-lemin	Ŝablono:Fb-rt
Kategorija:Saħħa	Kategorio:Sano
Mudell:PD-qadim	Ŝablono:Bildo malnova
Kategorija:Klabbs tal-futbol Russi	Kategorio:Rusiaj futbalteamoj
Mudell:Coord/dec2dms/dms	Ŝablono:Koord/dekalgms/gms
Mudell:Coord/prec dec	Ŝablono:Koord/prec dek
Mudell:Bandiera	Ŝablono:Flago
Mudell:Utent pl-4	Ŝablono:Vikipediisto pl-4
Kategorija:Isqfijiet Taljani	Kategorio:Italaj episkopoj
Portal:Matematika	Portalo:Matematiko
Kategorija:Mużiċisti Litwani	Kategorio:Litovaj muzikistoj
Kategorija:Lingwi Internazzjonali Awżiljari	Kategorio:Internacia planlingvo
Kategorija:William Shakespeare	Kategorio:William Shakespeare
Kategorija:Mudelli tal-mużika	Kategorio:Ŝablono:Muziko
Kategorija:Kantanti Montenegrini	Kategorio:Montenegraj kantistoj
Mudell:Infobox Kulur	Ŝablono:Informkesto koloro
Kategorija:Kompożituri	Kategorio:Komponistoj
Kategorija:Pajjiżi Amerikani	Kategorio:Amerikaj landoj
Mudell:Skwadra Ġermaniża Kampjonati Ewropej tal-Futbol 2012	Ŝablono:Germana nacia teamo - Eŭropa Futbal-Ĉampionado 2012
Mudell:Skwadra Ġermaniża Tazza tad-Dinja tal-Futbol 2006	Ŝablono:Germana nacia teamo - Futbala Mondpokalo 2006
Kategorija:Mudelli skont it-tip	Kategorio:Ŝablono:laŭ formo
Mudell:Suboff	Ŝablono:Eliris
Mudell:Sent off	Ŝablono:Forlasa ordono
Mudell:MLT	Ŝablono:MLT
Kategorija:Arċisqfijiet Maltin	Kategorio:Maltaj ĉefepiskopoj
Kategorija:Federazzjonijiet tal-futbol	Kategorio:Futbalaj organizaĵoj
Kategorija:Kantanti Ażerbajġani	Kategorio:Azeraj kantistoj
Kategorija:Kantanti Bjelorussi	Kategorio:Belorusaj kantistoj
Kategorija:Ktieb ta' Mormon	Kategorio:Libro de Mormon
Kategorija:Pajjiżi tal-Amerika Ċentrali	Kategorio:Centramerikaj landoj
Kategorija:Kantanti Ċiprijotti	Kategorio:Kipraj kantistoj
Kategorija:Klabbs tal-futbol Awstrijaċi	Kategorio:Aŭstraj futbalteamoj
Kategorija:Futbol fil-Korea t'Isfel	Kategorio:Futbalo en Sud-Koreio
Kategorija:Għawdex	Kategorio:Gozo
Kategorija:Irlanda	Kategorio:Irlando
Kategorija:Preżentaturi televiżivi Taljani	Kategorio:Italaj televidaj prezentistoj
Għajnuna:Kronoloġija	Helpo:Historio de paĝo
Portal:Kimika	Portalo:Kemio
Kategorija:Abbozzi tal-letteratura	Kategorio:Ĝermoj pri literaturo
Kategorija:Letteratura Maltija	Kategorio:Malta literaturo
Kategorija:Mużiċisti Maltin	Kategorio:Maltaj muzikistoj
Kategorija:Kantanti Maltin	Kategorio:Maltaj kantistoj
Kategorija:Abbozzi tal-mediċina	Kategorio:Ĝermoj pri medicino
Kategorija:Mużiċisti Montenegrini	Kategorio:Montenegraj muzikistoj
Kategorija:Kompożituri Romantiċi	Kategorio:Romantikaj komponistoj
Kategorija:Abbozzi tal-filosofija	Kategorio:Ĝermoj pri filozofio
Kategorija:Ortografija	Kategorio:Ortografio
Kategorija:Lingwi Semitiċi	Kategorio:Semida lingvaro
Kategorija:Kantanti Ġeorġjani	Kategorio:Kartvelaj kantistoj
Kategorija:Mużiċisti Slovakki	Kategorio:Slovakaj muzikistoj
Kategorija:Kantanti Slovakki	Kategorio:Slovakaj kantistoj
Kategorija:Okkupazzjonijiet sportivi	Kategorio:Profesioj rilataj al sporto
Kategorija:Provinċja ta' Agrigento	Kategorio:Provinco Agrigento
Kategorija:Provinċja ta' Kaltanissetta	Kategorio:Provinco Caltanissetta
Kategorija:Ludwig van Beethoven	Kategorio:Ludwig van Beethoven
Kategorija:Ateiżmu	Kategorio:Ateismo
Kategorija:Kompożituri Klassiċi	Kategorio:Klasikaj komponistoj
Kategorija:Didelphimorphia	Kategorio:Didelfoj
Kategorija:Bolol	Kategorio:Poŝtmarkoj
Kategorija:Xjenza Applikati	Kategorio:Aplikataj sciencoj
Kategorija:Coritiba Foot Ball Club	Kategorio:Coritiba Foot Ball Club
Kategorija:Snin tas-seklu 20	Kategorio:Jaroj de la 20-a jarcento
Kategorija:Snin tas-seklu 21	Kategorio:Jaroj de la 21-a jarcento
Kategorija:Logħob tat-tfal	Kategorio:Infanludoj
Kategorija:Provinċja ta' Bergamo	Kategorio:Provinco Bergamo
Kategorija:Kantanti Bulgari	Kategorio:Bulgaraj kantistoj
Kategorija:Provinċja ta' Lodi	Kategorio:Provinco Lodi
Kategorija:Kantanti Żvizzeri	Kategorio:Svisaj kantistoj
Kategorija:Pedagoġija	Kategorio:Pedagogio
Kategorija:Preistorja	Kategorio:Prahistorio
Kategorija:Drammi ta' William Shakespeare	Kategorio:Ŝekspiraj teatraĵoj
Kategorija:Mużiċisti Torok	Kategorio:Turkaj muzikistoj
Kategorija:Mużiċisti Bjelorussi	Kategorio:Belorusaj muzikistoj
Kategorija:Mużiċisti Ċiprijotti	Kategorio:Kipraj muzikistoj
Kategorija:Abbozzi tal-mitoloġija	Kategorio:Ĝermoj pri mitologio
Kategorija:Abbozzi tal-arkitettura	Kategorio:Ĝermoj pri arkitekturo
Kategorija:Mudelli tal-Paġna prinċipali	Kategorio:Ŝablono:Ĉefpaĝo
Mudell:Infobox Gazzetta	Ŝablono:Informkesto gazeto
Mudell:IMSLP	Ŝablono:IMSLP
Kategorija:Klassifikazzjoni xjentifika	Kategorio:Sistematiko
Kategorija:Utenti en-1	Kategorio:Vikipediisto en-1
Kategorija:Twieldu fl-1930	Kategorio:Naskiĝintoj en 1930
Kategorija:Twieldu fl-1946	Kategorio:Naskiĝintoj en 1946
Kategorija:Utenti de-1	Kategorio:Vikipediisto de-1
Kategorija:Twieldu fl-1920	Kategorio:Naskiĝintoj en 1920
Kategorija:Twieldu fl-1956	Kategorio:Naskiĝintoj en 1956
Kategorija:Twieldu fl-1933	Kategorio:Naskiĝintoj en 1933
Kategorija:Twieldu fl-1911	Kategorio:Naskiĝintoj en 1911
Kategorija:Twieldu fl-1937	Kategorio:Naskiĝintoj en 1937
Kategorija:Twieldu fl-1948	Kategorio:Naskiĝintoj en 1948
Kategorija:Mudelli protetti	Kategorio:Protektitaj ŝablonoj
Kategorija:Mietu fl-1978	Kategorio:Mortintoj en 1978
Kategorija:Twieldu fl-1921	Kategorio:Naskiĝintoj en 1921
Kategorija:Twieldu fl-1924	Kategorio:Naskiĝintoj en 1924
Kategorija:Twieldu fl-1926	Kategorio:Naskiĝintoj en 1926
Kategorija:Twieldu fl-1950	Kategorio:Naskiĝintoj en 1950
Kategorija:Twieldu fl-1964	Kategorio:Naskiĝintoj en 1964
Kategorija:Atturi Amerikani	Kategorio:Usonaj aktoroj
Kategorija:Mietu fl-1979	Kategorio:Mortintoj en 1979
Kategorija:Mietu fl-2010	Kategorio:Mortintoj en 2010
Kategorija:Macroscelidea	Kategorio:Makrosceliduloj
Kategorija:Mużiċisti Rumeni	Kategorio:Rumanaj muzikistoj
Mudell:Traduzzjoni	Ŝablono:Esperantigu artikolon
Għajnuna:Żbalji komuni fl-użu tal-Wikipedija	Helpo:Kutimaj komencanteraroj
Għajnuna:Medja	Helpo:Dosieroj
Mudell:Coord/negzeropad	Ŝablono:Koord/negzeropad
Wikipedija:Ċaħda medika	Vikipedio:Konsilo pri medicinaj temoj
Mudell:Userbox-livell	Ŝablono:Userbox-level
Mudell:Kotba tal-Ktieb ta' Mormon	Ŝablono:Libro de Mormon
Mudell:...	Ŝablono:Malplena sekcio
Mudell:Kunsilli lokali ta' Malta u Għawdex	Ŝablono:Navigilo:Komunumoj de Malto
Wikipedija:VisualEditor	Vikipedio:VidRedaktilo
Mudell:Skwadra Taljana Kampjonati Ewropej tal-Futbol 2012	Ŝablono:Itala nacia teamo - Eŭropa Futbal-Ĉampionado 2012
Mudell:Hs	Ŝablono:Hs
Mudell:Infobox Temp/kolt	Ŝablono:Veterkesto/Kolt
Edward Snowden	Edward Snowden
Coreca	Coreca
Speċjali:TibdilRiċenti	Specialaĵo:Lastaj ŝanĝoj
Kategorija:Utenti ja-4	Kategorio:Vikipediisto ja-4
Kategorija:Mietu fl-1976	Kategorio:Mortintoj en 1976
Kategorija:Mietu fl-1975	Kategorio:Mortintoj en 1975
Kategorija:Mietu fl-1974	Kategorio:Mortintoj en 1974
Franco Trappoli	Franco Trappoli
Krimea	Respubliko Krimeo (Rusio)
Kategorija:Pajjiżi stabbiliti fl-2014	Kategorio:Ŝtatoj kaj teritorioj fonditaj en 2014
Maurizio Malvestiti	Maurizio Malvestiti
