Africa	Afriko
Xapon	Japanio
Ixachitlān Huitztlāmpa	Sudameriko
Noruega	Norvegio
Inglatlālpan	Anglio
Wales	Kimrio
Irtlālpan	Irlando
Hungria	Hungario
Caxtillān	Hispanio
Tlacetilīlli Tlahtohcāyōtl Ixachitlān	Usono
Belgica	Belgio
Luxemburgo	Luksemburgo (lando)
Cemānāhuac	Universo
Tlālticpactli	Tero
Miquiztli	Morto
Tlācatl	Homo
George Washington	George Washington
Stanley Kubrick	Stanley Kubrick
Fintlālpan	Finnlando
Suecia	Svedio
Dinamarca	Danio
Polonia	Pollando
Lituania	Litovio
Italia	Italio
Suiza	Svislando
Austria	Aŭstrio
Grecia	Grekio
Turquia	Turkio
Portugal	Portugalio
Europan	Eŭropo
Asia	Azio
Ixachitlān Mictlāmpa	Nordameriko
Antartida	Antarkto
Huiquipedia	Vikipedio
Tlanitlālpan	Nederlando
Tepōlli	Peniso
Āltepētl Yancuīc York	Novjorko
Washington, D.C.	Vaŝingtono
San Francisco, California	San-Francisko
Berlin	Berlino
Los Ángeles	Los-Anĝeleso
Chīuhpōhualhuaztli	Komputilo
Berna	Berno
Zurich	Zuriko
Mātlatzālantli	Interreto
Barack Obama	Barack Obama
Uruguay	Urugvajo
Londres	Londono
In Cairo	Kairo
Alexandria	Aleksandrio
Manzana	Pomo
Paris	Parizo
Abraham Lincoln	Abraham Lincoln
Google	Google
Mēxihco	Meksiko
Ilhuicaātl Atlántico	Atlantika Oceano
Tēpāpāquiltiliztli Ilhuicaātl	Pacifika Oceano
California	Kalifornio
Mētztlitōnal	Lundo
Ic cē mētztli	Januaro
Ic ōme mētztli	Februaro
Ic ēyi mētztli	Marto
Chīchīlcītlalli	Marso
Quenia	Kenjo
Etiopia	Etiopio
Ghana	Ganao
Ic nāuhtetl mētztli	Aprilo
Ic mācuīlli mētztli	Majo
Ic chicuacen mētztli	Junio
Ic chicōme mētztli	Julio
Ic chicuēyi mētztli	Aŭgusto
Ic chiucnāhui mētztli	Septembro
Ic mahtlāctetl mētztli	Oktobro
Ic mahtlāctetl oncē mētztli	Novembro
Ic mahtlāctetl omōme mētztli	Decembro
Huītzilōpōchtōnal	Mardo
Yacatlipotōnal	Merkredo
Tezcatlipotōnal	Ĵaŭdo
Quetzalcōātōnal	Vendredo
Tlāloctitōnal	Sabato
Tōnatiuhtōnal	Dimanĉo
Cuāmiztli	Leono
Francia	Francio
Esperantotlahtōlli	Esperanto
Itzcuintli	Hundo
Tlacetilīlli Huēyitlahtohcāyōtl	Unuiĝinta Reĝlando
Miztōn	Hejma kato
China	Ĉina Popola Respubliko
Franciatlahtōlli	Franca lingvo
Michin	Fiŝoj
Octli	Alkoholaĵo
Brasil	Brazilo
Rusia	Rusio
Huēyātl	Maro
Π	Pio (litero)
Wiki	Vikio
Alabama	Alabamo
São Paulo	San-Paŭlo (urbo)
São Paulo (tlahtohcāyōtl)	San-Paŭlo
Quebec	Kebekio
Jimmy Wales	Jimmy Wales
Alemania	Germanio
Belarus	Belorusio
Alemantlahtōlli	Germana lingvo
Iztlālpan	Islando
Estonia	Estonio
Tzitzimicītlalli	Saturno (planedo)
Xocolātl	Ĉokolado
Tepoztōtōtl	Aviadilo
Cē (tlapōhualli)	1 (nombro)
Ōme	2 (nombro)
Ēyi	3 (nombro)
Nāhui	4 (nombro)
Mācuīlli	5 (nombro)
George W. Bush	George W. Bush
Letonia	Latvio
Ucrania	Ukrainio
Chequia	Ĉeĥio
Eslovaquia	Slovakio
Eslovenia	Slovenio
Vilnius	Vilno
Moldova	Moldava Respubliko
Rumania	Rumanio
Bulgaria	Bulgario
Roma	Romo
Tlācatlahtohcāyōtl Macedonia	Respubliko Makedonio
Albania	Albanio
Groentlālpan	Gronlando
Croacia	Kroatio
Bosnia īhuān Hertzegovina	Bosnio kaj Hercegovino
Nuuk	Nuko (Gronlando)
Azerbaiyan	Azerbajĝano
Andorra	Andoro
Chipre	Kipro
Georgia	Kartvelio
Cazaquistan	Kazaĥio
Malta	Malto
Flandes	Flandrio
Monaco	Monako
Tlīltepēc	Montenegro
In Vaticano	Vatikano
San Marino	San-Marino
Brusel	Bruselo
Cuba	Kubo
Belice	Belizo
Eiffel Huehcapan Calli	Eiffel-Turo
Barbados	Barbado
Volkswagen	Volkswagen
Indonesia	Indonezio
Wolfgang Amadeus Mozart	Wolfgang Amadeus Mozart
Ludwig van Beethoven	Ludwig van Beethoven
Africa Huitztlāmpa	Sud-Afriko
Argelia	Alĝerio
Uzbequistan	Uzbekujo
Poznan	Poznano
Varsovia	Varsovio
Modena	Modeno
Huino	Vino
Ātl	Akvo
Huehcaīxipcaxitl	Televido
Iztlahtōlli	Islanda lingvo
Chile	Ĉilio
Jesucristo	Jesuo Kristo
Elvis Presley	Elvis Presley
Galileo Galilei	Galilejo
Payīnalcītlalli	Merkuro (planedo)
Huēhuehcāyōmatiliztli	Historio
Apple Computer	Apple
Cītlalpōl	Venuso (planedo)
Tlahtōlli (tlahtōlmatiliztli)	Lingvo
Tlazohtiliztli	Amo
Huēyitzitzimicītlalli	Jupitero (planedo)
Cītlalin īcue (Ilhuicamatiliztli)	Lakta vojo
Ilhuicateōcītlalli	Urano (planedo)
Ricardo Lagos	Ricardo Lagos
Tlāloccītlalli	Neptuno (planedo)
Ilhuicamatiliztli	Astronomio
Singapur	Singapuro
Tlamatiliztli	Scienco
Mictlāntēuccītlalli	Plutono
María Ichpōchtli	Maria (patrino de Jesuo)
Liechtenstein	Liĥtenŝtejno
Adolf Hitler	Adolf Hitler
Facebook	Facebook
Īyāōyo in Cemānāhuac Inic Cē	Unua mondmilito
Īyāōyo in Cemānāhuac Inic Ōme	Dua mondmilito
Köln	Kolonjo
Vodka	Vodko
Tlapōhualtepoztli	Horloĝo
Tlapōhualmatiliztli	Matematiko
U2 (tlacuīcaliztli)	U2
Latintlahtōlli	Latina lingvo
Bahrein	Barejno
Armenia	Armenio
Serbia	Serbio
Mētztli	Luno
Estambul	Istanbulo
Australia	Aŭstralio
Carl Sagan	Carl Sagan
Iuhcāyōtl	Fiziko
Argentina	Argentino
Peru	Peruo
Yōlizmatiliztli	Biologio
Corea Mictlāmpa	Nord-Koreio
Camboya	Kamboĝo
Tēpouhtitlāzcuetzpalin	Dinosaŭro
Islam	Islamo
Pera	Pirarbo
Liubliana	Ljubljano
Tlanelhuayōmatiliztli	Plantoscienco
Malacatl	Rado
Denis Diderot	Denis Diderot
Lyon	Liono
Europan Cētiliztli	Eŭropa Unio
Cihuātl	Virino
Sofiya	Sofio
Ñ	Ñ
El Ingenioso Hidalgo Don Quixote de la Mancha	Kiĥoto
Xōchicuīcayōtl	Poezio
Milano	Milano
Torino	Torino
Cuichilli	Anuso
Limacuahuitl	Citrono
Émile Zola	Émile Zola
666	666
Xōchitl	Floro
Āltepētl	Urbo
Cītlalli	Stelo
Tōnatiuh	Suno
Ilhuicatl	Ĉielo
Tlāhuīlxihuitl	Lumjaro
Victor Hugo	Victor Hugo
Oceania	Oceanio
Tonacayōhuapāhualiztli	Atletiko
Tōnatiuh Īchān	Sunsistemo
Baltico huēyātl	Balta Maro
Āyōcoxqui	Hidrogeno
Tōnatiuhyoh	Heliumo
Angela Merkel	Angela Merkel
Iztactlāltepoztli	Berilio
Āmoxtli	Libro
Tōnalli	Tago
Timor Tlāpcopa	Orienta Timoro
Yohualli	Nokto
Xihuitl (cāhuitl)	Jaro
Mācuīlpōhualxihuitl	Jarcento
Lodz	Lodzo
Oslo	Oslo
Bonn	Bonn
Katowice	Katowice
Tecuīlontiliztli	Gejo
Ceres	Cereso
Lisboa	Lisbono
Makemake	Makemako (nanoplanedo)
Eris	Eriso
Lionel Messi	Lionel Messi
Padova	Padovo
Xacoiztatl	Boro
Mikołaj Kopernik	Koperniko
Tecolli	Karbono
Ehēcatehuiltic	Nitrogeno
Bergamo	Bergamo
Ehēcayoh	Oksigeno
Nehnencācītlalli	Planedo
Cuīcayōtl	Muziko
Venezia	Venecio
Naruto	Naruto (mangao)
Moscohuia	Moskvo
Italiatlahtōlli	Itala lingvo
Techichi	Ĉivava hundo
Yancuīquehēcatl	Neono
Chihuahhua	Chihuahua
Sankt Peterburg	Sankt-Peterburgo
Chad	Ĉado
Yancuīc Zetlālpan	Nov-Zelando
India	Barato
Tecpatepozteuh	Silicio
Tuvalu	Tuvalo
Tlīltic tepoztli	Fero
Tonga	Tongo
Tlequiquiztlālli	Sulfuro
Samoa	Samoo
Salomón Tlālhuāctli	Salomonoj
Vanuatu	Vanuatuo
Papua Yancuīc Guinea	Papuo-Nov-Gvineo
William Shakespeare	William Shakespeare
Palaos	Palaŭo
Nauru	Nauro
Micronesia	Federacio de Mikronezio
Tenextepoztli	Kalcio
Temētztli	Plumbo
Marshall Tlālhuāctli	Marŝala Insularo
Quiribati	Kiribato
Mongolia	Mongolio
Fiyi	Fiĝioj
Venezuela	Venezuelo
Cuappatōlli	Ŝako
Maine	Majno
Tlapāltepoztli	Kromo
Cahuāyoh	Ĉevalo
Amsterdam	Amsterdamo
Yōlcatl	Bestoj
Surinam	Surinamo
Paraguay	Paragvajo
Guyana	Gujano
Tōltēcayōtl	Arto
Ecuador	Ekvadoro
Colombia	Kolombio
Iztāctepoztli	Nikelo
Bolivia	Bolivio
Chīchīltic tepoztli	Kupro
Trinidad īhuān Tobago	Trinidado kaj Tobago
Tlanelhuayōtl	Plantoj
San Vicente īhuān in Granadinas	Sankta Vincento kaj Grenadinoj
Yancuīc Hampshire	Nov-Hampŝiro
Santa Lucía	Sankta Lucio
Leonardo da Vinci	Leonardo da Vinci
San Cristóbal īhuān Nevis	Sankta-Kito kaj Neviso
Nanacatl	Fungoj
Xamaica	Jamajko
Granada (tlācatiyān)	Grenado (lando)
Massachusetts	Masaĉuseco
Cuauhtēmallān	Gvatemalo
Bahamas	Bahamoj
Connecticut	Konektikuto
Cuānaca	Koko
Antigua īhuān Barbuda	Antigvo-Barbudo
Hawaii	Havajo
Honduras	Honduro
Dominica	Dominiko
Domingotlācatlahtohcāyōtl	Domingo
Ilhuicaātl Ártico	Arkta Oceano
Haiti	Haitio
Cōzcatlān	Salvadoro
Iran	Irano
Irac	Irako
Alaska	Alasko
Costa Rica	Kostariko
Israel	Israelo
Utrecht	Utrecht
Panama	Panamo
Yemen	Jemeno
Poloniatlahtōlli	Pola lingvo
Iordania	Jordanio
Nicānāhuac	Nikaragvo
Florida	Florido
Quirhuistan	Kirgizio
Arizona	Arizono
Cuhuait	Kuvajto
Lao	Laoso
Libano	Libano
Oregon	Oregono
Maldivas	Maldivoj
Ixachitlān	Ameriko
Utah	Utaho
Cuācuahueh	Bovo
Malasia	Malajzio
Mianma	Birmo
Nepal	Nepalo
Omān	Omano
Paquistan	Pakistano
Catar	Kataro
Saudarabia	Sauda Arabio
Sri Lanca	Sri-Lanko
Siria	Sirio
Plátōn	Platono
Tayiquistan	Taĝikio
Pokémon	Pokemono
Taihuan	Respubliko Ĉinio
YouTube	YouTube
Aristotelēs	Aristotelo
Taitlālpan	Tajlando
Tepozcōātl	Trajno
Turcmenistan	Turkmenio
Tlacetilīlli Arabiaemiryōtl	Unuiĝintaj Arabaj Emirlandoj
Vietnam	Vjetnamio
Charles Chaplin	Charlie Chaplin
Novosibirsk	Novosibirsko
Corea Huitztlāmpa	Sud-Koreio
The Simpsons	La Simpsonoj
Yekaterinburg	Jekaterinburg
Afganistan	Afganio
Nizhniy Novgorod	Niĵnij Novgorod
J.R.R. Tolkien	John Ronald Reuel Tolkien
Cōztic teōcuitlatl	Oro
Omsk	Omsk
Tlamatiliztlācatl	Sciencisto
Bangladex	Bangladeŝo
Chelyabinsk	Ĉeljabinsk
Rostov na Donu	Rostov-na-Donu
Mali	Malio
Sōcratēs	Sokrato
Volgograd	Volgogrado
Angola	Angolo
Butan	Butano
Brunei	Brunejo
Tanzania	Tanzanio
Yōliamochitl	Hidrargo
Roald Amundsen	Roald Amundsen
Filipinas	Filipinoj
Tlācatlahtohcāyōtl Tlahco Africa	Centr-Afrika Respubliko
Isaac Newton	Isaac Newton
Albert Einstein	Albert Einstein
Cōztic	Flava
Togo	Togolando
Tunez	Tunizio
Zambia	Zambio
Zimbahue	Zimbabvo
Pequin	Pekino
Sudan Huitztlāmpa	Sud-Sudano
Benin	Benino
Botzhuana	Bocvano
Burquina Faso	Burkino
Burundi	Burundo
Comoras	Komoroj
Tlācatlahtohcāyōtl in Congo	Respubliko Kongo
Tlācatlahtohcāyōtl Tlācatēpacholiztli in Congo	Demokratia Respubliko Kongo
San Antonio, Texas	San Antonio (Teksaso)
Yibuti	Ĝibutio
Bavaria	Bavario
Guinea Tlahcotlālticpac	Ekvatora Gvineo
Baden-Württemberg	Baden-Virtembergo
Eritrea	Eritreo
Yancuīc Delhi	Nov-Delhio
Ioannes Paulus II	Johano Paŭlo la 2-a
Tibilisi	Tbiliso
Conētzintli	Bebo
Gabon	Gabono
Gambia	Gambio
Guinea	Gvineo
Guinea Bissau	Gvineo Bisaŭa
Tlanomihuēyātēnco	Ebur-Bordo
Camerun	Kameruno
Cabo Xoxoctic	Kaboverdo
Lesoto	Lesoto
Liberia	Liberio
Libia	Libio
Madagascar	Madagaskaro
Malahui	Malavio
Stuttgart	Stutgarto
Mauritania	Maŭritanio
Mauricio	Maŭricio
Marruecos	Maroko
Mozambique	Mozambiko
Namibia	Namibio
Niger	Niĝero
Nigeria	Niĝerio
Charles Darwin	Charles Darwin
Uganda	Ugando
Ruanda	Ruando
Santo Tomé īhuān Tlahtohcāpilli	Sao-Tomeo kaj Principeo
Senegal	Senegalo
Seychelles	Sejŝeloj
Sierra Leona	Siera-Leono
Somalia	Somalio
Nextictepoztli	Niobio
Julius Caesar	Julio Cezaro
Sudan	Sudano
Suazitlālpan	Svazilando
Cōzamālōtl	Ĉielarko
Hamburg	Hamburgo
Tlacetilīlli Tlācatiyān	Unuiĝintaj Nacioj
Dante Alighieri	Dante Alighieri
Tlālmatiliztli	Geologio
Cemānāhuacāyōtl	Geografio
Yōllōtl	Koro
Cuāyōllōtl	Cerbo
Cuetlaxtli	Haŭto
Tlapālli	Koloro
Praha	Prago
Texohtic	Blua
Iztāc teōcuitlatl	Arĝento
Amochitl	Stano
Ilhuicateōtepoztli	Uranio
Mictlāntēuctepoztli	Plutonio
Tlāloctepoztli	Neptunio
Anime	Animeo
Nelnextictepoztli	Tantalo
Bill Clinton	William J. Clinton
Mumbai	Mumbajo
Michigan	Miĉigano
Aquitania	Akvitanio
Puerto Rico	Porto-Riko
Schleswig-Holstein	Ŝlesvigo-Holstinio
Mecklenburg-Pommern Cihuātlāmpa	Meklenburgo-Antaŭpomerio
Tlani Saxonia	Malsupra Saksio
Rhein Mictlāmpa-Westfalen	Nordrejn-Vestfalio
Hessen	Hesio
Rheinland-Pfalz	Rejnlando-Palatinato
Saarland	Sarlando
Saxonia	Saksio
John Lennon	John Lennon
Illinois	Ilinojso
Thüringen	Turingio
Saxonia-Anhalt	Saksio-Anhalto
Dakota Mictlāmpa	Norda Dakoto
Brandenburg	Brandenburgio
Bremen	Libera hansa urbo Bremeno
Lombardia	Lombardujo
Dakota Huitztlāmpa	Suda Dakoto
Montana	Montano
Wyoming	Vajomingo
Ierusalem	Jerusalemo
Idaho	Idaho
Washington	Vaŝingtonio
Nevada	Nevado
Ilhuicaātl Índico	Hinda Oceano
Cosovo	Kosovo
Huēyātl Caribe	Kariba Maro
Ban Ki-moon	Ban Ki-moon
Kofi Annan	Kofi Annan
Javier Pérez de Cuéllar	Javier Pérez de Cuéllar
Colorado	Koloradio
Frédéric Chopin	Frédéric Chopin
Neneuhcāyōtl:Índice de categorías	Kategorio:Ĉio
Gent	Gento (urbo)
Chicago	Ĉikago
The Beatles	The Beatles
Maastricht	Maastricht
Cehuetzilizpan	Vintro
Xōxōpan	Printempo
Xōpantlah	Somero
Pixcayān	Aŭtuno
Caxtillāntlahtōlli	Hispana lingvo
Montevideo	Montevideo
Johann Sebastian Bach	Johann Sebastian Bach
Antonio Vivaldi	Antonio Vivaldi
Opera	Opero
Calcuta	Kolkato
Daca	Dako
Tocatl	Araneuloj
Islamabad	Islamabado
Ozomahtli	Simio
Virginia	Virginio (ŝtato)
Virginia Tlāpcopa	Okcidenta Virginio
Yancuīc York	Nov-Jorkio
Rhode Island	Rod-Insulo
Yolcatzin	Insekto
Maryland	Marilando
Delaware	Delavaro
Ohio	Ohio
Pennsylvania	Pensilvanio
Uetersen	Uetersen
Augustus	Aŭgusto Cezaro
Yancuīc Jersey	Nov-Ĵerzejo
Fintlahtōlli	Finna lingvo
Indiana	Indianio
Nokia	Nokia (kompanio)
Tepozmalacatl	Aŭtomobilo
Georgia (Tlacetilīlli Tlahtohcāyōtl)	Georgio
Zagreb	Zagrebo
Texas	Teksaso
Genova	Ĝenovo
Carolina Mictlāmpa	Norda Karolino
Carolina Huitztlāmpa	Suda Karolino
Calabria	Kalabrio
Sicilia	Sicilio
Manillah	Manilo
Sardegna	Sardio
Feltre	Feltre
Buenos Aires	Bonaero
Āltepētl Mēxihco	Meksik-urbo
Tōquiō	Tokio
La Paz, Bolivia	La-Pazo
Barcelona	Barcelono
Matzahtli	Ananaso
Mississippi	Misisipio
Tennessee	Tenesio
Richard Wagner	Richard Wagner
Astana	Astano
Yancuīc Mēxihco	Nov-Meksiko
Atēna	Ateno
Minnesota	Minesoto
Bagdād	Bagdado
Caracas	Karakaso
Tlatēcpānalli cemānāhuaccāhuitl	UTC
Wisconsin	Viskonsino
Iowa	Iovao
Nebraska	Nebrasko
Āltepētl Cuauhtēmallān	Gvatemalurbo
Kansas	Kansaso
La Ahuana	Havano
Inditlahtōlli	Hindia lingvo
Maratitlahtōlli	Marata lingvo
Missouri	Misurio
Louisiana	Luiziano
Kentucky	Kentukio
Arkansas	Arkansaso
Urdutlahtōlli	Urduo
Oklahoma	Oklahomo
Danubio	Danubo
Kiel	Kilo (urbo)
Schwerin	Schwerin
Potsdam	Potsdamo
Hannover	Hanovro
Düsseldorf	Duseldorfo
Mainz	Majenco
Wiesbaden	Wiesbaden
Saarbrücken	Saarbrücken
Munich	Munkeno
Erfurt	Erfurto
Dresden	Dresdeno
Magdeburg	Magdeburgo
Innsbruck	Innsbruck
Viena	Vieno
Madonna	Madonna
Copenague	Kopenhago
Estocolmo	Stokholmo
Helsinqui	Helsinko
Dublin	Dublino
Reikiavik	Rejkjaviko
Tallin	Talino
Rīga	Rigo
Bratislava	Bratislavo
Budapest	Budapeŝto
Gdansk	Gdańsk
Frankfurt in Main	Frankfurto ĉe Majno
Wroclaw	Vroclavo
Cemānāuhtic Quixtianayōtl	Katolikismo
Vaduz	Vaduzo
Teōāmoxtli	Biblio
Āltepētl San Marino	San-Marino (urbo)
Nom Pen	Pnom-Peno
Āltepētl Ho Chi Minh	Ho-Ĉi-Min-urbo
Hanoi	Hanojo
Jesús Nelli Iglesia	Vera Eklezio de Jesuo
Inglatlahtōlli	Angla lingvo
Andorra in Huehcāuh	Andoro Malnova
Dong Hoi	Dong Hoi
Concepción, Chile	Koncepciono
Bologna	Bolonjo
Cagliari	Kaljaro
Kiev	Kievo
Ontario	Ontario
Ottawa	Otavo
Huēyitzitzimicītlalli īmētz	Naturaj satelitoj de Jupitero
Yuba	Ĵubo
Manitoba	Manitobo
Alberta	Alberto
Yancuīc Escocia	Nov-Skotio
Erevan	Erevano
Końskowola	Końskowola
Formula 1	Formulo 1
Tzitzimicītlalli īmētz	Naturaj satelitoj de Saturno
British Columbia	Brita Kolumbio
2000	2000
2003	2003
2002	2002
2001	2001
Saskatchewan	Saskaĉevano
2012	2012
2011	2011
2010	2010
2009	2009
2013	2013
2014	2014
2015	2015
2008	2008
Yukon	Jukonio
2004	2004
2005	2005
2006	2006
Nunavut	Nunavuto
2007	2007
Verona	Verono
1900	1900
1901	1901
1902	1902
Florencia	Florenco
1903	1903
1904	1904
1905	1905
1907	1907
1906	1906
1908	1908
1909	1909
1992	1992
1991	1991
1990	1990
1993	1993
Essen	Essen
1994	1994
1995	1995
1996	1996
1910	1910
1911	1911
1912	1912
Leipzig	Leipzig
1913	1913
1914	1914
1915	1915
1916	1916
1997	1997
1998	1998
Nürnberg	Nurenbergo
1999	1999
1917	1917
1918	1918
Tlacualli	Manĝaĵo
Cōātl	Serpento
Onohuayān Arica īhuān Parinacota	Arikio kaj Parinakotio
Onohuayān Antofagasta	Antofagasta (regiono)
Onohuayān Atacama	Regiono Atakamo
Onohuayān Coquimbo	Kokimbio
Winnipeg	Vinipego
Tlāloccītlalli īmētz	Naturaj satelitoj de Neptuno
Āltepētl Quebec	Kebeko
1 ic cē mētztli	1-a de januaro
2 ic cē mētztli	2-a de januaro
Ilhuicateōcītlalli īmētz	Naturaj satelitoj de Urano
1920	1920
3 ic cē mētztli	3-a de januaro
1919	1919
1921	1921
1922	1922
Onohuayān Maule	Maule (Ĉilio)
4 ic cē mētztli	4-a de januaro
1923	1923
Onohuayān Biobío	Biobío
1924	1924
Onohuayān La Araucanía	Araŭkanio
Onohuayān Los Lagos	Los Lagos
5 ic cē mētztli	5-a de januaro
Arica	Arica (Ĉilia urbo)
UTC-7	UTC-07:00
6 ic cē mētztli	6-a de januaro
7 ic cē mētztli	7-a de januaro
8 ic cē mētztli	8-a de januaro
9 ic cē mētztli	9-a de januaro
10 ic cē mētztli	10-a de januaro
11 ic cē mētztli	11-a de januaro
12 ic cē mētztli	12-a de januaro
13 ic cē mētztli	13-a de januaro
14 ic cē mētztli	14-a de januaro
15 ic cē mētztli	15-a de januaro
16 ic cē mētztli	16-a de januaro
17 ic cē mētztli	17-a de januaro
18 ic cē mētztli	18-a de januaro
19 ic cē mētztli	19-a de januaro
20 ic cē mētztli	20-a de januaro
21 ic cē mētztli	21-a de januaro
22 ic cē mētztli	22-a de januaro
23 ic cē mētztli	23-a de januaro
Roma Emperadoryōtl	Romia Imperio
24 ic cē mētztli	24-a de januaro
25 ic cē mētztli	25-a de januaro
Minsk	Minsko
26 ic cē mētztli	26-a de januaro
27 ic cē mētztli	27-a de januaro
28 ic cē mētztli	28-a de januaro
29 ic cē mētztli	29-a de januaro
30 ic cē mētztli	30-a de januaro
31 ic cē mētztli	31-a de januaro
2 Tlamahtlācōnti	2-a de decembro
1 Tlamahtlācōnti	1-a de decembro
Tlamahtlācōnti 3	3-a de decembro
Tlamahtlācōnti 7	7-a de decembro
Tlamahtlācōnti 5	5-a de decembro
Tlamahtlācōnti 8	8-a de decembro
Tlamahtlācōnti 10	10-a de decembro
Tlamahtlācōnti 6	6-a de decembro
Tlamahtlācōnti 9	9-a de decembro
Pink Floyd	Pink Floyd
AvtoVAZ	AvtoVAZ
Tlamahtlācōnti 4	4-a de decembro
1 Tlaōnti	1-a de februaro
2 Tlaōnti	2-a de februaro
3 Tlaōnti	3-a de februaro
Kurów	Kurów
Tlaōnti 4	4-a de februaro
Tlaōnti 5	5-a de februaro
Tlaōnti 6	6-a de februaro
Tlaōnti 7	7-a de februaro
Tlaōnti 8	8-a de februaro
Tlaōnti 9	9-a de februaro
10 Tlaōnti	10-a de februaro
14 Tlaōnti	14-a de februaro
13 Tlaōnti	13-a de februaro
15 Tlaōnti	15-a de februaro
11 Tlaōnti	11-a de februaro
12 Tlaōnti	12-a de februaro
19 Tlaōnti	19-a de februaro
17 Tlaōnti	17-a de februaro
16 Tlaōnti	16-a de februaro
18 Tlaōnti	18-a de februaro
Tlaōnti 20	20-a de februaro
21 Tlaōnti	21-a de februaro
Tlaōnti 22	22-a de februaro
Tlaōnti 23	23-a de februaro
24 tlaōnti	24-a de februaro
25 tlaōnti	25-a de februaro
Tlaōnti 26	26-a de februaro
27	27
Tlaōnti 27	27-a de februaro
Tlaōnti 28	28-a de februaro
Tlamahtlācōnti 11	11-a de decembro
Tlaōnti 29	29-a de februaro
Tlamahtlācōnti 12	12-a de decembro
Tlamahtlācōnti 13	13-a de decembro
Tlamahtlācōnti 14	14-a de decembro
Tlamahtlācōnti 15	15-a de decembro
Tlayēti 2	2-a de marto
Tlayēti 3	3-a de marto
Tlayēti 5	5-a de marto
Tlayēti 1	1-a de marto
Tlayēti 7	7-a de marto
Tlayēti 8	8-a de marto
Tlayēti 4	4-a de marto
Tlayēti 10	10-a de marto
11 tlayēti	11-a de marto
Tlayēti 6	6-a de marto
Tlayēti 13	13-a de marto
Tlayēti 9	9-a de marto
12 tlayēti	12-a de marto
Tlayēti 15	15-a de marto
Tlayēti 14	14-a de marto
Tlamahtlācōnti 16	16-a de decembro
Tlamahtlācōnti 17	17-a de decembro
Tlayēti 16	16-a de marto
Tlayēti 17	17-a de marto
Tlayēti 18	18-a de marto
Tlayēti 19	19-a de marto
1989	1989
1988	1988
Tlayēti 20	20-a de marto
1987	1987
1986	1986
1985	1985
1984	1984
Tlayēti 21	21-a de marto
1983	1983
Tlayēti 22	22-a de marto
1982	1982
1981	1981
Tlamahtlācōnti 18	18-a de decembro
1980	1980
Tlayēti 23	23-a de marto
19 tlamahtlācōnti	19-a de decembro
Tlayēti 24	24-a de marto
Tlayēti 25	25-a de marto
Tlamahtlācōnti 20	20-a de decembro
Tlayēti 26	26-a de marto
Tlayēti 27	27-a de marto
Tlayēti 28	28-a de marto
Tlayēti 29	29-a de marto
Tlayēti 30	30-a de marto
Tlayēti 31	31-a de marto
Nassau	Nasaŭo (Bahamoj)
1970	1970
1971	1971
1972	1972
1973	1973
1974	1974
1975	1975
1976	1976
1977	1977
1978	1978
1979	1979
1969	1969
Konrad Adenauer	Konrad Adenauer
Benedictus XVI	Benedikto la 16-a
Ludwig Erhard	Ludwig Erhard
15 Tlanāuhti	15-a de aprilo
Tlanāuhti 13	13-a de aprilo
Tlanāuhti 12	12-a de aprilo
Tlanāuhti 14	14-a de aprilo
Tlanāuhti 11	11-a de aprilo
Tlanāuhti 10	10-a de aprilo
Tlanāuhti 8	8-a de aprilo
Tlanāuhti 9	9-a de aprilo
7 tlanāuhti	7-a de aprilo
Tlanāuhti 6	6-a de aprilo
Tlanāuhti 5	5-a de aprilo
Tlanāuhti 4	4-a de aprilo
Tlanāuhti 3	3-a de aprilo
Tlanāuhti 1	1-a de aprilo
Tlanāuhti 2	2-a de aprilo
Kurt Georg Kiesinger	Kurt Georg Kiesinger
Willy Brandt	Willy Brandt
Helmut Schmidt	Helmut Schmidt
Helmut Kohl	Helmut Kohl
Tlanāuhti 16	16-a de aprilo
Tlanāuhti 17	17-a de aprilo
Tlanāuhti 18	18-a de aprilo
Tlanāuhti 19	19-a de aprilo
20 Tlanāuhti	20-a de aprilo
Tlanāuhti 21	21-a de aprilo
22 Tlanāuhti	22-a de aprilo
Tlanāuhti 23	23-a de aprilo
Tlanāuhti 24	24-a de aprilo
Gerhard Schröder	Gerhard Schröder
Tlanāuhti 25	25-a de aprilo
Tlanāuhti 26	26-a de aprilo
Tlanāuhti 27	27-a de aprilo
Tlanāuhti 28	28-a de aprilo
Tlanāuhti 29	29-a de aprilo
Tlanāuhti 30	30-a de aprilo
Christian Wulff	Christian Wulff
Horst Köhler	Horst Köhler
Tlamācuīlti 1	1-a de majo
Tlamācuīlti 2	2-a de majo
Tlamācuīlti 3	3-a de majo
Tlamācuīlti 4	4-a de majo
Tlamācuīlti 5	5-a de majo
Johannes Rau	Johannes Rau
Tlamācuīlti 6	6-a de majo
Tlamācuīlti 7	7-a de majo
Tlamācuīlti 8	8-a de majo
Tlamācuīlti 9	9-a de majo
Tlamācuīlti 10	10-a de majo
Tlamācuīlti 11	11-a de majo
Tlamācuīlti 12	12-a de majo
Tlamācuīlti 13	13-a de majo
Tlamācuīlti 14	14-a de majo
Tlamācuīlti 15	15-a de majo
Tlamācuīlti 16	16-a de majo
Tlamācuīlti 17	17-a de majo
Tlamācuīlti 18	18-a de majo
Tlamācuīlti 19	19-a de majo
Tlamācuīlti 20	20-a de majo
Tlamācuīlti 21	21-a de majo
Tlamācuīlti 22	22-a de majo
Tlamācuīlti 23	23-a de majo
Tlamācuīlti 24	24-a de majo
Tlamācuīlti 25	25-a de majo
Tlamācuīlti 26	26-a de majo
Tlamācuīlti 27	27-a de majo
Tlamācuīlti 28	28-a de majo
Tlamācuīlti 29	29-a de majo
Tlamācuīlti 30	30-a de majo
Tlamācuīlti 31	31-a de majo
Paul McCartney	Paul McCartney
Tlamahtlācōnti 21	21-a de decembro
Erich Honecker	Erich Honecker
Tlachicuazti 14	14-a de junio
Tlachicuazti 15	15-a de junio
Tlachicuazti 13	13-a de junio
Tlachicuazti 10	10-a de junio
7 Tlachicuazti	7-a de junio
Tlachicuazti 11	11-a de junio
9 Tlachicuazti	9-a de junio
Tlachicuazti 12	12-a de junio
6 Tlachicuazti	6-a de junio
8 Tlachicuazti	8-a de junio
5 Tlachicuazti	5-a de junio
3 Tlachicuazti	3-a de junio
2 Tlachicuazti	2-a de junio
1 Tlachicuazti	1-a de junio
4 Tlachicuazti	4-a de junio
Ringo Starr	Ringo Starr
Napoli	Napolo
Tlamahtlācōnti 22	22-a de decembro
George Harrison	George Harrison
1968	1968
Friedrich Ebert	Friedrich Ebert
1967	1967
1966	1966
1965	1965
1964	1964
Tlachicuazti 16	16-a de junio
Palermo	Palermo
Tlachicuazti 30	30-a de junio
Tlachicuazti 29	29-a de junio
Tlachicuazti 28	28-a de junio
Tlachicuazti 26	26-a de junio
Tlachicuazti 25	25-a de junio
Tlachicuazti 22	22-a de junio
Tlachicuazti 27	27-a de junio
Tlachicuazti 24	24-a de junio
Tlachicuazti 20	20-a de junio
Paul von Hindenburg	Paul von Hindenburg
Tlachicuazti 23	23-a de junio
Tlachicuazti 19	19-a de junio
Tlachicuazti 18	18-a de junio
Tlachicuazti 21	21-a de junio
Tlachicuazti 17	17-a de junio
Tlamahtlācōnti 23	23-a de decembro
Bruce Willis	Bruce Willis
Tlachicōnti 15	15-a de julio
13 Tlachicōnti	13-a de julio
Tlachicōnti 12	12-a de julio
10 Tlachicōnti	10-a de julio
Tlachicōnti 9	9-a de julio
Tlachicōnti 14	14-a de julio
Tlachicōnti 8	8-a de julio
Tlachicōnti 7	7-a de julio
Tlachicōnti 6	6-a de julio
Tlachicōnti 5	5-a de julio
Tlachicōnti 2	2-a de julio
Tlachicōnti 4	4-a de julio
Tlachicōnti 3	3-a de julio
1 Tlachicōnti	1-a de julio
Tlachicōnti 11	11-a de julio
Tlamahtlācōnti 24	24-a de decembro
Tlachicōnti 31	31-a de julio
Tlachicōnti 30	30-a de julio
Tlachicōnti 29	29-a de julio
Tlachicōnti 28	28-a de julio
Tlachicōnti 27	27-a de julio
Tlachicōnti 25	25-a de julio
Tlachicōnti 24	24-a de julio
Tlachicōnti 23	23-a de julio
Tlachicōnti 26	26-a de julio
Tlachicōnti 22	22-a de julio
Tlachicōnti 19	19-a de julio
Tlachicōnti 21	21-a de julio
Tlachicōnti 20	20-a de julio
Tlachicōnti 17	17-a de julio
Tlachicōnti 18	18-a de julio
Tlachicōnti 16	16-a de julio
Neicxitapayōlhuiliztli	Futbalo
Tlamahtlācōnti 25	25-a de decembro
Augsburg	Augsburg
1963	1963
Tlamahtlācōnti 26	26-a de decembro
1962	1962
Tlachicuēiti 14	14-a de aŭgusto
Tlachicuēiti 15	15-a de aŭgusto
Tlachicuēiti 13	13-a de aŭgusto
Tlachicuēiti 12	12-a de aŭgusto
Tlachicuēiti 11	11-a de aŭgusto
Tlachicuēiti 10	10-a de aŭgusto
Tlachicuēiti 8	8-a de aŭgusto
Tlachicuēiti 7	7-a de aŭgusto
Tlachicuēiti 9	9-a de aŭgusto
Tlachicuēiti 5	5-a de aŭgusto
Tlachicuēiti 4	4-a de aŭgusto
Tlachicuēiti 2	2-a de aŭgusto
Tlachicuēiti 3	3-a de aŭgusto
Tlachicuēiti 6	6-a de aŭgusto
Tlachicuēiti 1	1-a de aŭgusto
Tlamahtlācōnti 27	27-a de decembro
Madrid	Madrido
Tlachicuēiti 16	16-a de aŭgusto
Coca-Cola	Koka-kolao
Tlachicuēiti 29	29-a de aŭgusto
Tlachicuēiti 28	28-a de aŭgusto
Tlachicuēiti 30	30-a de aŭgusto
Tlachicuēiti 25	25-a de aŭgusto
Tlachicuēiti 26	26-a de aŭgusto
23 Tlachicuēiti	23-a de aŭgusto
Tlachicuēiti 27	27-a de aŭgusto
Tlachicuēiti 21	21-a de aŭgusto
Tlachicuēiti 20	20-a de aŭgusto
Tlachicuēiti 24	24-a de aŭgusto
Tlachicuēiti 18	18-a de aŭgusto
Tlachicuēiti 17	17-a de aŭgusto
Tlachicuēiti 22	22-a de aŭgusto
Tlachicuēiti 19	19-a de aŭgusto
Tlachicuēiti 31	31-a de aŭgusto
Michael Jackson	Michael Jackson
Tlamahtlācōnti 28	28-a de decembro
Freiburg im Breisgau	Freiburg
Bogotá	Bogoto
Brasilia	Braziljo
Tlachiucnāuhti 15	15-a de septembro
Tlachiucnāuhti 14	14-a de septembro
Tlachiucnāuhti 13	13-a de septembro
Tlachiucnāuhti 12	12-a de septembro
Tlachiucnāuhti 8	8-a de septembro
Tlachiucnāuhti 11	11-a de septembro
Tlachiucnāuhti 7	7-a de septembro
Tlachiucnāuhti 10	10-a de septembro
Tlachiucnāuhti 5	5-a de septembro
Tlachiucnāuhti 4	4-a de septembro
Tlachiucnāuhti 9	9-a de septembro
Tlachiucnāuhti 2	2-a de septembro
Tlachiucnāuhti 6	6-a de septembro
Tlachiucnāuhti 1	1-a de septembro
Tlachiucnāuhti 3	3-a de septembro
Tlamahtlācōnti 29	29-a de decembro
Lima	Limo
Tlachiucnāuhti 30	30-a de septembro
Tlachiucnāuhti 29	29-a de septembro
Tlachiucnāuhti 28	28-a de septembro
27 tlachiucnāuhti	27-a de septembro
Tlachiucnāuhti 26	26-a de septembro
Tlachiucnāuhti 25	25-a de septembro
Santiago de Chile	Santiago de Ĉilio
Tlachiucnāuhti 23	23-a de septembro
Tlachiucnāuhti 22	22-a de septembro
Tlachiucnāuhti 24	24-a de septembro
Tlachiucnāuhti 21	21-a de septembro
Tlachiucnāuhti 20	20-a de septembro
Tlachiucnāuhti 18	18-a de septembro
Tlachiucnāuhti 17	17-a de septembro
Tlachiucnāuhti 19	19-a de septembro
16 tlachiucnāuhti	16-a de septembro
Quito	Kito
Tlamahtlācōnti 30	30-a de decembro
Sucre	Sukro
Tlamahtlācōnti 31	31-a de decembro
Tlamahtlācti 1	1-a de oktobro
Tlamahtlācti 15	15-a de oktobro
Tlamahtlācti 12	12-a de oktobro
Tlamahtlācti 10	10-a de oktobro
Tlamahtlācti 14	14-a de oktobro
Tlamahtlācti 9	9-a de oktobro
Tlamahtlācti 8	8-a de oktobro
Tlamahtlācti 13	13-a de oktobro
Tlamahtlācti 7	7-a de oktobro
Tlamahtlācti 11	11-a de oktobro
Tlamahtlācti 6	6-a de oktobro
4 Tlamahtlācti	4-a de oktobro
Tlamahtlācti 5	5-a de oktobro
Tlamahtlācti 3	3-a de oktobro
Tlamahtlācti 2	2-a de oktobro
Asunción	Asunciono
31 Tlamahtlācti	31-a de oktobro
Tlamahtlācti 30	30-a de oktobro
Tlamahtlācti 29	29-a de oktobro
Tlamahtlācti 28	28-a de oktobro
Tlamahtlācti 26	26-a de oktobro
Tlamahtlācti 25	25-a de oktobro
Tlamahtlācti 24	24-a de oktobro
Tlamahtlācti 27	27-a de oktobro
Tlamahtlācti 22	22-a de oktobro
Tlamahtlācti 23	23-a de oktobro
Tlamahtlācti 20	20-a de oktobro
Tlamahtlācti 21	21-a de oktobro
Tlamahtlācti 19	19-a de oktobro
Tlamahtlācti 17	17-a de oktobro
Tlamahtlācti 16	16-a de oktobro
Tlamahtlācti 18	18-a de oktobro
Heidelberg	Heidelberg
Ratisbona	Regensburg
Tlamahtlāccēti 15	15-a de novembro
Tlamahtlāccēti 14	14-a de novembro
Tlamahtlāccēti 13	13-a de novembro
Tlamahtlāccēti 12	12-a de novembro
Tlamahtlāccēti 11	11-a de novembro
Tlamahtlāccēti 10	10-a de novembro
Tlamahtlāccēti 7	7-a de novembro
Tlamahtlāccēti 8	8-a de novembro
Tlamahtlāccēti 9	9-a de novembro
Tlamahtlāccēti 6	6-a de novembro
Tlamahtlāccēti 5	5-a de novembro
Tlamahtlāccēti 4	4-a de novembro
Tlamahtlāccēti 3	3-a de novembro
Tlamahtlāccēti 2	2-a de novembro
Tlamahtlāccēti 1	1-a de novembro
Wurzburg	Würzburg
Paramaribo	Paramaribo
Ulm	Ulm
Tlamahtlāccēti 30	30-a de novembro
Tlamahtlāccēti 29	29-a de novembro
Tlamahtlāccēti 28	28-a de novembro
27 Tlamahtlāccēti	27-a de novembro
Tlamahtlāccēti 26	26-a de novembro
Tlamahtlāccēti 25	25-a de novembro
Tlamahtlāccēti 23	23-a de novembro
Tlamahtlāccēti 24	24-a de novembro
21 Tlamahtlāccēti	21-a de novembro
Tlamahtlāccēti 20	20-a de novembro
Tlamahtlāccēti 22	22-a de novembro
Tlamahtlāccēti 19	19-a de novembro
Tlamahtlāccēti 18	18-a de novembro
Tlamahtlāccēti 17	17-a de novembro
Tlamahtlāccēti 16	16-a de novembro
Belmopan	Belmopano
Carolus Magnus	Karolo la Granda
San José, Costa Rica	San-Joseo (Kostariko)
San Salvador	San-Salvadoro
Camberra	Kanbero
Sydney	Sidnejo
Xoxoctic	Verdo
Chīchīltic	Ruĝa
Tletl	Fajro
Tēuctzincalpan	Tegucigalpo
Mānāhuac	Managvo
Āltepētl Panama	Panamurbo
George Orwell	George Orwell
Aosta	Aosto
Trento	Trento
Nilo	Nilo
Perugia	Peruĝo
Bari	Bari
Rabāt	Rabato
Popōcacītlallīn	Kometo
Argel	Alĝero
Antofagasta	Antofagasta (urbo)
Tehrān	Teherano
Adis Abeba	Adis-Abebo
Yakarta	Ĝakarto
Ankara	Ankaro
Asmara	Asmaro
Yamena	Nĵameno
1961	1961
Bamako	Bamako
Belgrado	Beogrado
Banyul	Banĵulo
Conacri	Konakrio
Bissau	Bisaŭo
Neneuhcāyōtl:Nemachiyōtīlli	Kategorio:Vikipedio:Ŝablonoj
Praia	Prajo
1960	1960
Acra	Akrao
Damasco	Damasko
Yamusukro	Jamusukro
Chillán	Chillán
Uagadugu	Uagaduguo
Ātōyātl Amazonas	Amazono (rivero)
Abuya	Abuĝo
Porto Novo	Porto-Novo
Ammān	Amano
Yaundé	Jaundeo
Malabo	Malabo
Libreville	Librevilo
Malucca	Molukoj
Buyumbura	Buĵumburo
Nicosia	Nikozio
Doha	Doho
Copiapó	Copiapó (urbo)
Nairobi	Najrobo
Manāmah	Manamo
Catanzaro	Katanzaro
Luanda	Luando
Moroni	Moronio
Galicia	Galegio
Maseru	Maseruo
Huēyitlamachticalli	Universitato
Gaborone	Gaberono
Pretoria	Pretorio
Bamberg	Bamberg
Aschaffenburg	Aschaffenburg
Cantabria	Kantabrio
Chāntli	Domo
Liège	Lieĝo (urbo)
Vasconia	Eŭska Aŭtonoma Komunumo
Rosenheim	Rosenheim
Navarra	Navaro
Ātōyātl	Rivero
Osasco	Osasco (San-Paŭlo)
Aragón	Aragono
-36	-36
-20	-20
-40	-40
-39	-39
-37	-37
-22	-22
-38	-38
Cabo de Buena Esperanza	Kabo de Bona Espero
Glasgow	Glasgovo
-28	-28
-18	-18
-15	-15
-33	-33
Neu Ulm	Neu-Ulm
-30	-30
-12	-12
Ehēcalquixohuayān Dong Hoi	Flughaveno Dong Hoi
-45	-45
-46	-46
Passau	Passau
-41	-41
-49	-49
-42	-42
Tlīlcuauhtlah	Nigra Arbaro
-25	-25
-47	-47
-10	-10
Tlacetilīztli Huitzixachitēcatl Tlācatiyān	Komunumo Sudamerika de Nacioj
Curitiba	Kuritibo
Chīchīltechalōtl	Rufa sciuro
Cuauhtlah	Arbaro
Talca	Talkao
Anna Faris	Anna Faris
Neneuhcāyōtl:Ōmicqueh xiuhpan 1481	Kategorio:Mortintoj en 1481
Neneuhcāyōtl:Tuneztlācah	Kategorio:Personoj de Tunizio
Neneuhcāyōtl:Āltepētl īpan Liechtenstein	Kategorio:Komunumoj de Liĥtenŝtejno
Sean Connery	Sean Connery
Rancagua	Rancagua (Ĉilio)
Marilyn Monroe	Marilyn Monroe
Corbin Bleu	Corbin Bleu
Neneuhcāyōtl:Tlapōhualmatiliztli	Kategorio:Matematiko
Aimaratlahtōlli	Ajmara lingvo
Sherlock Holmes	Sherlock Holmes
Le Corbusier	Le Corbusier
Mēxihcatl peso	Meksika peso
1488	1488
Euro	Eŭro
1004	1004
Berlin pāntli	Berlina muro
Ācintli	Rizo
Céline Dion	Céline Dion
Cemantoc tlālli	Kontinento
Tōtōtl	Birdoj
Tēcuacān	Ĉefurbo
Monzón	Monzono
Portugallahtōlli	Portugala lingvo
Mētztli (cāhuitl)	Monato
1948	1948
1949	1949
Tlaōnti 2008	Februaro de 2008
Almazán	Almazán
Huang Xianfan	Huang Senfan
Quechhuatlahtōlli	Keĉua lingvaro
1956	1956
1200	1200
1201	1201
1202	1202
1203	1203
1204	1204
1205	1205
1206	1206
1941	1941
1207	1207
1208	1208
1945	1945
1209	1209
1210	1210
1211	1211
1958	1958
1212	1212
1926	1926
1213	1213
1947	1947
1944	1944
1952	1952
Bill Gates	Bill Gates
Xapontlahtōlli	Japana lingvo
Cēntlamatilizāmoxtli	Enciklopedio
Vīdeocaquizcopīnalōni	DVD
Calīxatl	Vikipedio:Ĉefpaĝo
1959	1959
Nemachiyōtīlli:Cualli tlahcuilōlli	Ŝablono:Leginda
1957	1957
1214	1214
1215	1215
Chiquiuhtapayōlhuiliztli	Korbopilkado
1216	1216
1217	1217
1218	1218
UTC-6	UTC-06:00
Mimalacatl	Aŭtosporto
1219	1219
Olimpicayoh neāhuiltiliztli	Olimpiaj ludoj
UTC-5	UTC-05:00
1220	1220
1221	1221
1222	1222
1223	1223
1224	1224
1225	1225
1226	1226
1227	1227
1228	1228
1229	1229
1230	1230
1231	1231
1232	1232
1233	1233
1234	1234
1235	1235
1236	1236
1237	1237
1238	1238
1239	1239
1240	1240
1241	1241
1242	1242
1243	1243
1244	1244
1245	1245
1246	1246
Āltepētl In Cabo	Kaburbo
Chuvasia	Ĉuvaŝio
1247	1247
1248	1248
1249	1249
1250	1250
1251	1251
1252	1252
1253	1253
1254	1254
1255	1255
1256	1256
Tepozocuilin	Metroo
1257	1257
1258	1258
1259	1259
1260	1260
1261	1261
1262	1262
1263	1263
1264	1264
1265	1265
1266	1266
1267	1267
1268	1268
1269	1269
1270	1270
1271	1271
1272	1272
1273	1273
1274	1274
1275	1275
1276	1276
1277	1277
1278	1278
1279	1279
1280	1280
1281	1281
1282	1282
1283	1283
1284	1284
1285	1285
1286	1286
1287	1287
1288	1288
1289	1289
1290	1290
1291	1291
1292	1292
1293	1293
1294	1294
1295	1295
1296	1296
1297	1297
1298	1298
1299	1299
Salvador Dalí	Salvador Dalí
Albrecht Dürer	Albrecht Dürer
Vincent van Gogh	Vincent van Gogh
Frida Kahlo	Frida Kahlo
Pablo Picasso	Pablo Picasso
Frank Lloyd Wright	Frank Lloyd Wright
1300	1300
1301	1301
1302	1302
1303	1303
1304	1304
1305	1305
Miguel de Cervantes	Miguel de Cervantes
Charles Dickens	Charles Dickens
Catalania	Katalunio
1306	1306
1307	1307
Cemāxcāyōtl Valencia	Valencilando
1308	1308
1309	1309
La Rioja (Caxtillān)	Provinco Rioĥo
1310	1310
1311	1311
1312	1312
1313	1313
Castillān īhuān León	Kastilio kaj Leono
1314	1314
1315	1315
1316	1316
1317	1317
Castillān-La Mancha	Kastilio-Manĉo
1318	1318
Cemāxcāyōtl Madrid	Madrida Regiono
Baleares	Balearoj
1319	1319
1320	1320
1321	1321
1322	1322
1323	1323
Cemāxcāyōtl Murcia	Murcia Regiono
1324	1324
1325	1325
Belen	Bet-Leĥem
Extremadura	Ekstremaduro
1326	1326
Andalucía	Andaluzio
1327	1327
1328	1328
Ernesto Guevara	Che Guevara
Canarias	Kanarioj
Córdoba, Caxtillān	Kordovo (Hispanio)
Ceuta	Ceŭto
Melilla	Melilo
Toledo	Toledo
Kabul	Kabulo
Cuitlāmatl	Neceseja papero
Chichén Itzá	Chichén Itzá
Gabriel García Márquez	Gabriel García Márquez
Tamillahtōlli	Tamila lingvo
Tlazohmatiliztli	Filozofio
1329	1329
Neneuhcāyōtl:Huiquipedia:Borrar (definitivo)	Kategorio:Tujforigendaj artikoloj
Pianotli	Piano
1330	1330
1331	1331
1332	1332
1333	1333
1334	1334
1335	1335
1336	1336
1337	1337
1338	1338
1339	1339
1340	1340
1341	1341
1342	1342
1343	1343
1344	1344
1345	1345
1346	1346
1347	1347
1348	1348
1349	1349
1350	1350
Marco Polo	Marko Polo
1351	1351
Hebe Camargo	Hebe Camargo
1400	1400
1401	1401
1352	1352
1402	1402
1353	1353
1403	1403
1354	1354
1404	1404
1355	1355
1405	1405
1500	1500
1406	1406
1356	1356
1501	1501
1407	1407
1357	1357
1502	1502
1408	1408
1358	1358
1503	1503
1359	1359
1409	1409
1504	1504
1360	1360
1410	1410
1505	1505
1506	1506
1411	1411
1361	1361
1507	1507
1412	1412
1362	1362
1413	1413
1508	1508
1363	1363
1509	1509
1414	1414
1510	1510
1415	1415
1364	1364
1511	1511
1416	1416
1365	1365
1512	1512
1417	1417
1366	1366
Quintus Horatius Flaccus	Horacio
1513	1513
1418	1418
1367	1367
1514	1514
1419	1419
1368	1368
1515	1515
1420	1420
1369	1369
1516	1516
1421	1421
1370	1370
1371	1371
1372	1372
Pahuia	Pavio
1373	1373
1422	1422
1517	1517
1423	1423
1518	1518
1374	1374
1424	1424
1375	1375
1519	1519
1376	1376
1425	1425
1520	1520
1521	1521
1377	1377
1426	1426
1522	1522
1523	1523
1427	1427
1378	1378
1524	1524
1525	1525
1428	1428
1379	1379
1526	1526
1429	1429
1380	1380
1381	1381
1382	1382
1383	1383
1430	1430
1431	1431
1384	1384
1432	1432
1385	1385
1386	1386
1433	1433
1387	1387
1434	1434
1435	1435
1388	1388
1436	1436
1389	1389
1437	1437
1390	1390
1438	1438
1391	1391
1439	1439
1392	1392
1440	1440
Tlamānelōliztli	Naĝado
1393	1393
1394	1394
1395	1395
1441	1441
1396	1396
1397	1397
1442	1442
1527	1527
1528	1528
1398	1398
1443	1443
1444	1444
1529	1529
1399	1399
1445	1445
1530	1530
1446	1446
1531	1531
1447	1447
1532	1532
1448	1448
1533	1533
1449	1449
1534	1534
1450	1450
1535	1535
1451	1451
1536	1536
1452	1452
1537	1537
1453	1453
1538	1538
1454	1454
1539	1539
1455	1455
1540	1540
Neneuhcāyōtl:Ilhuicamatiliztli	Kategorio:Astronomio
1541	1541
1456	1456
1457	1457
1542	1542
1458	1458
1543	1543
1459	1459
1544	1544
Bolzano	Bolzano-Bozen
1460	1460
1545	1545
1461	1461
1546	1546
Günter Grass	Günter Grass
1462	1462
1547	1547
1463	1463
1548	1548
1464	1464
1549	1549
1465	1465
1550	1550
1466	1466
1551	1551
1467	1467
1468	1468
1552	1552
1469	1469
1553	1553
1470	1470
1554	1554
UTC+0	UTC±00:00
1471	1471
1555	1555
1472	1472
1556	1556
1473	1473
1557	1557
1474	1474
1558	1558
Strasbourg	Strasburgo
Mecahuēhuētl	Gitaro
1475	1475
1559	1559
1476	1476
1560	1560
1477	1477
1478	1478
1561	1561
1479	1479
1562	1562
1480	1480
1563	1563
1481	1481
1564	1564
1482	1482
1565	1565
Cuīlonyōtl	Samseksemo
1483	1483
1566	1566
1484	1484
1567	1567
1485	1485
1486	1486
1568	1568
Nepatlachhuiliztli	Samseksemulino
1487	1487
1569	1569
Croaciatlahtōlli	Kroata lingvo
UTC+1	UTC+01:00
1570	1570
Hamburtēcanacatl	Hamburgero
1489	1489
1571	1571
1490	1490
1572	1572
Tlācatecolōtl	Diablo
1491	1491
1573	1573
1492	1492
1574	1574
Renault	Renault
1493	1493
1575	1575
1494	1494
1495	1495
1496	1496
1576	1576
1497	1497
1577	1577
1498	1498
1578	1578
1499	1499
1579	1579
1580	1580
1581	1581
1582	1582
1600	1600
1601	1601
1583	1583
1602	1602
1584	1584
1603	1603
1585	1585
1604	1604
1586	1586
1605	1605
Peugeot	Peugeot
1587	1587
Citroën	Citroën
1606	1606
1607	1607
1588	1588
1608	1608
1589	1589
1609	1609
1590	1590
1610	1610
1591	1591
1611	1611
1592	1592
1612	1612
1593	1593
1613	1613
1594	1594
1614	1614
1595	1595
1615	1615
1596	1596
1616	1616
1597	1597
1617	1617
1598	1598
1618	1618
1599	1599
1619	1619
1620	1620
1621	1621
1700	1700
1701	1701
1622	1622
1623	1623
1702	1702
1624	1624
1703	1703
1704	1704
1625	1625
1705	1705
1626	1626
1627	1627
1706	1706
1628	1628
1707	1707
1708	1708
1629	1629
1630	1630
1709	1709
1631	1631
1710	1710
1632	1632
1711	1711
1633	1633
1712	1712
1634	1634
1713	1713
1800	1800
1801	1801
1714	1714
1635	1635
1802	1802
1715	1715
1636	1636
1803	1803
1637	1637
1716	1716
1638	1638
1804	1804
1717	1717
1639	1639
1805	1805
1718	1718
1640	1640
1719	1719
1806	1806
1641	1641
1720	1720
1807	1807
1642	1642
1721	1721
1808	1808
1643	1643
1722	1722
1809	1809
1644	1644
1723	1723
1810	1810
1645	1645
1724	1724
Mācuīlpōhualxihuitl XX	20-a jarcento
1811	1811
1646	1646
1725	1725
1812	1812
1647	1647
1726	1726
1813	1813
Mācuīlpōhualxihuitl XXI	21-a jarcento
1648	1648
1727	1727
1814	1814
1649	1649
1728	1728
1815	1815
1650	1650
1729	1729
1816	1816
Mācuīlpōhualxihuitl XIX	19-a jarcento
1651	1651
1730	1730
1817	1817
1652	1652
1731	1731
1818	1818
1653	1653
1732	1732
1819	1819
1654	1654
1733	1733
1820	1820
1655	1655
1821	1821
1734	1734
1656	1656
1822	1822
1735	1735
1657	1657
1823	1823
1736	1736
1658	1658
1737	1737
1824	1824
1659	1659
1738	1738
1825	1825
1660	1660
1739	1739
1826	1826
1661	1661
1740	1740
1827	1827
Mācuīlpōhualxihuitl 18	18-a jarcento
Mācuīlpōhualxihuitl 17	17-a jarcento
Mācuīlpōhualxihuitl 16	16-a jarcento
Mācuīlpōhualxihuitl 15	15-a jarcento
Catalantlahtōlli	Kataluna lingvo
Mācuīlpōhualxihuitl 14	14-a jarcento
Neneuhcāyōtl:Cīcītlaltin	Kategorio:Steloj
Girona	Ĝirono
Amberg	Amberg
Mācuīlpōhualxihuitl 13	13-a jarcento
Mācuīlpōhualxihuitl 12	12-a jarcento
Mācuīlpōhualxihuitl XI	11-a jarcento
Ahteōmatiliztli	Ateismo
Cemitquimatiliztli	Politiko
Tlācatēpacholiztli	Demokratio
Marie Curie	Marie Curie
Rosa Luxemburg	Roza Luksemburg
Centēpacholiztli	Monarkio
Pyotr Ilyich Tchaikovsky	Pjotr Iljiĉ Ĉajkovskij
Jacques Cartier	Jacques Cartier
Cristoforo Colombo	Kristoforo Kolumbo
Hernán Cortés	Hernán Cortés
Vasco da Gama	Vasco da Gama
Ilhuicaātl Antártico	Suda Oceano
Nacaztli	Orelo
Yacatl	Nazo (organo)
Īxtelolotl	Okulo
Cuīcatl	Kanto
Mōyōtl	Moskito
Ichcatl (yōlcatl)	Ŝafo
Federico Fellini	Federico Fellini
Alfred Hitchcock	Alfred Hitchcock
Cameyoh	Kamelo
Mammalia	Mamuloj
Elefante	Elefanto
Āzcatl	Formiko
Tlanitlālpantlahtōlli	Nederlanda lingvo
Ingmar Bergman	Ingmar Bergman
Canauhtli	Anasedoj
Nantli	Patrino
Cepayahuitl	Neĝo
Tahtli	Patro
Conētl	Infano
1828	1828
1829	1829
1741	1741
1662	1662
1742	1742
1830	1830
1663	1663
1831	1831
1743	1743
1664	1664
1665	1665
1744	1744
1832	1832
1666	1666
1745	1745
1833	1833
1667	1667
1746	1746
Huaznenqui	Transporto
1834	1834
1668	1668
1747	1747
1835	1835
1748	1748
1836	1836
1669	1669
1670	1670
1749	1749
1837	1837
1671	1671
1750	1750
1838	1838
1672	1672
1751	1751
1839	1839
1673	1673
1752	1752
1840	1840
1674	1674
1753	1753
1841	1841
1754	1754
1675	1675
1842	1842
1755	1755
1676	1676
1843	1843
1677	1677
1756	1756
1844	1844
1678	1678
1757	1757
1845	1845
1679	1679
1758	1758
1846	1846
1680	1680
1759	1759
1847	1847
1681	1681
1760	1760
1848	1848
1682	1682
1761	1761
1849	1849
1683	1683
1762	1762
1850	1850
1684	1684
1763	1763
1851	1851
1764	1764
1685	1685
1852	1852
1686	1686
1765	1765
1853	1853
1687	1687
1766	1766
1854	1854
1688	1688
1767	1767
1855	1855
1689	1689
1768	1768
1856	1856
1690	1690
1769	1769
1857	1857
1691	1691
1770	1770
1858	1858
1692	1692
1771	1771
1859	1859
1693	1693
1772	1772
1860	1860
1773	1773
1861	1861
1694	1694
1695	1695
1774	1774
1862	1862
1696	1696
1775	1775
1863	1863
1697	1697
1776	1776
1864	1864
1698	1698
1865	1865
1777	1777
1699	1699
1866	1866
1778	1778
1779	1779
1867	1867
1780	1780
1868	1868
1781	1781
1869	1869
Minuto	Minuto
Rusiatlahtōlli	Rusa lingvo
1782	1782
1870	1870
1783	1783
1871	1871
Vladimir Putin	Vladimir Putin
1784	1784
1872	1872
1785	1785
1873	1873
1786	1786
1874	1874
1787	1787
1875	1875
1788	1788
1876	1876
1789	1789
1877	1877
1790	1790
1878	1878
Ītlahtōllō Caxtillān	Historio de Hispanio
1879	1879
1791	1791
1792	1792
1880	1880
1793	1793
1881	1881
1794	1794
1882	1882
1795	1795
1883	1883
1796	1796
1884	1884
1797	1797
1885	1885
1886	1886
1798	1798
1887	1887
1799	1799
1888	1888
1889	1889
1890	1890
René Magritte	René Magritte
1891	1891
Suahilitlahtōlli	Svahila lingvo
1892	1892
1893	1893
1894	1894
1895	1895
1896	1896
1897	1897
1898	1898
Chinatlahtōlli	Ĉina lingvaro
1899	1899
Cuitlacalli	Necesejo
Yeliztli	Naturo
Achyolli	Ĉelo (biologio)
Eztli	Sango
Toulouse	Tuluzo
Miquiztetl	Skeleto
Casablanca	Kazablanko
Rumaniatlahtōlli	Rumana lingvo
Quiyahuitl	Pluvo
Tlālolīniliztli	Tertremo
Sergej Ėjzenštejn	Sergej Miĥajloviĉ Ejzenŝtejn
Akira Kurosawa	Kurosawa Akira
Nelson Mandela	Nelson Mandela
Mācuīlpōhualxihuitl X	10-a jarcento
Tletepētl	Vulkano
Mixtli	Nubo
Atēna 1896	Somera Olimpiko 1896
Mācuīlpōhualxihuitl IX	9-a jarcento
Mācuīlpōhualxihuitl VIII	8-a jarcento
Paris 1900	Somera Olimpiko 1900
Mācuīlpōhualxihuitl VII	7-a jarcento
Mācuīlpōhualxihuitl VI	6-a jarcento
Ehēcatl	Vento
Mācuīlpōhualxihuitl V	5-a jarcento
Telugutlahtōlli	Telugua lingvo
Saint Louis 1904	Somera Olimpiko 1904
Mācuīlpōhualxihuitl IV	4-a jarcento
Mācuīlpōhualxihuitl III	3-a jarcento
Mācuīlpōhualxihuitl II	2-a jarcento
Mācuīlpōhualxihuitl I	1-a jarcento
Londin 1908	Somera Olimpiko 1908
Antwerpen 1920	Somera Olimpiko 1920
Paris 1924	Somera Olimpiko 1924
Amsterdam 1928	Somera Olimpiko 1928
Los Ángeles 1932	Somera Olimpiko 1932
Xapon Yen	Japana eno
Berlin 1936	Somera Olimpiko 1936
Tlahtōlmatiliztli	Lingvoscienco
Cirilo īmachiyōtlahtōltecpantiliz	Cirila alfabeto
Greciamachiyōtlahtōltecpantiliztli	Greka alfabeto
Latinmachiyōtlahtōltecpantiliztli	Latina alfabeto
Neneuhcāyōtl:Bulgaria	Kategorio:Bulgario
Tlahcuilōcāyōtl	Literaturo
Neneuhcāyōtl:Francia	Kategorio:Francio
Neneuhcāyōtl:Cuīcayōtl	Kategorio:Muziko
Neneuhcāyōtl:Tlahcuilōcāyōtl	Kategorio:Literaturo
Manga	Mangao
Tepozquiquiztli	Trumpeto
Jazz	Ĵazo
Ehuatlapitzalli	Sakŝalmo
Violin	Violono
Valladolid	Valadolido
Londin 1948	Somera Olimpiko 1948
Helsinqui 1952	Somera Olimpiko 1952
Melbourne 1956	Somera Olimpiko 1956
Roma 1960	Somera Olimpiko 1960
Tōquiō 1964	Somera Olimpiko 1964
Āltepētl Mēxihco 1968	Somera Olimpiko 1968
Munich 1972	Somera Olimpiko 1972
Hugo Chávez Frías	Hugo Chávez
Oquichtli	Viro
Montreal 1976	Somera Olimpiko 1976
Moscohuia 1980	Somera Olimpiko 1980
Los Ángeles 1984	Somera Olimpiko 1984
Seul 1988	Somera Olimpiko 1988
Barcelona 1992	Somera Olimpiko 1992
Pātzcatl	Suko
Chīchīhualātl	Lakto
Tepētl	Monto
Huāccāīxtlāhuatl	Dezerto
Atlanta 1996	Somera Olimpiko 1996
Sydney 2000	Somera Olimpiko 2000
Atēna 2004	Somera Olimpiko 2004
Pequin 2008	Somera Olimpiko 2008
Olimpiayōtl Nemīmīnaliztli Londres 2012	Somera Olimpiko 2012
Simón Bolívar	Simón Bolívar
Hong Kong	Honkongo
Miami	Miamo
Lagos	Lagoso
Rio de Janeiro	Rio-de-Ĵanejro
Seul	Seulo
Xanghai	Ŝanhajo
Bilbao	Bilbao
Walt Disney	Walt Disney
Sevilla	Sevilo
Thomas Alva Edison	Thomas Alva Edison
Vigo	Vigo
Michael Faraday	Michael Faraday
Vascotlahtōlli	Eŭska lingvo
In Coruña	Korunjo
Granada, Caxtillān	Granado
Valencia	Valencio
Palma de Mallorca	Palma de Majorko
Málaga	Malago
Cītlalōlli	Leono (konstelacio)
Cītlallachtli	Oriono (konstelacio)
Cītlalcuetzpalli	Pegazo (konstelacio)
Cītlalcōlōtl	Skorpio (konstelacio)
Satyajit Ray	Satyajit Ray
Cītlalocēlōtl	Granda Ursino (konstelacio)
Miaccītlalli	Konstelacio
Johannes Gutenberg	Johannes Gutenberg
Cancún	Cancún
Max Planck	Max Planck
Ātemaxac	Gvadalaharo
Sueciatlahtōlli	Sveda lingvo
Dantlahtōlli	Dana lingvo
Karl Marx	Karl Marx
Esloveniatlahtōlli	Slovena lingvo
Voltaire	Voltaire
Machiliztli	Scio
Chīchīhualli	Mamo
Nantzintetl	Atomo
Tlāhuīlli	Lumo
Greciatlahtōlli	Greka lingvo
Tōtōmichin	Pingveno
E-mail	Retpoŝto
Teōmatiliztli	Religio
Coreatlahtōlli	Korea lingvo
René Descartes	René Descartes
Vietnantlahtōlli	Vjetnama lingvo
Sigmund Freud	Sigmund Freud
Neneuhcāyōtl:Miaccītlalli	Kategorio:Konstelacioj
Mongollahtōlli	Mongola lingvo
Bacu	Bakuo
Judaísmo	Judismo
Timbu	Timbuo
Bandar Seri Begawan	Bandar-Seri-Begavano
Galiciatlahtōlli	Galega lingvo
Immanuel Kant	Immanuel Kant
Vianchan	Vjentiano
Male	Maleo (Maldivoj)
Ēltapachtli	Hepato
Tanahtli	Testiko
Tōchtli	Kuniklo
Ninja	Ninĵo
Tlācacuetlāchtli	Homlupo
Timbuctu	Timbuktuo
Ilhuicaātl	Oceano
Mahoma	Mohamedo
IPod	IPod
Burgos, Caxtillān	Burgoso
Honda	Honda
Catolicismo Romano	Katolika Eklezio
Xillāntli	Ventro
Bengalatlahtōlli	Bengala lingvo
Camatl	Buŝo
Cuitlaxcolli	Intesto
A	A
Michael Schumacher	Michael Schumacher
Vancouver 2010	Vintra Olimpiko 2010
Cihuātlahtoāni Elizabeth II	Elizabeto la 2-a (Britio)
B	B
Gioachino Rossini	Gioachino Rossini
G	G
U	U
Z	Z
Blues	Bluso
F	F
J	J
Machiyōtlahtōliztli	Litero
Reggae	Regeo
T	T
C	C
R	R
D	D
Α	Alfo
Ω	Omego
I	I
Μ	Muo (litero)
E	E
H	H
K	K
L	L
M	M
N	N
O	O
P	P
Q	Q
S	S
Ronald Reagan	Ronald Reagan
V	V
W	W
X	X
Y	Y
Ä	Ä
Φ	Fio (litero)
Zulutlahtōlli	Zulua lingvo
Zazatlahtōlli	Zazaa lingvo
Pamplona	Pamplono
Zaragoza	Zaragozo
Unterallgäu (calpōlli)	Distrikto Unterallgäu
Cītlaltecpatl	Suda Fiŝo (konstelacio)
Aichach-Friedberg	Distrikto Aichach-Friedberg
Weilheim-Schongau (calpōlli)	Distrikto Weilheim-Schongau
Cītlalxonecuilli	Granda Hundo
Unterfranken	Malsupra Frankonio
Mittelfranken	Meza Frankonio
Oberfranken	Supra Frankonio
Oberpfalz	Supra Palatinato
Schwaben (Bavaria)	Distriktaro Ŝvabio
Niederbayern	Malsupra Bavario
Oberbayern	Supra Bavario
Cītlalmamalhuāztli	Taŭro (konstelacio)
1100	1100
Neneuhcāyōtl:Venezuela	Kategorio:Venezuelo
Belfast	Belfasto
Cardiff	Cardiff
Tlapēuhcāyōtl nemachiyōtīlpāntli	Perioda tabelo
Georgetown	Ĝorĝtaŭno (Gujano)
Tēyōllālih	Gadmeso
Mariano Rajoy	Mariano Rajoy
Nemiltōpīllōtl	Bakterioj
Cuahuitl	Arbo
Λ	Lambdo
Emo	Emoo (muziko)
Tlatetzauhtli	Fromaĝo
Xocomecatl	Vinbero
Neuctli	Mielo
Tlālcamohtli	Terpomo
Caxtillān chiyancaca	Sukero
Xiuhtlacualli	Legomo
Āmantēcayōtl	Teknologio
Huehcacaquiztli	Telefono
The Rolling Stones	The Rolling Stones
Chihuātlahcāyōtl	Kulturo
Sanscritotlahtōlli	Sanskrito
Lugo	Lugo (Hispanio)
2100	2100
Tīciyōtl	Medicino
Sarayevo	Sarajevo
Tlapōhuallōtl	Aritmetiko
Ōme Huēyicnīuhcalli	World Trade Center
Kubuntu	Kubuntu
Iztātl	Salo
Fidel Castro	Fidel Castro
Neneuhcāyōtl:Brasil	Kategorio:Brazilo
Neneuhcāyōtl:Rumania	Kategorio:Rumanio
Tlātlamantic cuīcayōtl	Alternativa rokmuziko
Rock	Rok-muziko
Huēhuētl	Tamburo
Tlapitzalli	Fluto
Tlaihīyōānani tetl	Magneto
Āhuilli	Ludilo
Īxiptlayōlli	Filmo
Tlayōlītīliztli	Animacio
Ahuiyapopotl	Gaso
Omalacatl	Biciklo
Ācalli	Ŝipo
Mīllahcayōtl	Agrikulturo
Tlaquēmitl	Vesto
Xaltehuilotl	Vitro
Cāhuitl	Tempo
Tetehuitl	Papero
Tecololli	Plasto
Tlapōhualli	Nombro
Huehcan	Metro
Cintli	Maizo
Judy Garland	Judy Garland
Mācēhualiztli	Danco
Nirvana (tlacuīcaliztli)	Nirvana
Leopold Figl	Leopold Figl
Karl Renner	Karl Renner
Engelbert Dollfuß	Engelbert Dollfuss
Ö	Ö
Tlācatiyān	Listo de sendependaj ŝtatoj
Nagoya	Nagojo
Heinz Fischer	Heinz Fischer
Jürgen Trittin	Jürgen Trittin
Tlācamāyeh	Urso
John Adams	John Adams
Kevin Costner	Kevin Costner
Quimichin Mickey	Mickey Mouse
Guadalajara, Caxtillān	Gvadalaharo (Hispanio)
Alicante	Alakanto
Las Palmas de Gran Canaria	Las Palmas de Gran Canaria
Teōcuahuitl	Kverko
1101	1101
1102	1102
Caxtillān tlaōlli	Tritiko
2040	2040
2039	2039
2038	2038
2037	2037
2036	2036
2035	2035
Cocoliztli	Malsano
Gregorio xiuhpōhualli	Gregoria kalendaro
Soria	Sorio
Cocoliztli īpan mochīuh nepapan āltepētl	Pandemio
Nantes	Nanto (Francio)
Tētzāuhcocoliztli	Tuberkulozo
Mātlālzahuatl	Variolo
Murcia	Murcio
Santander	Santandero (Hispanio)
Huelva	Onubo
Calmanaliztli	Arkitekturo
Pontevedra	Pontevedro
1103	1103
1104	1104
அப்பாசியக் கலீபகம்	Kalifujo de Abasidoj
Latinixachitlān	Latin-Ameriko
Āyōllohco Mēxihco	Meksika Golfo
2034	2034
2033	2033
2032	2032
Tepozmācuahuitl	Glavo
2031	2031
2030	2030
2029	2029
Nepōhualtzintzin	Abako (meĥanika kalkulilo)
2028	2028
2027	2027
Cem Özdemir	Cem Özdemir
Antwerpen	Antverpeno (urbo)
Yacatēuctli (cītlalli)	Norda Stelo
Īpān Belgica	Flago de Belgio
Teate	Chieti
Tzontecomatl	Kranio
Ronda, Málaga	Arundo
Xālīxco	Jalisco
Ezxocotl	Granatujo
Duraznocuahuitl	Persiko
Naranjaxocotl	Oranĝo (frukto)
Limōnxocotl	Limeo
Romanitlahtōlli	Cigana lingvo
Xhosatlahtōlli	Kosa lingvo
Graz	Graz
Nāhuatlahtōlli	Naŭatla lingvo
Navajotlahtōlli	Navaha lingvo
Yucatēcatl mayatlahtōlli	Jukatana majaa lingvo
Luca	Luko (Italio)
Pisa	Pizo (Italio)
Tiyānquiztli (Ilhuicamatiliztli)	Plejadoj
Tarento	Taranto
Mēxihco Tenōchtitlan	Tenoĉtitlano
1105	1105
Angelina Jolie	Angelina Jolie
Arabiatlahtōlli	Araba lingvo
Zotolin	Arekacoj
Afrikaantlahtōlli	Afrikansa lingvo
Ü	Ü
Matlatzalan axcayotl	Domajno de plej alta nivelo
Santiago de Compostela	Santiago de Compostela
Oviedo	Oviedo
Vitoria	Vitorio (Hispanio)
The Day After Tomorrow	The Day After Tomorrow
Mérida, Caxtillān	Merido (Hispanio)
Logroño	Logronjo
Santa Cruz de Tenerife	Santa Cruz de Tenerife
Michmāliztli	Fiŝkaptado
Β	Beto (litero)
Γ	Gamo (litero)
Ε	Epsilono
Ζ	Zeto
Η	Eto (litero)
Θ	Teto
Ι	Joto
Κ	Kapo (litero)
Ν	Nuo (litero)
Ξ	Ksio
Ο	Omikrono
Ρ	Roto (litero)
Σ	Sigmo
Τ	Taŭo (litero)
Υ	Upsilono
Ψ	Psio (litero)
Iquique	Iquique
Pascua tlālhuāctli	Paskinsulo
La Serena, Chile	La Serena (Ĉilio)
Pāmitl	Flago
Ć	Ć
Ahcopechtli	Tablo
Icpalli	Seĝo
Tarragona	Taragono
Albacete	Albacete
Yancuīc León	Nuevo León
Āltepēcalpōllōtl	Municipo
Cáceres	Cáceres
Badajoz	Badaĥozo
Cádiz	Kadizo
Segovia	Segovio
Salamanca, Caxtillān	Salamanko
Zamora, Caxtillān	Zamoro (Hispanio)
León, Caxtillān	Leono (Hispanio)
Xotl	Piedo
Queen	Queen
Freddie Mercury	Freddie Mercury
Cipactli	Lacertuloj
Metallica	Metallica
Wolfgang Schäuble	Wolfgang Schäuble
Mario Benedetti	Mario Benedetti
Б	Be (cirila alfabeto)
А	A (cirila alfabeto)
Г	Ge (cirila alfabeto)
Д	De (cirila alfabeto)
В	Ve (cirila alfabeto)
Ґ	Ge ukraina
Ahcōlli	Ŝultro
Death Cab For Cutie	Death Cab For Cutie
Huiquipedia:Cenca cualtzin tlahcuilōlli	Vikipedio:Elstaraj artikoloj
Nemachiyōtīlli:Link FA	Ŝablono:LigoElstara
Huiquipedia:Tlecuitl	Vikipedio:Diskutejo
Vermont	Vermonto
San Diego, California	San-Diego
San José, California	San Jose (Kalifornio)
Denver	Denvero (Koloradio)
Houston	Houston (Teksaso)
Phoenix	Fenikso (Arizono)
Dallas	Dallas (Teksaso)
Austin	Aŭstino
Īpān Rusia	Flago de Rusio
Nanquin	Nankingo
Edgar Allan Poe	Edgar Allan Poe
Los Ángeles (Chile)	Los Ángeles (Ĉilio)
Teōpantli	Kirko
Oakland	Oakland (Kalifornio)
Ehēcatlanōnōtzqui	Poŝtelefono
Stephen Hawking	Stephen Hawking
Safo	Sapfo
Ācacalōtl	Jabiruo
Sacramento, California	Sakramento (Kalifornio)
Honolulu	Honolulu
1925	1925
1927	1927
ABBA	ABBA
1000	1000
999	999
Cuetlāchtli	Lupo
Tucson	Tucson (Arizono)
1955	1955
1954	1954
1953	1953
1951	1951
1950	1950
1946	1946
1943	1943
1942	1942
1940	1940
1939	1939
1938	1938
1937	1937
1936	1936
1935	1935
1934	1934
1933	1933
1932	1932
1931	1931
1930	1930
1929	1929
Pionyan	Pjongjango
Chiucnāhui	9 (nombro)
Cōlōtl	Skorpio
1001	1001
1002	1002
1003	1003
1005	1005
1006	1006
1007	1007
1008	1008
1009	1009
1010	1010
1011	1011
1012	1012
1013	1013
1014	1014
1015	1015
1016	1016
1017	1017
1018	1018
1019	1019
1020	1020
1021	1021
1022	1022
1023	1023
1024	1024
1025	1025
1026	1026
1027	1027
1028	1028
1029	1029
1030	1030
1031	1031
1032	1032
1033	1033
1034	1034
1035	1035
1036	1036
1037	1037
1038	1038
1039	1039
1040	1040
1041	1041
San Pedro de la Paz	San Pedro de la Paz
1042	1042
1043	1043
1044	1044
1045	1045
1046	1046
1047	1047
1048	1048
1049	1049
1050	1050
1051	1051
1052	1052
1053	1053
1054	1054
1055	1055
1056	1056
1057	1057
1058	1058
1059	1059
1060	1060
1061	1061
1062	1062
1063	1063
1064	1064
1065	1065
1066	1066
1067	1067
1068	1068
1069	1069
1070	1070
1071	1071
1072	1072
1073	1073
1074	1074
1075	1075
1076	1076
1077	1077
1078	1078
1079	1079
1080	1080
1081	1081
1082	1082
1083	1083
1084	1084
1085	1085
1086	1086
1087	1087
1088	1088
1089	1089
1090	1090
1091	1091
1092	1092
1093	1093
1094	1094
1095	1095
1096	1096
1097	1097
Nha Trang	Nha Trang
1098	1098
1099	1099
1106	1106
1107	1107
1108	1108
1109	1109
1110	1110
Podolsk	Podolsk
1111	1111
1112	1112
1113	1113
1114	1114
1115	1115
1116	1116
1117	1117
1118	1118
1119	1119
1120	1120
Huēyiteōpixcātlahtoāni	Papo
1130	1130
Simferopol	Simferopolo
1131	1131
Rafael Correa	Rafael Correa
1132	1132
1133	1133
1134	1134
1135	1135
1136	1136
1137	1137
1138	1138
1139	1139
5	5
1140	1140
1141	1141
1142	1142
1143	1143
1144	1144
4	4
1145	1145
1146	1146
1147	1147
1148	1148
3	3
1149	1149
1150	1150
1151	1151
1152	1152
1153	1153
2	2
1154	1154
1155	1155
1156	1156
1157	1157
1158	1158
1159	1159
1160	1160
1161	1161
1162	1162
1163	1163
1164	1164
Louvre	Luvro
1165	1165
1166	1166
1167	1167
1168	1168
1169	1169
1170	1170
Partido Independentista Puertorriqueño	Partio de la Sendependeco de Porto-Riko
1171	1171
1172	1172
1173	1173
Tirana	Tirano
1174	1174
1175	1175
1176	1176
1177	1177
1178	1178
Motorhead	Motörhead
1179	1179
1180	1180
1181	1181
Axno	Azeno
1182	1182
1928	1928
1183	1183
1184	1184
1185	1185
1186	1186
1187	1187
1188	1188
1189	1189
1190	1190
1191	1191
1192	1192
1193	1193
1194	1194
1195	1195
1196	1196
1197	1197
1198	1198
1199	1199
Huiquipedia:Cualtzin tlahcuilōlli	Vikipedio:Legindaj artikoloj
6	6
Josh Duhamel	Josh Duhamel
Tlācatilizilhuitl	Kristnasko
Romatlahtōlli	Latinida lingvaro
Huēytlaōntic xihuitl	Superjaro
Steve Jobs	Steve Jobs
Lady Gaga	Lady Gaga
Breinigerberg	Breinigerberg
Huēhuehocēlōtl	Tigro
Juan Carlos I	Johano Karlo la 1-a (Hispanio)
Francesco Totti	Francesco Totti
Nissan	Nissan
Paxcua	Pasko
Muse	Muse
Quimichtechalōtl	Tamiaso
Chapopohtli	Nafto
Cemonocāyōtl cemānāhuacāyōcopa	Geografia koordinata sistemo
Atepipitztli	Koleopteroj
Cactli	Ŝuo
Chināncalli	Parko
Pennsylvania-teutontlahtōlli	Pensilvanigermana dialekto
Xocomecamīllah	Vitejo
Āxōlōtl	Aŝolotlo
Tetl	Ŝtono
1	1
10	10
20	20
Sussex Tlāpcopa	East Sussex
30	30
Audi	Audi
Abcasia	Abĥazio
40	40
9	9
7	7
8	8
Chicōme	7 (nombro)
Chicuēyi	8 (nombro)
Taylor Lautner	Taylor Lautner
Jeremy Renner	Jeremy Renner
12	12
Chicōntōnalli	Semajno
Mazātl	Cervedoj
Cetl	Glacio
Totahtziné	Patro nia
Ātezcatl	Lago
Caxtillān xōnacatl	Ajlo
Musée d'Orsay	Musée d'Orsay
930	930
13	13
985	985
1122	1122
981	981
939	939
Osetia Huitztlāmpa	Sud-Osetio
Ernest Hemingway	Ernest Hemingway
Edinburgh	Edinburgo
51	51
Octave Mirbeau	Octave Mirbeau
Tlālhuāctli	Insulo
Iztāc	Blanko
Tlīltic	Nigro
814	814
678	678
950	950
679	679
996	996
680	680
37	37
980	980
900	900
1129	1129
Chris Pine	Chris Pine
843	843
Lordi	Lordi
690	690
691	691
988	988
692	692
476	476
693	693
Marseille	Marsejlo
694	694
695	695
Xōnacatl	Cepo
696	696
Chicuacē	6 (nombro)
697	697
698	698
Achcauhtlahtolli	Oficiala lingvo
699	699
700	700
Moshchena	Moŝĉena
701	701
702	702
703	703
Xītomatl	Tomato
704	704
705	705
George H. W. Bush	George H. W. Bush
706	706
68	68
89	89
707	707
708	708
709	709
11	11
710	710
711	711
712	712
713	713
714	714
715	715
Dmitri Medvedev	Dmitrij Medvedev
716	716
717	717
718	718
719	719
720	720
Protestantismo	Protestantismo
721	721
722	722
Selena	Selena
723	723
Bryan Cranston	Bryan Cranston
724	724
Mérida, Venezuela	Merido (Venezuelo)
725	725
726	726
727	727
728	728
729	729
963	963
730	730
Podgoritza	Podgorico
731	731
962	962
732	732
733	733
997	997
734	734
972	972
735	735
955	955
901	901
736	736
737	737
936	936
738	738
953	953
902	902
739	739
15	15
740	740
14	14
741	741
742	742
17	17
743	743
958	958
744	744
500	500
745	745
150	150
746	746
880	880
747	747
748	748
Tlahtōltecpantiliztli	Vortaro
749	749
870	870
903	903
750	750
751	751
752	752
Cuaitl	Kapo
753	753
987	987
754	754
965	965
755	755
924	924
951	951
932	932
23	23
800	800
120	120
42	42
967	967
989	989
960	960
969	969
957	957
1124	1124
971	971
937	937
992	992
990	990
899	899
975	975
942	942
966	966
1128	1128
959	959
973	973
18	18
Rowan Atkinson	Rowan Atkinson
19	19
16	16
Las Vegas, Nevada	Lasvegaso
21	21
26	26
41	41
32	32
33	33
982	982
974	974
976	976
979	979
986	986
919	919
998	998
Palestina	Palestino
995	995
977	977
1125	1125
934	934
Mahtlāctli	10 (nombro)
200	200
876	876
875	875
810	810
929	929
882	882
1127	1127
940	940
889	889
844	844
912	912
838	838
984	984
874	874
38	38
43	43
127	127
954	954
39	39
24	24
79	79
61	61
104	104
29	29
102	102
866	866
839	839
622	622
918	918
100	100
Lila Downs	Lila Downs
961	961
570	570
632	632
Andrew Garfield	Andrew Garfield
946	946
835	835
884	884
859	859
832	832
849	849
877	877
Ocēlōmiztli	Gepardo
878	878
861	861
869	869
968	968
983	983
964	964
1121	1121
1123	1123
933	933
915	915
970	970
911	911
993	993
991	991
994	994
898	898
944	944
907	907
943	943
945	945
922	922
905	905
941	941
Ordino	Ordino (paroko)
925	925
928	928
948	948
947	947
949	949
926	926
126	126
101	101
105	105
108	108
117	117
115	115
Teconalli	Terkarbo
22	22
46	46
25	25
153	153
156	156
31	31
825	825
Vancouver	Vankuvero
301	301
116	116
886	886
330	330
860	860
842	842
165	165
871	871
893	893
203	203
909	909
222	222
931	931
938	938
917	917
160	160
28	28
Liverpool	Liverpool
Āltepehxic	Altepexi
85	85
88	88
76	76
54	54
477	477
914	914
920	920
913	913
Albany	Albany (Nov-Jorkio)
935	935
841	841
Avatar	Avatar (filmo)
820	820
906	906
Āltepētl Bremen	Bremeno
916	916
885	885
168	168
60	60
47	47
836	836
112	112
854	854
862	862
879	879
887	887
770	770
817	817
864	864
863	863
868	868
855	855
818	818
837	837
845	845
Roald Dahl	Roald Dahl
RMS Titanic	RMS Titanic
Rammstein	Rammstein
166	166
Ehēcalquixohuayān ītlālpancalactihuechiliz Cam Ranh	Flughaveno Cam Ranh
Īlītl	Alno
2016	2016
Mīmiztin	Felisedoj
552	552
2019	2019
Perexil	Petroselo
2017	2017
2018	2018
Zōyacapolcuahuitl	Daktilopalmo
-2	-2
-1	-1
Pichilemu	Piĉilemo
Cōzamatl	Vizelo
Teconxinachtli	Angiospermoj
Chīcuahtli	Turstrigo
Micazayolli	Kokcinelo
Antoni Gaudí	Antoni Gaudí
Ācuāuhtli	Fiŝaglo
2020	2020
Zōlcanauhtli	Platbeka anaso
Theodor Mommsen	Theodor Mommsen
Āpozonalli	Sukceno
Xīcohtli	Burdo
Stavanger	Stavanger
Cuicuitzcatl	Kamphirundo
Coxolihtli	Komuna fazano
Tlani teutontlahtōlli	Platgermana lingvo
Cuauhchochopihtli	Pegedoj
600	600
400	400
300	300
Xinachtlanelhuayōtl	Semplantoj
Caxtillān canauhtli	Kuleranaso
Hermann Hesse	Hermann Hesse
Tromsø	Tromsø
Universidad Niccolò Cusano	Università degli Studi Niccolò Cusano
Takeshi Kitano	Kitano Takeshi
1040 xiuhtin	1040-aj jaroj
Tēucyōtl Hidalgo (Texas)	Kantono Hidalgo (Teksaso)
Āltepētl Juárez	Ciudad Juárez
BMW	BMW
Bergen	Bergen (Norvegio)
Huēyimichtecuani	Granda orcino
Huehxōlōtl	Komuna meleagro
Camilo Cienfuegos	Camilo Cienfuegos
Alfa Romeo	Alfa Romeo
Aston Martin	Aston Martin
Bentley	Bentley
Bugatti	Bugatti
Ferrari	Ferrari
AC/DC	AC/DC
Okinawa	Okinavo
Ainutlahtōlli	Ajnua lingvo
Caxtillān zōlin	Ordinara koturno
Tzinācantli	Kiropteroj
36	36
Tzontli	Haro
Ācatl	Phragmites australis
Hastings, Sussex Tlāpcopa	Hastings
Willis Tower	Willis-Turo
Montgomery, Alabama	Montgomery (Alabamo)
Chevrolet	Chevrolet
815	815
816	816
822	822
840	840
823	823
811	811
771	771
888	888
768	768
851	851
205	205
159	159
107	107
162	162
103	103
802	802
Āhuitzotl	Lutra lutra
804	804
Huēyitlahtohcāyōtl in Tlanitlālpan	Reĝlando de Nederlando
119	119
118	118
Extremaduratlahtōlli	Ekstremadura lingvo
801	801
807	807
806	806
152	152
240	240
218	218
655	655
496	496
Jaguar	Jaguar
238	238
197	197
451	451
775	775
489	489
784	784
661	661
625	625
653	653
904	904
921	921
923	923
1126	1126
668	668
636	636
408	408
464	464
410	410
956	956
952	952
658	658
650	650
518	518
70	70
81	81
69	69
87	87
65	65
66	66
67	67
55	55
34	34
44	44
35	35
64	64
504	504
453	453
161	161
169	169
481	481
151	151
155	155
128	128
129	129
463	463
193	193
674	674
687	687
251	251
337	337
786	786
660	660
50	50
260	260
501	501
45	45
491	491
49	49
Ecser	Ecser
978	978
Silesiatlahtōlli	Silezia lingvo
221	221
543	543
536	536
230	230
762	762
610	610
787	787
480	480
209	209
202	202
192	192
Zhengzhou	Ĝengĝoŭo
681	681
819	819
173	173
867	867
865	865
827	827
824	824
847	847
883	883
829	829
813	813
910	910
850	850
808	808
853	853
872	872
873	873
856	856
858	858
831	831
857	857
828	828
826	826
833	833
848	848
834	834
881	881
852	852
163	163
154	154
201	201
803	803
805	805
52	52
532	532
82	82
84	84
73	73
72	72
62	62
71	71
75	75
74	74
83	83
78	78
77	77
90	90
80	80
627	627
Е	Je (cirila alfabeto)
456	456
91	91
190	190
109	109
53	53
270	270
688	688
452	452
795	795
465	465
778	778
846	846
830	830
404	404
Tlahtohcātēīxiptla	Prezidanto
908	908
896	896
897	897
927	927
63	63
555	555
571	571
86	86
401	401
890	890
533	533
264	264
Mijaíl Gorbachov	Miĥail Gorbaĉov
99	99
415	415
483	483
469	469
462	462
459	459
466	466
402	402
761	761
780	780
675	675
689	689
774	774
759	759
758	758
350	350
782	782
760	760
785	785
783	783
767	767
766	766
211	211
232	232
204	204
188	188
98	98
894	894
891	891
602	602
628	628
892	892
601	601
672	672
682	682
821	821
648	648
686	686
664	664
677	677
640	640
110	110
111	111
137	137
138	138
122	122
140	140
809	809
167	167
665	665
776	776
763	763
769	769
667	667
529	529
777	777
788	788
671	671
772	772
432	432
231	231
237	237
239	239
130	130
226	226
207	207
475	475
454	454
495	495
206	206
468	468
461	461
460	460
194	194
210	210
Caracalmiztli	Karakalo (besto)
225	225
311	311
220	220
541	541
642	642
313	313
180	180
794	794
587	587
530	530
609	609
497	497
540	540
428	428
548	548
422	422
549	549
457	457
478	478
253	253
467	467
458	458
158	158
157	157
164	164
124	124
113	113
121	121
106	106
551	551
494	494
320	320
242	242
Ё	Jo (cirila alfabeto)
291	291
48	48
Toloatzin	Ordinara daturo
97	97
56	56
93	93
57	57
503	503
510	510
509	509
474	474
484	484
576	576
493	493
479	479
287	287
El Alto	El Alto
407	407
485	485
547	547
546	546
544	544
537	537
535	535
502	502
527	527
508	508
525	525
613	613
618	618
617	617
608	608
645	645
621	621
606	606
623	623
604	604
603	603
626	626
619	619
634	634
630	630
614	614
505	505
446	446
791	791
557	557
656	656
657	657
659	659
651	651
676	676
670	670
652	652
673	673
654	654
647	647
812	812
669	669
792	792
649	649
Nāuhpōhualmahtlāctli omēyi	93 (nombro)
895	895
756	756
663	663
779	779
662	662
684	684
773	773
757	757
435	435
790	790
437	437
433	433
764	764
426	426
781	781
425	425
429	429
423	423
765	765
235	235
Reinhard Bütikofer	Reinhard Bütikofer
233	233
223	223
224	224
216	216
219	219
254	254
272	272
208	208
175	175
170	170
171	171
172	172
58	58
59	59
139	139
114	114
134	134
135	135
179	179
142	142
96	96
181	181
146	146
145	145
183	183
182	182
184	184
324	324
589	589
521	521
92	92
597	597
329	329
Cracovia	Krakovo
133	133
413	413
258	258
Tehuitztli	Beko
259	259
196	196
236	236
789	789
332	332
631	631
487	487
638	638
473	473
176	176
143	143
643	643
523	523
215	215
148	148
247	247
424	424
641	641
492	492
639	639
256	256
441	441
Garou	Garou
131	131
191	191
450	450
612	612
635	635
611	611
534	534
488	488
607	607
524	524
282	282
472	472
471	471
Tonantzin Guadalupe	Nia Damo de Gvadalupo
490	490
316	316
Ahtēpacholiztli	Anarkio
797	797
511	511
295	295
598	598
303	303
250	250
515	515
512	512
418	418
333	333
294	294
217	217
277	277
578	578
312	312
Tlacempōhualiztli	Adicio
284	284
283	283
241	241
243	243
262	262
498	498
336	336
334	334
266	266
Māīxnāmiquiliztli	Boksado
261	261
470	470
349	349
271	271
275	275
292	292
296	296
345	345
431	431
304	304
550	550
586	586
588	588
554	554
229	229
583	583
265	265
263	263
585	585
582	582
556	556
420	420
280	280
581	581
558	558
302	302
309	309
353	353
335	335
367	367
344	344
245	245
290	290
449	449
308	308
255	255
439	439
319	319
318	318
299	299
419	419
416	416
338	338
310	310
315	315
359	359
360	360
273	273
286	286
288	288
278	278
455	455
577	577
575	575
482	482
486	486
580	580
567	567
564	564
561	561
328	328
325	325
317	317
574	574
566	566
249	249
348	348
442	442
443	443
267	267
244	244
248	248
343	343
562	562
417	417
268	268
Vendatlahtōlli	Venda lingvo
590	590
269	269
499	499
409	409
405	405
406	406
403	403
414	414
411	411
412	412
560	560
592	592
Cebra	Zebro
276	276
314	314
323	323
366	366
362	362
545	545
531	531
514	514
513	513
539	539
538	538
519	519
516	516
520	520
522	522
528	528
506	506
526	526
507	507
214	214
213	213
212	212
228	228
227	227
149	149
174	174
189	189
199	199
141	141
132	132
125	125
123	123
147	147
144	144
198	198
178	178
177	177
187	187
195	195
186	186
347	347
620	620
624	624
605	605
629	629
Tlālocēlōtl	Oceloto
616	616
Las Cruces, Yancuīc Mēxihco	Las Cruces
615	615
644	644
646	646
633	633
637	637
436	436
434	434
Hererotlahtōlli	Herera lingvo
293	293
427	427
185	185
321	321
327	327
430	430
447	447
569	569
568	568
444	444
796	796
798	798
793	793
685	685
Hartford	Hartford (Konektikuto)
799	799
683	683
274	274
579	579
281	281
306	306
438	438
297	297
421	421
298	298
Hawaitlahtōlli	Havaja lingvo
351	351
352	352
355	355
Pandatlācamāyeh	Granda pando
Ātlācamāyeh	Blanka urso
95	95
94	94
594	594
542	542
448	448
445	445
305	305
234	234
565	565
Otommanguetlahtōlli	Otomi-mangea lingvaro
381	381
385	385
553	553
307	307
584	584
346	346
257	257
Mayatlahtōlli	Majaa lingvaro
Tlahuītequiliztli	Fulmo
285	285
591	591
Lombardotlahtōlli	Lombarda lingvo
289	289
Māitl	Mano
563	563
252	252
595	595
246	246
596	596
593	593
Mictlāmpa Sototlahtōlli	Peda lingvo
357	357
573	573
Simón Pedro	Sankta Petro
Tel Aviv	Tel-Avivo
Izhuatl	Folio
Valparaíso	Valparaiso
Xonatlahtōlli	Ŝona lingvo
Hollywood	Holivudo
Marlon Brando	Marlon Brando
Suatitlahtōlli	Svazia lingvo
559	559
599	599
326	326
341	341
322	322
Yutanāhuatlahtōlli	Jut-azteka lingvaro
Nathalia Dill	Nathalia Dill
Huāxyacac	Oaxaca
386	386
Tzhuanatlahtōlli	Cvana lingvo
374	374
380	380
Oxford, Oxfordshire	Oksfordo
136	136
Port-au-Prince	Portoprinco
Hutlahtōlli	Vua lingvo
Tsongatlahtōlli	Conga lingvo
Sototlahtōlli	Sota lingvo
Rotterdam	Roterdamo
Tlatzotzonalli	Muzika instrumento
Quetzalcanauhtli	Cigno
Āmōlli	Sapo
Yancuīc Orleans	Nov-Orleano
Scarlett Johansson	Scarlett Johansson
Gwyneth Paltrow	Gwyneth Paltrow
Yahualtōntli	Kompakta disko
Tepozmōyōtl	Helikoptero
382	382
342	342
373	373
372	372
1980s	1980-aj jaroj
J. K. Rowling	J. K. Rowling
Xālli	Sablo
Caxtillān tlapalpopozōn	Rozo
Xācocēlōtl	Leopardo
Salzburg	Salzburg
Albuquerque	Albuquerque (Nov-Meksiko)
Yancuīc xihuitl	Novjaro
Santo Domingo	Sankta Domingo
Tequixquiāc	Tequixquiac
Huēyāltepētl	Provinco
Ochonetli	Papajo
375	375
Isaac Asimov	Isaac Asimov
Trinidad, Bolivia	Trinidad (Bolivio)
1970s	1970-aj jaroj
2000 xiuhtin	2000-aj jaroj
Potosí	Potosí (urbo)
Col	Blanka brasiko
Agatha Christie	Agatha Christie
Āltepētl Cuhuait	Kuvajturbo
Tezcatl	Spegulo
Oruro	Oruro (urbo)
Miztli	Pumo
-44	-44
Tēmelāhuanimeh Jehová	Atestantoj de Jehovo
387	387
Brad Pitt	Brad Pitt
Huitzollahtōlli	Viĉola lingvo
Arthur Conan Doyle	Arthur Conan Doyle
Ndebeletlahtōlli mictlāmpa	Norda Ndebela lingvo
Ocēlōtl	Jaguaro
1930s	1930-aj jaroj
1960s	1960-aj jaroj
1920s	1920-aj jaroj
Osaka	Osako
Chināntēcatlahtōlli	Ĉinanteka grupo
Guaranitlahtōlli	Gvarania lingvo
Lamborghini	Lamborghini
Emmy Rossum	Emmy Rossum
Mazda	Mazda
Mercedes-Benz	Mercedes-Benz
Huexōtl	Saliko
Charles Bronson	Charles Bronson
Tlālpantli	Grundo
Bridgetown	Briĝurbo
Āmatlahcuilo	Verkisto
Siligo	Siligo
Xapon tlālolīniliztli īhuān huēyāolīniliztli īpan 2011	Tertremo de Sendajo en 2011
Puerto Montt	Puerto Montt
Tlapatiliztōcāitl	Pronomo
Tzilīnitl	Vokalo
Saint John	Sankta Johano (Antigvo-Barbudo)
Roseau	Roseo
1950s	1950-aj jaroj
Salta	Saltaurbo
Caxtillān quimichin	Rato
Porto	Porto
Yōltextli	Faruno
The Lion King	The Lion King
.ru	.ru
.ad	.ad
1940s	1940-aj jaroj
1910s	1910-aj jaroj
Mamut	Mamuto
Mācēhualtlācatl	Indianoj
Ndebeletlahtōlli huitztlāmpa	Suda Ndebela lingvo
Calīxtli	Pordo
Michhuahcatlahtōlli	Taraska lingvo
Tzotzillahtōlli	Cocila Lingvo
Tlahtohcāpilli William of Wales	William Mountbatten-Windsor
Toquelau	Tokelao
Cuīcapixqui	Komponisto
Ātōnahuiztli Influenza A H1N1	Porka gripo
Salvador de Bahia	Salvador de Bahio
Mahtlāctli omōme	12 (nombro)
Toshirō Mifune	Mifune Toshiro
Thomas Mann	Thomas Mann
Tallahassee	Tallahassee (Florido)
José Saramago	José Saramago
Pop	Pop-muziko
331	331
Mahtlāctli oncē	11 (nombro)
365	365
Mahtlāctli omēyi	13 (nombro)
Āhuacacuahuitl	Avokado
379	379
.fi	.fi
Luiz Inácio Lula da Silva	Luiz Inácio Lula da Silva
.ae	.ae
.am	.am
.de	.de
Āmatlalcāyōtl	Skribo
.fr	.fr
Lublin	Lublin
John Michael Talbot	John Michael Talbot
Tlālcacahuatl	Ternukso
.af	.af
Mācuīlpōhualli	100 (nombro)
.au	.au
Ixtezcatl	Okulvitro
.cz	.cz
.ag	.ag
Texihuitl	Hajlo
Luciano Pavarotti	Luciano Pavarotti
Mila Kunis	Mila Kunis
-43	-43
Campora San Giovanni	Campora San Giovanni
Bloemfontein	Bloemfontein
.at	.at
.us	.us
.es	.es
.gr	.gr
.pl	.pl
.uk	.uk
Camohtli	Batato
Gregor Mendel	Johann Gregor Mendel
Herta Müller	Herta Müller
Daniel Radcliffe	Daniel Radcliffe
Samurai	Samurajo
-31	-31
Enya	Enya
.al	.al
.ar	.ar
Alexandre Dumas, père	Alexandre Dumas (patro)
.az	.az
Xena: Warrior Princess	Xena
Santa Fe Ānalco	Santa Fe (Nov-Meksiko)
Mahtlāctli onnāhui	14 (nombro)
Caxtōlli	15 (nombro)
Caxtōlomēyi	18 (nombro)
Universidad del Bío-Bío	Universidad del Bío-Bío
Suva	Suvo
Xōlōitzcuintli	Meksika nuda hundo
Tōnēhuiliztli	Febro
-4	-4
Teide	Tejdo
1890s	1890-aj jaroj
.ao	.ao
.jp	.jp
.bd	.bd
.it	.it
-8	-8
Ācalquīxōhuayān Caxtillān	Portospeno
Quimichin	Muso (besto)
Xopaltic	Oranĝkolora
Anquichichi	Leporhundoj
Sochi	Soĉi
Emma Watson	Emma Watson
.bb	.bb
1800 xiuhtin	1800-aj jaroj
.ca	.ca
Nicolas Appert	Nicolas Appert
Eyjafjallajökull	Eyjafjallajökull
.co	.co
.ba	.ba
Penélope Cruz	Penélope Cruz
-14	-14
-27	-27
-19	-19
Mario Vargas Llosa	Mario Vargas Llosa
-3	-3
Radio Studio 54 Network	Radio Studio 54 Network
Caxtōlonnāhui	19 (nombro)
Āhuacātzin	Hirundo
Xōchipaxcua	Pentekosto
.br	.br
.is	.is
.cg	.cg
Mezquentli	Pantalono
Mahtlācxihuitl	Jardekoj
.pt	.pt
Huēyāltepētl Concepción	Koncepciono (provinco)
Rio Grande do Sul	Suda Rio-Grando
Amazonas (Brasil)	Amazonio (ŝtato)
-6	-6
-34	-34
Ilhuicaatentli	Strando
Caxtōlomōme	17 (nombro)
Amapá	Amapao
Manaus	Manaŭo
Caxtōloncē	16 (nombro)
Porto Alegre	Porto-Alegro
Cempōhualli	20 (nombro)
Tlācatlahtohcāyōtl Sahara	Araba Demokratia Sahara Respubliko
.eg	.eg
-5	-5
-23	-23
Bahia	Bahio
.se	.se
A (kana)	A (kanao)
I (kana)	I (kanao)
U (kana)	U (kanao)
E (kana)	E (kanao)
O (kana)	O (kanao)
Ka (kana)	Ka (kanao)
Jim Carrey	Jim Carrey
.bo	.bo
Julia Roberts	Julia Roberts
Ki (kana)	Ki (kanao)
Ku (kana)	Ku (kanao)
Ke (kana)	Ke (kanao)
Ko (kana)	Ko (kanao)
Sa (kana)	Sa (kanao)
Shi (kana)	Ŝi (kanao)
30 Seconds to Mars	30 Seconds to Mars
Su (kana)	Su (kanao)
Se (kana)	Se (kanao)
So (kana)	So (kanao)
Ta (kana)	Ta (kanao)
Tacloban	Tacloban
Chi (kana)	Ĉi (kanao)
Ray Bradbury	Ray Bradbury
Tsu (kana)	Cu (kanao)
Te (kana)	Te (kanao)
Cristina Fernández	Cristina Fernández de Kirchner
To (kana)	To (kanao)
Na (kana)	Na (kanao)
Ni (kana)	Ni (kanao)
Nu (kana)	Nu (kanao)
Ne (kana)	Ne (kanao)
No (kana)	No (kanao)
Ha (kana)	Ha (kanao)
Hi (kana)	Hi (kanao)
Fu (kana)	Fu (kanao)
He (kana)	He (kanao)
Dilma Rousseff	Dilma Rousseff
Ho (kana)	Ho (kanao)
Ma (kana)	Ma (kanao)
Mi (kana)	Mi (kanao)
Mu (kana)	Mu (kanao)
Me (kana)	Me (kanao)
Mo (kana)	Mo (kanao)
Ya (kana)	Ja (kanao)
Yu (kana)	Ju (kanao)
Acre	Akro (Brazilo)
Yo (kana)	Jo (kanao)
Tecuicihtli	Krabo
Texotlaticiliztli	Kirurgio
-29	-29
Āltepētl Carson	Carsonurbo
Alagoas	Alagoaso
Anna Maria Jopek	Anna Maria Jopek
Frank Sinatra	Frank Sinatra
-7	-7
-9	-9
Eva Perón	Eva Perón
-32	-32
Opel	Opel
.mx	.mx
Porsche	Porsche
.hn	.hn
-48	-48
Táchira	Táchira
-26	-26
Apure	Apure
Santiago ohtli	Jakoba Vojo
-11	-11
Jonathan Swift	Jonathan Swift
Calli	Konstruaĵo
Sony	Sony
Tomīn	Monero
-16	-16
-35	-35
-13	-13
Īxīptlayōlmatiliztli	Kinejo
Franz Liszt	Franz Liszt
-17	-17
-24	-24
José Luis Rodríguez Zapatero	José Luis Rodríguez Zapatero
Federico García Lorca	Federico García Lorca
.sa	.sa
Kingstown	Kingstaŭno
Tlanelhuatl	Radiko (planto)
Saint George	Sankta Georgo (Grenado)
Julia Gillard	Julia Gillard
Haifa	Ĥajfo
Emiliano Zapata	Emiliano Zapata
Joseph Goebbels	Joseph Goebbels
Klagenfurt	Klagenfurt
Beersheba	Be'er Ŝeba
-50	-50
.jm	.jm
.pa	.pa
.pe	.pe
Talcahuano	Talcahuano
1347 Tlīltic Miquiztli	Nigra morto
.nz	.nz
In ītlahpalōlōcatzin María	Ave Maria
Mirante do Vale	Videjo de Valo
Ōmpōhualli	40 (nombro)
Ichcatohmitl	Lano
Huehcāuh Inglatlahtōlli	Anglosaksa lingvo
Cacahuacuahuitl	Theobroma cacao
Evo Morales	Evo Morales
Īpān Polonia	Flago de Pollando
Sheffield	Sheffield
Nextic	Griza
Īpān Tlacetilīlli Tlahtohcāyōtl	Flago de Usono
Yama	Lamo
Keira Knightley	Keira Knightley
Teōpixqui	Pastro
Piauí	Piaŭio
Santiago de los Caballeros	Santiago de los Caballeros
Johnny Cash	Johnny Cash
Audrey Hepburn	Audrey Hepburn
Tlācamichin	Manato
Belo Horizonte	Bel-Horizonto
Cēmpōhualmahtlāctli	30 (nombro)
Īpān Italia	Flago de Italio
Calmanani	Arkitekturistoj
1600 xiuhtin	1600-aj jaroj
Franz Ferdinand	Franz Ferdinand d'Este
Heinrich Himmler	Heinrich Himmler
Donetsk	Donecko
Caxtillān chīlli	Nigra pipro
Huiquipedia:Yequihcuilōtl	Ortografio
Īpān Xapon	Flago de Japanio
Īpān Francia	Flago de Francio
Zacatl	Poacoj
Enrique González Martínez	Enrique González Martínez
Zulia	Zulia
Membrillocuahuitl	Cidonio
Fresno	Fresno
Harry Potter and the Philosopher's Stone	Hari Poter kaj la Ŝtono de la Saĝuloj
1700 xiuhtin	1700-aj jaroj
Ocomiztli	Eŭrazia linko
Petlazolcoatl	Centpieduloj
Fortaleza	Fortalezo
Cuāuhtohtli	Falko
Guayaquil	Guayaquil
Quetzalitztli	Smeraldo
Gerhart Hauptmann	Gerhart Hauptmann
Tehuilotl	Kristalo
Huitzilli	Kolibro
Xīctli	Umbiliko
Eddie Murphy	Eddie Murphy
Azahuad	Azavado
Das Lied der Deutschen	La kanto de l' germanoj
La Plata	La Plata
Reese Witherspoon	Reese Witherspoon
Ciruelacuahuitl	Pruno (frukto)
1500 xiuhtin	1500-aj jaroj
San Fernando del Valle de Catamarca	San Fernando del Valle de Catamarca
Tepozyōllōtl	Motoro
Radiohead	Radiohead
Resistencia, Argentina	Resistencia
Rawson	Rawson
Córdoba, Argentina	Kordobo (Argentino)
Corrientes	Corrientes (urbo)
Paraná, Argentina	Paraná (Argentino)
Formosa, Argentina	Formosa (Formosa)
Santa Rosa, Argentina	Santa Rosa (La Pampa)
San Salvador de Jujuy	San Salvador de Jujuy
La Rioja, Argentina	La Rioja (Argentina urbo)
Mendoza	Mendoza (urbo)
Posadas	Posadas (Argentino)
Neuquén	Neuquén
San Juan, Argentina	San Juan (Argentina urbo)
Río Gallegos	Río Gallegos
San Luis, Argentina	San Luis (Argentina urbo)
Santa Fe, Argentina	Santa Fe de la Vera Cruz
Santiago del Estero	Santiago del Estero (urbo)
Ushuaia	Ushuaia
San Miguel de Tucumán	San Miguel de Tucumán
Jörg Haider	Jörg Haider
Ford Motor Company	Ford Motor Company
Coyōtl	Kojoto
Jim Morrison	Jim Morrison
Ronald Golias	Ronald Golias
Quechquentli	Kravato
Anne Brontë	Anne Brontë
GNU	GNU
1820s	1820-aj jaroj
Amazonas (Colombia)	Amazonio (Kolombio)
Heinz-Christian Strache	Heinz-Christian Strache
Francisco Pizarro	Francisco Pizarro
Huēyāltepētl Buenos Aires	Provinco Bonaero
Catamarca	Katamarkio
Tzacuapanyan	Haveno
Tucuman	Tukumano
Chubut	Ĉubutio
Michhuahqueh	Taraskoj
Lino	Ordinara lino
Coldplay	Coldplay
The Hound of the Baskervilles	The Hound of the Baskervilles
Coimbra	Koimbro
Tlācanēxquimilli	Fantomo
Migueltzin Huēyahtlapāleh	Ĉefanĝelo Miĥaelo
Tlazōlli	Rubo
John Cale	John Cale
Cihtli	Leporo
Tlāhuīlnāuhmecatl	Basgitaro
Sonora	Sonora
Guanajuato	Guanajuato
Osiris	Oziriso
Tlani California Huitztlāmpa	Baja California Sur
Īpān Tlanitlālpan	Flago de Nederlando
Charles Babbage	Charles Babbage
Tlācatzinācantli	Vampiro
Octavio Paz	Octavio Paz
Harry Potter and the Goblet of Fire	Hari Poter kaj la Pokalo de Fajro
Īpān Austria	Flago de Aŭstrio
Harry Potter and the Half-Blood Prince	Hari Poter kaj la Duonsanga Princo
Tepotzohcuacuahueh	Zebuo
Harry Potter and the Chamber of Secrets	Hari Poter kaj la Ĉambro de Sekretoj
Elfriede Jelinek	Elfriede Jelinek
Ocuilin	Vermo
Kepler-22b	Kepler-22b
Cetepētl	Glacimonto
Harry Potter and the Prisoner of Azkaban	Hari Poter kaj la Kaptito de Azkabano
Rudolf Eucken	Rudolf Christoph Eucken
Jubrān Khalīl Jubrān	Ĝibran Ĥalil Ĝibran
Caxtillān epazōtl	Mento
Āyōtōchtli	Dazipo
Robbie Williams	Robbie Williams
339	339
340	340
354	354
356	356
358	358
361	361
363	363
364	364
368	368
369	369
370	370
371	371
Nemachiyōtīlli:Commonscat	Ŝablono:Commonscat
376	376
377	377
378	378
383	383
384	384
388	388
389	389
390	390
391	391
392	392
393	393
394	394
395	395
396	396
397	397
398	398
399	399
Īpān Alemania	Flago de Germanio
Cēmpōhualomēyi	23 (nombro)
Medellín, Colombia	Medeĝino
Kōbe	Kobe
Hiragana	Rondaj kanaoj
Cesarea de Capadocia	Kayseri
Recife	Recife
Ohohuihcan	Labirinto
279	279
Bridgeport	Bridgeport (Konektikuto)
440	440
517	517
572	572
Scottsdale, Arizona	Scottsdale (Arizono)
Reno	Reno (Nevado)
Aurora, Colorado	Aurora (Koloradio)
Anaheim	Anaheim
Colorado Springs	Colorado Springs
Mesa, Arizona	Mesa
Henderson, Nevada	Henderson (Nevado)
Peer Steinbrück	Peer Steinbrück
2026	2026
Ontetocaitl	Petolnomo
2025	2025
2024	2024
2023	2023
2022	2022
2021	2021
Schaan	Schaan
2041	2041
2042	2042
2043	2043
2044	2044
2045	2045
2046	2046
2047	2047
2048	2048
2049	2049
2050	2050
2051	2051
2052	2052
2053	2053
2054	2054
2055	2055
2056	2056
2057	2057
2058	2058
2059	2059
Hordaland	Hordaland
Sogn og Fjordane	Sogn og Fjordane
Tepētzallāntli Mēxihco	Valo de Meksiko
Santiago de Cali	Santiago de Cali
David Wark Griffith	David Wark Griffith
Luis Buñuel	Luis Buñuel
Billy Wilder	Billy Wilder
Roman Polanski	Roman Polański
Punta Arenas	Punta Arenas
Tempe, Arizona	Tempe (Arizono)
Nemachiyōtīlli:Taxobox	Ŝablono:Taksonomio
Rosario, Argentina	Rosario
Mar del Plata	Mar del Plata
Jean-Luc Godard	Jean-Luc Godard
Saltillo	Saltillo (Coahuila)
Saltillo (āltepēcalpōlli)	Saltillo (komunumo)
Cōāhuillān Zaragoza	Coahuila
Mexicana de Aviación	Mexicana de Aviación
Ōmmalacapayīnaliztli	Biciklado
Toyota	Toyota
Werner Faymann	Werner Faymann
San Mango d'Aquino	San Mango d'Aquino
Itztli	Obsidiano
Paola, Italia	Paola
Cuenca, Ecuador	Cuenca (Ekvadoro)
Hayao Miyazaki	Hayao Miyazaki
Ж	Ĵe (cirila alfabeto)
Colonia del Sacramento	Colonia del Sacramento
Punta del Este	Punta del Este
Vilamoviatlahtōlli	Vilamovica lingvo
Mayotlahtōlli	Majoa lingvo
Nelly Sachs	Nelly Sachs
Ollanta Humala	Ollanta Humala
Felipe Calderón	Felipe Calderón
Mauricio Funes	Mauricio Funes
Thomas de Maizière	Thomas de Maizière
Franz Josef Jung	Franz Josef Jung
Jóhanna Sigurðardóttir	Jóhanna Sigurðardóttir
Philipp Rösler	Philipp Rösler
Guido Westerwelle	Guido Westerwelle
Duran Duran	Duran Duran
Tlani California	Baja California
Chiyapan	Chiapas
Veracruz de Ignacio de la Llave	Veracruz
1150 xihuitl	1150-aj jaroj
Īpān Dinamarca	Dannebrog
Guerrero	Guerrero
Yucatān	Jukatanio
Cītlalmītl	Meteorŝtono
1030 xiuhtin	1030-aj jaroj
1050 xiuhtin	1050-aj jaroj
Constantinopla Tēpachoteōpīxqui	Patriarko de Konstantinopolo
Ursula von der Leyen	Ursula von der Leyen
Kristina Schröder	Kristina Schröder
Winfried Kretschmann	Winfried Kretschmann
Chihuahhua, Chihuahhua	Chihuahua (urbo)
Pachtitlan (āltepēcalpōlli)	Guanajuato (urbo)
Cōlimān	Colima
Cōlimān, Cōlimān	Colima (Colima)
Nehnemiliztli	Vojaĝo
Erika Mann	Erika Mann
Ronald Pofalla	Ronald Pofalla
Caxtillān quetzaltōtōtl	Barata pavo
Norbert Röttgen	Norbert Röttgen
Sabine Leutheusser-Schnarrenberger	Sabine Leutheusser-Schnarrenberger
Peter Struck	Peter Struck
Johannes Heesters	Johannes Heesters
Huehcāuh Tlācatiyān	Listo de eksaj ŝtatoj en Eŭropo
Daniel Bahr	Daniel Bahr
Barranquilla	Barankilo
Dirk Niebel	Dirk Niebel
Peter Ramsauer	Peter Ramsauer
Alfred Hugenberg	Alfred Hugenberg
Peter Altmaier	Peter Altmaier
Edelgard Bulmahn	Edelgard Bulmahn
Morelos	Morelos
Manfred Stolpe	Manfred Stolpe
Hans-Peter Friedrich	Hans-Peter Friedrich
Hermann Gröhe	Hermann Gröhe
Cueyatl	Rano
Futurama	Futurama
Karl Dönitz	Karl Dönitz
Heinrich Mann	Heinrich Mann
Johann Pachelbel	Johann Pachelbel
Paul Heyse	Paul Heyse
Margot Honecker	Margot Honecker
Karl-Theodor zu Guttenberg	Karl-Theodor zu Guttenberg
Ernst Thälmann	Ernst Thälmann
Klaus Mann	Klaus Mann
Golo Mann	Golo Mann
Wilhelm Marx	Wilhelm Marx
Angelika Beer	Angelika Beer
Centzīntiliztica	Unukotiledonaj plantoj
San Luis Potosí	San Luis Potosí
Tlapaltehuilōtl	Ametisto
Querétaro	Querétaro
Nogales, Arizona	Nogales (Arizono)
930 xihuitl	930-aj jaroj
Cuātōchtli	Kobajo
Flagstaff	Flagstaff (Arizono)
Michhuahcān	Michoacán
Īpān Afganistan	Flago de Afganio
Isis	Iziso
Durango	Durango (subŝtato)
Nayarit	Nayarit
1130 xihuitl	1130-aj jaroj
Puebla	Puebla
Aguascalientes	Aguascalientes
Cēmpōhualmācuīlli	25 (nombro)
Cēmpōhualonnāhui	24 (nombro)
Tamaulipas	Tamaulipas
Caxtillān mexcalmetl	Aloo vera
Īpān Canada	Flago de Kanado
Emily Brontë	Emily Brontë
Watlasecawiloni	Ĉapelo
Tecontli	Botelo
Quintana Roo	Quintana Roo
Sinaloa	Sinaloa
Zacatēcapan	Zacatecas
Julianne Moore	Julianne Moore
960 xihuitl	960-aj jaroj
990 xihuitl	990-aj jaroj
890 xihuitl	890-aj jaroj
1190 xihuitl	1190-aj jaroj
1180 xihuitl	1180-aj jaroj
Hidalgo	Hidalgo (Meksiko)
Campeche	Campeche
Tabasco	Tabasco
John Travolta	John Travolta
Fez	Fez
Monterrey	Monterejo
Quiyahuātl	Tempesto
950 xihuitl	950-aj jaroj
1020 xihuitl	1020-aj jaroj
1060 xiuhtin	1060-aj jaroj
Īpān Suecia	Flago de Svedio
Harrison Ford	Harrison Ford
1010 xihuitl	1010-aj jaroj
Ācapōlco	Akapulko
Īpān Lituania	Flago de Litovio
Xocoztli	Citruso
Īpān Andorra	Flago de Andoro
Alpaca	Alpako
Melōn	Melono (frukto)
Calāntōcāitl	Eksonimo
970 xihuitl	970-aj jaroj
Īpān Australia	Flago de Aŭstralio
Santos	Santos
Īpān Turquia	Flago de Turkio
Tlahtohcāyōtl Mēxihco	Estado de México
Temuco	Temuco
Īpān Brasil	Flago de Brazilo
Hande Yener	Hande Yener
Īpān Azerbaiyan	Flago de Azerbajĝano
920 xihuitl	920-aj jaroj
1170 xihuitl	1170-aj jaroj
980 xihuitl	980-aj jaroj
1080 xiuhtin	1080-aj jaroj
К	Ka (cirila alfabeto)
П	Pe (cirila alfabeto)
И	I (cirila alfabeto)
Tlaxcallān	Tlaxcala
Cuācuauhxōlōtl	Amerika bizono
1090 xiuhtin	1090-aj jaroj
São Paulo Museum of Art	Arta Muzeo de San-Paŭlo
Katakana	Strekaj kanaoj
Cemitqui	Politikisto
1110 xihuitl	1110-aj jaroj
1160 xihuitl	1160-aj jaroj
940 xihuitl	940-aj jaroj
Tecpatl	Siliko
Cuauhcamohtli	Manioko
Goiânia	Goiânia
Quillechuca	Kultiva laktuko
Galilea	Galileo (regiono)
Epatl	Mefito
870 xihuitl	870-aj jaroj
Béla Bartók	Béla Bartók
880 xihuitl	880-aj jaroj
860 xihuitl	860-aj jaroj
1070 xiuhtin	1070-aj jaroj
Tlālolīnilizmatiliztli	Tertremoscienco
1140 xihuitl	1140-aj jaroj
Anthony Quinn	Anthony Quinn
Maximiliano I (Mēxihco)	Maksimiliano (Meksiko)
Polandball	Pollandpilko
Back To The Future	Back to the Future
Tōtoltetl	Kokina ovo
Āmaquēmehcān	Amecameca
Palachtli	Jukatana meleagro
Āpantzincān	Apatzingán
Ourense	Oŭrenso
Huēhcāuhahtlapalli	Arkeopterigo
Huēyicocoliztli influenza A H1N1 xiuhpan 2009	Gripa pandemio de 2009
Tebas	Tebo (Egiptio)
Īpān Honduras	Flago de Honduro
Tlacuīltīllahtōlli	Lingva prunto
Peter O'Toole	Peter O’Toole
Zabrze	Zabrze
Judea	Judeo
Callao	Kajao
Ātenāmitl	Digo
Legnica	Legnica
Jamie Lee Curtis	Jamie Lee Curtis
Tēucyōtl Alameda	Kantono Alameda
Tlahtohcayotl	Subŝtato
Atzcalli	Ostro
Tēucyōtl Contra Costa	Kantono Contra Costa
Tēucyōtl San Diego	Kantono San-Diego
Āltepētl Belice	Belizurbo
Malacactli	Sketilo
Georg von Schönerer	Georg von Schönerer
Victoria de Durango	Victoria de Durango
Xāltēnco	Jaltenco
Mētzcuitlatl	Glimo
Abelardo Rodríguez	Abelardo L. Rodríguez
MINI	MINI
Santiago de Cuba	Santiago de Kubo
Leuven	Loveno
Boyacá	Bojakao
Īpān Caxtillān	Flago de Hispanio
Alemania ītlahtōllō	Historio de Germanio
Tequillān mexcalli	Tekilo
Īpān Mēxihco	Flago de Meksiko
Cuetlāchtlācamāyeh	Amerika nigra urso
Antioquia	Antjokio
Īpān Suiza	Flago de Svislando
Īpān Angola	Flago de Angolo
Tijuana	Tijuana
Cuetlaxcōāpan	Heroica Puebla de Zaragoza
Orlando Drummond	Orlando Drummond
Tlācaxōlōtl	Tapiro
Huēhuētlololli	Drumo
Īpān Portugal	Flago de Portugalio
Paul Verhoeven	Paul Verhoeven
Ϙ	Kuoppo
Caxtillān ocomiztli	Iberia linko
Pōctli	Fumo
Īpān Argentina	Flago de Argentino
Chiquilichtli	Cikadedoj
James Blunt	James Blunt
Īpān Rumania	Flago de Rumanio
Acocohxōchitl	Dalio
Cepayauhmelahuaztli	Skiado
Tlālyacatl Yucatān	Jukatano
Cītlalin tlamīna	Meteoro
Īpān China	Flago de Ĉinio
Caxtillān pitzāhuac etl	Lento
Tzontecomananacatl	Muŝoamanito
Immagine & poesia	Immagine & Poesia
Alexander Rybak	Aleksander Ribak
Soul	Soulo
Caxtillān ayecohtli	Fabo
Ͳ	Sampio
Brighton, Sussex Tlāpcopa	Brajtono
Merano	Merano
Joan Baez	Joan Baez
Ōlli	Gumo
Ocotōchtli	Rufa linko
Xbox	Xbox
Tlapoatl	Ŝlosilo
Misa	Meso (diservo)
Īchīmal Alemania	Blazono de Germanio
Bee Gees	Bee Gees
Āltepētlahtohcāyōtl	Urboŝtato
Petlāuhxinachtli	Nudsemplantoj
Namur	Namuro (urbo)
Oscar Niemeyer	Oscar Niemeyer
Tzīncuauhyōtl	Tigo
Cēmani (cuīcayōtl)	Unuopaĵo
Quecehuatl	Zono (vestaĵo)
Īpān Bolivia	Flago de Bolivio
Ōlmēcah	Olmekoj
LG	LG Group
Māpachtlācamāyeh	Okulvitra urso
Pōchōtl	Kapok-arbo
Zacatēcapan, Zacatēcapan	Zacatecas (komunumo)
Motēcuhzōma Xōcoyōtzin	Moktezumo la 2-a
Ch	Ch
Āmapatōlli	Kartludo
Freistadt	Freistadt
Kanash	Kanaŝ
Zakopane	Zakopane
Malayotlācamāyeh	Malaja urso
Tlālyacatl Italia	Itala duoninsulo
Tōlli	Tifao
Zamora, Michhuahcān	Zamora (Michoacán)
Zamora	Zamoro
Tzapopan	Zapopan
Tzopelātl	Senalkoholaĵo
Āchiyōtl	Bikso orelana
Pēzohtli	Nazurso
Māpachtli	Prociono (genro)
Cidracuahuitl	Cedrato
Quināmehtlatzcan	Sekvojo
Porfirio Díaz	Porfirio Díaz
Westlife	Westlife
2008 Sichuan tlālolīniliztli	Tertremo en Siĉuano en 2008
Police Academy: The Animated Series	Police Academy (televida serio)
Ludmilla Radchenko	Ljudmila Radĉenko
Ilse Aigner	Ilse Aigner
Nana Mouskouri	Nana Mouskouri
Carlos Fuentes	Carlos Fuentes
Arturo Pérez-Reverte	Arturo Pérez-Reverte
Metl	Agavo
Huauhtli	Amaranto
Volkswagen AG	Volkswagen AG
Manzanacuahuitl	Kulturpomo
Tzapotl	Sapotacoj
Capolin	Aronio
Cuauhtzapotl	Ĉerimolio
Ēlōcapolcuahuitl	Malfrua prunuso
Nohpalli	Opuntio
Nequēnnetl	Sisalo
Santa Cruz, California	Santa Cruz (Kalifornio)
Santa Clara, California	Santa Clara (Kalifornio)
Arequipa	Arekipo
Santa Bárbara, California	Santa Barbara (Kalifornio)
Travis	Travis
Telconalli	Globkrajono
Īpān Africa Huitztlāmpa	Flago de Sud-Afriko
Īpān Peru	Flago de Peruo
Īpān Colombia	Flago de Kolombio
Valdivia	Valdivia
Pachyohcān Soto	Pachuca de Soto
Īpān Chile	Flago de Ĉilio
Caxtiltēcah	Hispanoj
David Cītlalli	Stelo de Davido
T.A.T.u.	T.A.T.u.
Mango	Mangifero
André Breton	André Breton
Tlīlxōchitl	Vanilo
Comondú	Comondú
Cartagena, Caxtillān	Kartaĥeno (Hispanio)
Īpān Irac	Flago de Irako
Tlatlīltzicuīniliztli	Diakrita signo
Īpān Cuba	Flago de Kubo
Marguerite Yourcenar	Marguerite Yourcenar
Hugh Grant	Hugh Grant
Hernando Franco	Hernando Franco
Palpetlatl	Tapiŝo
Īpān Birmania	Flago de Birmo
Volvo	Volvo (firmao)
Cuīcatlāhuīlcaxitl	Sintezilo
Alexandr Borodin	Aleksandr Porfirjeviĉ Borodin
Funk	Funko
Sergio Leone	Sergio Leone
Momochitl	Krevmaizo
Mérida, Yucatān	Mérida (Meksiko)
Lope de Vega	Lope de Vega
Teresina	Teresina
Limōncuahuitl	Limeujo
Īpān Ecuador	Flago de Ekvadoro
Mérida (tlahtohcāyōtl)	Mérida (venezuela ŝtato)
Xālxocotl	Psidium guajava
Ixtehuilli	Lupeo
Alan García	Alan García
Manzanaoctli	Cidro
Alizée Jacotey	Alizée
Amélie Nothomb	Amélie Nothomb
Mayanalo	Malsatego
Huēyimichin	Lamencetacoj
Vitória	Vitória (Espirito-Santo)
Santiago Calatrava	Santiago Calatrava
Caselle Landi	Caselle Landi
Īpān Cosovo	Flago de Kosovo
Panhuehuetl	Tambora
Maceió	Maceió
Īpān Panama	Flago de Panamo
Īpān Belice	Flago de Belizo
Zeca Pagodinho	Zeca Pagodinho
Amapechtli	Koverto
110 xihuitl	110-aj jaroj
Carlos Slim Helú	Carlos Slim
Zoquitl	Ŝlimo
Īpān Paraguay	Flago de Paragvajo
Cuānacacōzcacuāuhtli	Anda kondoro
Arctic Monkeys	Arctic Monkeys
Īchīmal Caxtillān	Blazono de Hispanio
Advance Australia Fair	Advance Australia Fair
Yancuīc Caxtillān	Nova Hispanio
Santa Cruz de la Sierra	Santa Cruz de la Sierra
Boca Juniors	Club Atlético Boca Juniors
Cuiabá	Cuiabá
Īchīmal Mēxihco	Blazono de Meksikio
Guimarães	Guimarães
Īpān Uruguay	Flago de Urugvajo
Diego Rivera	Diego Rivera
Dornbirn	Dornbirn
Chīmalxōchitl	Sunfloro
Rio Branco	Rio Branco (Acre)
Campinas	Campinas
Maracaibo	Marakajbo
Л	El (cirila alfabeto)
Tlālalacatl	Blankfrunta ansero
Porto Velho	Porto Velho
Īpān Nicānāhuac	Flago de Nikaragvo
Bugatti Veyron	Bugatti Veyron
Teōtīhuahcān	Teotiŭakano
Katana	Japana glavo
Huanaco	Gvanako
Santiago Tlachco	Santiago de Querétaro
Chalchiuhcuehcān	Veracruz (komunumo)
Tlenemāctli	Olibano
Īpān Cōzcatlān	Flago de Salvadoro
San José	San José
Ч	Ĉe (cirila alfabeto)
Ш	Ŝa (cirila alfabeto)
Н	Н (cirila alfabeto)
Ф	Ef (cirila alfabeto)
Vietnam Airlines	Vietnam Airlines
Villa Alemana	Villa Alemana
Chālchihuitl	Jado
Cemānāhuac tlāhuāntli ītech neīcxitapayolhuiliztli 2010	Futbala Mondpokalo 2010
Cananea	Cananea
Burger King	Burger King
Cuīcani	Kantisto
Chīchīlcītlalli īmētz	Naturaj satelitoj de Marso
Tzitzimītl	Demono
The Police	The Police
Huapalcepayahuiliztli	Neĝtabulado
Sololá	Sololao
Īpān Cuauhtēmallān	Flago de Gvatemalo
О	O (cirila alfabeto)
Mōlli	Saŭco
Bels	Wels
Vinillahualli	Gramofondisko
Cauhcaxitl	Brakhorloĝo
Teōtl	Diaĵo
Cu	Cu
Cahuāyohyacānaliztli	Rajdado
Chīuhpōhualhuaztiliztli	Komputado
Atahualpa	Ataŭalpo
М	Em (cirila alfabeto)
Edward Elgar	Edward Elgar
Xōchitēnācatl	Smeraldotukano
Quetzalcōātl	Kecalkoatlo (majaoj)
Ц	Ce (cirila alfabeto)
Х	Ĥa (cirila alfabeto)
У	U (cirila alfabeto)
С	Es (cirila alfabeto)
Boa Vista	Boa Vista (Rorajmo)
Popōcatepētl	Popocatépetl
Disneyland	Disneyland
HNK Hajduk Split	Hajduk Split
Wavre	Wavre (Belgio)
Р	Er (cirila alfabeto)
Jeanne Calment	Jeanne Calment
Benito Juárez	Benito Juárez
Cuammiztli	Jaguarundio
Щ	Ŝĉa (cirila alfabeto)
With the Beatles	With the Beatles
Т	Te (cirila alfabeto)
Elena Paparizou	Elena Paparizou
Juana Inés de la Cruz	Sor Juana Inés de la Cruz
Cochabamba	Cochabamba (urbo)
Xamitl	Adobo
Tīzatl	Kreto (ŝtono)
Michpatlāni	Flugofiŝoj
In Teōtlahtōlneltocōni	Kredokonfeso
Mictlāntēuccītlalli īmētz	Naturaj satelitoj de Plutono
Viña del Mar	Viña del Mar
Guarulhos	Guarulhos
Caxtiltōtōtl	Bankiva koko
Tzopilōtl	Katartedoj
Curlant	Kurlando
Yacapitzāhuac (tōtōtl)	Nigrakola grebo
Tlacetīliztli (tlapōhualmatiliztli)	Kunaĵo
Serravalle	Serravalle (San-Marino)
Bressanone	Brixen
Ю	Ju (cirila alfabeto)
Abasolo	Abasolo
Ocnamacoyān	Trinkejo
Tōltēcatl	Toltekoj
Teōtlālmazātl	Antilokapro
Cuīcāmoxtli	Partituro
Caxitl	Kesto
Ocēlōmichin	Tigroŝarko
SEAT	SEAT
Cuīcayōtl neneuhcāyōtl	Muzika ĝenro
Yamaha	Yamaha Corporation
Pixies	Pixies
Rigoberta Menchú	Rigoberta Menchú
Pyeongchang	Pjonĉango
Я	Ja (cirila alfabeto)
Sorocaba	Sorocaba
León, Guanajuato	León (Guanajuato)
Pītic	Hermosillo
Antonio José de Sucre	Antonio José de Sucre
Tlacetilīlli Huēyāltepētl in Tlahco Ixachitlān	Unuiĝintaj Provincoj de Centra Ameriko
Sintra	Sintra
Vicente Fox	Vicente Fox Quesada
Un Chien Andalou	Un chien andalou
Matthew Bellamy	Matthew Bellamy
Xihuitl (tlanelhuayōtl)	Herbo
Felipe VI	Filipo la 6-a (Hispanio)
Chiara d'Assisi	Klara el Asizo
Zacaitzcuintli	Mustelvulpo
Clavimecatl	Klavikordo
Tlācatōtōtl	Amerika reao
Liberdade (São Paulo)	Liberdade (distrikto)
Pancho Villa	Francisco Villa
Xōchimiztli	Margajo
Cōzcacuāuhtli	Reĝa katarto
Āxcān cāhuitl	Estanteco
Iquitos	Iquitos
Live Aid	Live Aid
Cuappachtli	Okra
Universidad de Buenos Aires	Universitato de Bonaero
Tzopilōcuāuhtli	Kalifornia kondoro
Tlacuachin	Ordinara didelfo
Cantinflas	Cantinflas
Chīmalhuahcān	Chimalhuacán
Shumerlya	Ŝumerla
Mēxihcali	Mexicali
Michcoztli	Moruo
Universidad de Concepción	Universidad de Concepción
Āltepēnānyōtl	Metropolo
Morelia	Morelia
Juan Rulfo	Juan Rulfo
Mēxihcatlācatiyāncuīcatiliztli	Himno Nacional Mexicano
Aguascalientes, Aguascalientes	Aguascalientes (urbo)
Loreto (tlālxeliuhcāyōtl)	Departemento de Loreto
Rishon LeZion	Riŝon-Le-Ciono
Chiquihuitl	Korbo
Amazonas (Peru)	Departemento Amazonio (Peruo)
Tecpacuihcuilli	Jaspo
Francisco de Quevedo	Francisco de Quevedo
Jedward	Jedward
Chīlli	Kapsiko
Ic cē mētztli īpan 2008	Januaro de 2008
Dido Armstrong	Dido (kantistino)
Reggaeton	Regetono
Tlaxcalli	Tortiljo
San Luis Potosí, San Luis Potosí	San Luis Potosí (urbo)
World Music	Mondmuziko
Cuzco (tlālxeliuhcāyōtl)	Regiono Kusko
Arequipa (tlālxeliuhcāyōtl)	Departemento Arekipa
Caxamarca (tlālxeliuhcāyōtl)	Departemento Kaĥamarkio
Ancax	Departemento Ankaŝo
Puno (tlālxeliuhcāyōtl)	Departemento de Puno (Peruo)
Ayacucho (tlālxeliuhcāyōtl)	Departemento Ajakuĉo
Caxamarca	Kaŝamarko (Peruo)
Tlālxeliuhcāyōtl La Libertad (Peru)	La Libertad (Peruo)
Nøtterøy	Nøtterøy
Tōchtlān Gutiérrez	Tuxtla Gutiérrez
Chīlpantzinco Bravo	Chilpancingo
Āhuacamōlli	Avokada kaĉo
Junín	Junina Regiono
Peugeot 206	Peugeot 206
Cacahuatetl	Kakao
León, Nicānāhuac	León (Nikaragvo)
Piura (tlālxeliuhcāyōtl)	Departemento Piura
Ica (tlālxeliuhcāyōtl)	Departemento Ika
Santa Marta (Colombia)	Sankta Marta
Tōllohcān Lerdo	Toluca (komunumo)
Tumbes (tlālxeliuhcāyōtl)	Departemento Tumbes
Tlālxeliuhcāyōtl Lambayeque	Departemento Lambayeque
Ambato	Ambato (Ekvadoro)
Cualnezcāltepēc	Villahermosa
San Lucar de Barrameda	Sanlúcar de Barrameda
Glastonbury, Somerset	Glastonbury
Tesla Roadster	Tesla Roadster
Madre de Dios (tlālxeliuhcāyōtl)	Madre de Dios
Pedro de Alvarado	Pedro de Alvarado
Pasco	Regiono Pasco
Cōlhuahcān Rosales	Culiacán
San Martín (tlālxeliuhcāyōtl)	Departemento San Martín
Lima (tlālxeliuhcāyōtl)	Lima Regiono
Tlālxeliuhcāyōtl Centzonātl	Departemento Sonsonate
Mēxihco ītlahtōllō	Historio de Meksiko
Huehcāuh Cuauhtēmallān	Antikva Gvatemalo (urbo)
Wadowice	Wadowice
Paul Walker	Paul Walker
Troxillo, Perú	Trujillo (Peruo)
Adolfo Suárez	Adolfo Suárez
Mēxihcatl Tēahcomanaliztli	Meksika revolucio
Leticia, Colombia	Leticia
Machala	Maĉala
Huanuco (tlālxeliuhcāyōtl)	Departemento Huánuco
Peugeot 307	Peugeot 307
Rock tlacuīcaliztli	Bando (muziko)
Chichimichin	Delfenoj
Yōlchicāuhtlahtōl	Dekstra korno
Lamborghini Murciélago	Lamborghini Murciélago
Francisco I. Madero	Francisco I. Madero
Cúcuta	Cúcuta
Pucallpa	Pucallpa
Bocas del Toro (huēyāltepētl)	Bokas-del-Toro
Tlācatōcāitl	Laŭloka nomo
Álvaro Obregón	Álvaro Obregón
Hidalgo (tlahtōlmelāhuacātlāliztli)	Hidalgo (apartigilo)
Chāhuiztli	Damaĝbesto
Chīmalāyotl	Martestudoj
Onohuayān Valparaíso	Valparaiso (regiono)
Nāuhcalpan Juárez	Naucalpan
Universidad Complutense de Madrid	Komplutensa Universitato de Madrido
Popol Vuh	Popol Vuh
Xālāpan Enríquez	Xalapa
Ramla	Ramlo
Universidad Nacional Autónoma de México	Universidad Nacional Autónoma de México
César Vallejo	César Vallejo
Ibagué	Ibagué
Āyōtl	Testuduloj
Hu	Hu
Granada	Granado (apartigilo)
Piura	Pjuro
Tl	Tl
Santa Fe	Santa Fe
Āpātzco	Apaxco
Santa Ana	Santa Ana
Tzompanco	Zumpango
Nariño	Nariño
Tz	Tz
Tlālcoyōtl	Taksideo
Universidad de Chile	Universitato de Ĉilio
Tlachicuazti 2007	Junio de 2007
Cundinamarca	Kundinamarko
Puno	Punjo
Tlāloc	Tlaloko
Beni	Beniio
Mochīntīn tepozmalacatl tlātlāliani	Aŭtomobilmarko
Pāntli	Muro (apartigilo)
Tlachicōnti 2006	Julio de 2006
Tlachicōnti 2007	Julio de 2007
Tlaōnti 2007	Februaro de 2007
Tlālxeliuhcāyōtl Cochabamba	Koĉabambo
Tlālxeliuhcāyōtl Tarixa	Tariŝio
Run	RUN
Tolima	Tolimo
Tlayēti 2007	Marto de 2007
Tlachicuēiti 2007	Aŭgusto de 2007
Tlamahtlācti 2008	Oktobro de 2008
Tlālxeliuhcāyōtl Santa Cruz	Santa-Kruzio (Bolivio)
Chuquisaca	Ĉukisakio
Ahtlapāleh	Anĝelo
Cuixin	Buteo (genro)
Manizales	Manizales
Tlamahtlāccēti 2007	Novembro de 2007
Amy Smart	Amy Smart
Pando	Pando (Bolivio)
Tlamahtlāccēti 2006	Novembro de 2006
Tlamācuīlti 2008	Majo de 2008
Īpān Vasconia	Flago de Eŭskio
Tlanāuhti 2007	Aprilo de 2007
Tlamācuīlti 2007	Majo de 2007
Tlanāuhti 2008	Aprilo de 2008
Ic cē mētztli īpan 2010	Januaro de 2010
Tlamahtlācti 2007	Oktobro de 2007
Tunja	Tunja
Tlamahtlāccēti 2008	Novembro de 2008
Lucía Etxebarria	Lucía Etxebarria
Maria del Mar Bonet	Maria del Mar Bonet
Elvira Lindo	Elvira Lindo
Tlachicuazti 2006	Junio de 2006
Ic cē mētztli īpan 2009	Januaro de 2009
Tlālxeliuhcāyōtl Potosí	Potosiio
Cītlaltepētl	Citlaltepetl
Ángeles Caso	Ángeles Caso
Mérida	Mérida
Ehcatōtōtl	Kapuĉmerĝo
Tlamahtlācōnti 2008	Decembro de 2008
Tlachicuēiti 2008	Aŭgusto de 2008
Tlachiucnāuhti 2008	Septembro de 2008
Tlachicōnti 2008	Julio de 2008
Ic cē mētztli īpan 2011	Januaro de 2011
Alotl	Makao (birdo)
Bucaramanga	Bucaramanga
Pinar del Río	Pinar del Río
Pete Seeger	Pete Seeger
Romagna	Romanjo
San José Chināntequilla	San José Chinantequilla
Lewes, Sussex Tlāpcopa	Lewes
Renault 4	Renault 4
Halloween	Halloween
Tlāhuihpochchōtl	Sorĉado
Chiclayo	Chiclayo
Funes, Italia	Villnöß
Intibucá	Intibucá
70 xihuitl	70-aj jaroj
Cuīcatlahtōl	Muziknoto
Alejandro Jodorowsky	Alejandro Jodorowsky
Omitl	Osto
Universidad Nacional Mayor de San Marcos	Universidad Nacional Mayor de San Marcos
Tlayēti 2008	Marto de 2008
Tlachicuazti 2008	Junio de 2008
Tlamahtlācōnti 2007	Decembro de 2007
Guarujá	Guarujá
80 xihuitl	80-aj jaroj
Tlanāuhti 2006	Aprilo de 2006
Tacna	Takno
Tampico	Tampico
Exija	Écija
San Pedro Zōllān	San Pedro Sula
Tezoquitl	Gipso
Xuxa	Xuxa
900 xihuitl	900-aj jaroj
Conēyōtl	Infanaĝo
90 xihuitl	90-aj jaroj
910 xihuitl	910-aj jaroj
Nāuhpōhualmahtlāctli omōme	92 (nombro)
Nāuhpōhualcaxtōloncē	96 (nombro)
Ōmpōhualomēyi	43 (nombro)
San Pablo Macuiltianquiz	San Pablo Macuiltianguis
Abejones	Abejones
José María Morelos (āltepēcalpōlli)	José María Morelos
Mazda 6 Atenza II	Mazda 6
Dolores Heredia	Dolores Heredia
Miguel de la Madrid	Miguel de la Madrid Hurtado
Costa-Gavras	Costa-Gavras
Lázaro Cárdenas	Lázaro Cárdenas del Río
Enrique Peña Nieto	Enrique Peña Nieto
Ernesto Zedillo	Ernesto Zedillo Ponce de León
Baltazar Enrique Porras Cardozo	Baltazar Enrique Porras Cardozo
Tecciztli	Heliko
Miccāilhuitl	Tago de la mortintoj
Renault Clio	Renault Clio
Ātzapocuahuitl	Pouteria campechiana
Guadalupe Victoria	Guadalupe Victoria (Durango)
N!xau	N!Xau
Venustiano Carranza	Venustiano Carranza
Martín de Porras	Martín de Porres
Ousmane Sembène	Ousmane Sembene
Carlos Salinas de Gortari	Carlos Salinas de Gortari
Francesco di Paola	Francisko de Paola
David Alfaro Siqueiros	David Alfaro Siqueiros
Tupaq Amaru II	Tupak-Amaru la 2-a
Andrés Manuel López Obrador	Andrés Manuel López Obrador
Chayohtli	Ĉajoto
Ic cē mētztli īpan 2006	Januaro de 2006
Xālxococuahuitl	Gujavo
Aguascalientes īāltepēcalpōlhuān	Listo de komunumoj en Aguascalientes
Tlayēti 2006	Marto de 2006
Tlaōnti 2006	Februaro de 2006
Facundo Cabral	Facundo Cabral
Tlachicōnti 2005	Julio de 2005
Cozumel	Cozumel
Quetzaltenānco (āltepēcalpōlli)	Ketzaltenango
Tlamahtlācti 2005	Oktobro de 2005
Popayán	Popayán
Salto, Uruguay	Salto (urbo)
Juan Diego Cuāuhtlahtoātzin	Johano Diego
Tīzoc	Tizok
John Sheperd-Barron	John Shepherd-Barron
Ācatlān	Acatlán
Ātocpan	Actopan
Tungurahua	Tungurahua
Mariano Azuela	Mariano Azuela
Jiří Trnka	Jiří Trnka
Castelo Branco	Castelo Branco
Molotl (tōtōtl)	Ruĝkapa karpodako
Brennero	Brenner
Chittagong	Ĉitagongo
Nimatullah Youssef Kassab Al-Hardini	Sankta Nimatullah Kassab Al-Hardini
Nezahualcoyōtl	Nezahualcóyotl
Salvatore Nunnari	Salvatore Nunnari
Bernardino de Sahagún	Bernardino de Sahagún
Nicolás Bravo	Nicolás Bravo
Chiquito de la Calzada	Chiquito de la Calzada
Aeroméxico	Aeroméxico
Partido Verde Ecologista de México	Partido Verde Ecologista de México
Arecibo tlahtōltzintli	Arecibo-mesaĝo
Ń	Ń
Tlīltzapocuahuitl	Diospyros nigra
Tohtli	Striakcipitro
Tinum (āltepēcalpōlli)	Tinúm
Torreón	Torreón
Tecpin	Pulo
Carichí (āltepēcalpōlli)	Carichí
Quechōlli	Ajajao
Nacamatl	Kartono (materialo)
Tlaxcallān īāltepēcalpōlhuān	Listo de komunumoj en Tlaxcala
Michael J. Fox	Michael J. Fox
Abasolo (Yancuīc León īāltepēcalpōl)	Abasolo (Nuevo León)
-h-	Saltillo
Ācatlān Pérez Figeroa	Acatlán de Pérez Figueroa
Agua Blanca de Iturbide	Agua Blanca de Iturbide
Tepalcatepēc (āltepēcalpōlli)	Tepalcatepec
Camohpāltic	Viola
Cosío	Cosío
Ācapōletlān (āltepēcalpōlli)	Acaponeta
Tomaizquitl	Arbuto (genro)
Nazaret	Nazareto
San Juan de Sabinas (āltepēcalpōlli)	San Juan de Sabinas
Cēmpōhualchicōme	27 (nombro)
Cēmpōhualcaxtōlli	35 (nombro)
Nāuhpōhualcaxtōlonnāhui	99 (nombro)
Ātlitzintlah	Alvarado
Francisco (huēyi teōpixcātlahtoāni)	Francisko (papo)
Soraya Jiménez	Soraya Jiménez
Noah Gordon	Noah Gordon
Chetumal	Chetumal
Carazo	Karazo (departemento)
Tēcuāncōātl	Krotalo
Tlamahtlācōnti 2005	Decembro de 2005
Volkswagen Touran	Volkswagen Touran
Ātzompan	Monte Albán
Petén	Peten
Tlanāuhti 2005	Aprilo de 2005
Alamogordo	Alamogordo
Huancayo	Huancayo (urbo)
Ācoyōtl	Anhingo
Ehēcalquixohuayān Tan Son Nhat	Flughaveno Tan Son Nhat
Depeche Mode	Depeche Mode
Yahualtzintli	Muzikalbumo
São Paulo Metro	Metroo en San-Paŭlo
Walmart	Walmart
The Cranberries	The Cranberries
Sigur Rós	Sigur Rós
Mr. Bean	Mr. Bean
Keane	Keane
Erasure	Erasure
Tarkan Tevetoğlu	Tarkan
Smells Like Teen Spirit	Smells Like Teen Spirit
San Bernardino, California	San Bernardino (Kalifornio)
Monterey, California	Monterey
Salinas, California	Salinas (Kalifornio)
Tlamantli	Objekto (filozofio)
Michel Teló	Michel Teló
.nl	.nl
Rainer Brüderle	Rainer Brüderle
Puntarenas (huēyāltepētl)	Puntarenas
Adela Noriega	Adela Noriega
Chris Pratt	Chris Pratt
Xomōtl	Bluflugila anaso
Renault 21	Renault 21
Ayacucho	Ajakuĉo
Huanuco	Ŭanuko
Alta Verapaz	Alta Verapaco
Baja Verapaz	Malalta Verapaco
Huancavelica (tlālxeliuhcāyōtl)	Departemento Huankavelika
Zacatepēc, Cuauhtēmallān	Sakatepekezo
San Rafael, Veracruz	San Rafael
Tepēāpōlco	Tepeapulco
Chimbote	Ĉimboto
Tlālxeliuhcāyōtl Xālātēnanco	Departemento Chalatenango
Kami	Kamio
Ehēcatzinco	Ecatzingo
Huēyizacatlān	San Cristóbal de las Casas
Kanasín (āltepēcalpōlli)	Kanasín
Kaká	Kaká
Tōnatiuhco	Tonatico
Acambay Ruiz Castañeda	Acambay
Tekax (āltepēcalpōlli)	Tekax
Concepción de La Vega	Concepción de la Vega
Texcaltitlan	Texcaltitlán
Cēmpōhualchiucnāhui	29 (nombro)
Huexōtzinco	Huejotzingo
Peugeot 304	Peugeot 304
Tlāhuīlmecatl	Drato
Fernando del Paso	Fernando del Paso
Carlos Núñez	Carlos Núñez
Joan Fuster	Joan Fuster
Cuauhcoxolihtli	Invaria mutuo
Tlālxeliuhcāyōtl Āhuachāmpan	Departemento Ahuachapán
Mecano	Mecano (grupo)
Cuammantlah	Huamantla
Āmanacocheh	Grandkapa klangulo
Mēxihcah in ōmpa Tlacetilīlli Tlahtohcāyōtl	Meksik-usonanoj
Hot Wheels	Hot Wheels
Osuna	Osuna
Tlālxeliuhcāyōtl León	Leono (departemento)
Dominic Howard	Dominic Howard
Cēmpōhualchicuēyi	28 (nombro)
Īxiptlayōlcāyōtl	Kino
Capōlālpan Méndez	Capulalpam de Méndez
Tlālxeliuhcāyōtl Santa Bárbara (Honduras)	Santa Bárbara
2060	2060
Veraguas	Veragŭo
Nāuhpōhualcaxtōlli	95 (nombro)
Cēmpōhualcaxtōlomēyi	38 (nombro)
Itzcuāuhtli	Ornata spizaeto
San Pedro Pōchōtlān	San Pedro Pochutla
Isidro Fabela	Isidro Fabela
Coyocahco	Cuyoaco
Arizpe	Arizpe
Pōctlān Guerrero (āltepēcalpōllōtl)	Putla Villa de Guerrero
Āpitzauhco	Apizaco
Ātlatlālacatl	Ansero
Palos de la Frontera	Palos de la Frontera
Mīltomatl	Physalis philadelphica
Tlālxeliuhcāyōtl Atlántida	Atlántida
Aramberri	Aramberri
Huēiyac chicāuhtlahtōl	Makrono
Ōmpōhualmācuīlli	45 (nombro)
Mēxihco Tlahtohcātēīxiptla	Prezidanto de Meksiko
Santo Domingo Tēcuāntepēc	Santo Domingo Tehuantepec
Ehēcatōtolin	Granda vojkurulo
Neiva	Neiva
Cuīcatiani	Muzikisto
Tonantzin Coromoto	Virgulino de Coromoto
Xōchimīlco	Ŝoĉimilko
Huitzitzilmichin	Belono
Marías Tlālhuāctli	Islas Marías
Tlālxeliuhcāyōtl Chināntēcapan	Ĉinandego (departemento)
Atapalcatl	Jamajka anaso
Arthur Seyß-Inquart	Arthur Seyß-Inquart
Mamixtli	Krano
Caratagena de Indias	Kartageno (Kolombio)
Los Cabos	Los Cabos
Coyōhuahcān	Coyoacán
Wieselburg	Wieselburg
Iztāccihuātl	Istaksiŭatlo
Zacatōchin	Vulkankuniklo
2073	2073
Quiché, Cuauhtēmallān	Kiĉeo (departemento)
Santa Ana (tlālxeliuhcāyōtl)	Departemento Santa Ana (Salvadoro)
San Miguel, Cōzcatlān	San Miguel de la Frontera
Tlamācuīlti 2005	Majo de 2005
Tlachicuazti 2005	Junio de 2005
Juárez	Juárez
Nāuhpōhualcaxtōlomōme	97 (nombro)
Xināchtēcatl	Nevado de Toluca
Drew Barrymore	Drew Barrymore
Machu Picchu	Maĉupikĉuo
Francesco d'Assisi	Sankta Francisko el Asizo
Renault Dauphine	Renault Dauphine
Solidaridad (āltepēcalpōlli)	Solidaridad
Ācachichictli	Okcidenta grebo
Cōcohtli	Inkaa kolombo
Partido Revolucionario Institucional	Revolucia Institucia Partio
Ic cē mētztli īpan 2005	Januaro de 2005
Nāuhpōhualmahtlāctli onnāhui	94 (nombro)
Armería (āltepēcalpōlli)	Armería
Darién	Darieno
Cuauhnacaztli (huēyāltepētl)	Guanacaste
Nāuhpōhualmahtlāctli oncē	91 (nombro)
Nextlālpan	Nextlalpan
2097	2097
Izabal	Izabal
Cuauhtēmallān (Tlālxeliuhcāyōtl)	Gvatemalo (departemento)
Juliaca	Juliaca
Xālcanauhtli	Amerika fajfanaso
De facto	De facto
Ichanehquiliz tlacatiyan	Listo de landoj laŭ loĝantaro
Cēmpōhualoncē	21 (nombro)
Cēmpōhualomōme	22 (nombro)
Ōmpōhualoncē	41 (nombro)
Cēmpōhualmahtlāctli onnāhui	34 (nombro)
Cēmpōhualmahtlāctli omēyi	33 (nombro)
Ōmpōhualchicōme	47 (nombro)
Cēmpōhualmahtlāctli oncē	31 (nombro)
Cēmpōhualmahtlāctli omōme	32 (nombro)
Ōmpōhualonnāhui	44 (nombro)
Ōmpōhualchicuacē	46 (nombro)
Ōmpōhualchiucnāhui	49 (nombro)
Ōmpōhualchicuēyi	48 (nombro)
Cēmpōhualcaxtōlomōme	37 (nombro)
Cēmpōhualcaxtōlonnāhui	39 (nombro)
Cēmpōhualcaxtōloncē	36 (nombro)
Chris Martin	Chris Martin
Nāuhpōhualcaxtōlomēyi	98 (nombro)
Jenni Rivera	Jenni Rivera
Ichcatl	Kotonujo
Santa Tecla, Cōzcatlān	Santa Tecla
Tlālxeliuhcāyōtl Rivas	Rivas (departemento)
Santiago Apóstol īteōpan (Tequixquiāc)	Paroko de Santiago Tequixquiac
Āltepētl Mēxihco Metro	Metroo de Meksikurbo
Kėdainiai	Kėdainiai
Chiriquí	Ĉirikio
Santa Ana, Cōzcatlān	Santa Ana (Salvadoro)
Patox	Hejmanaso
Āteponaztli	Nord-amerika botaŭro
Ātīzapan Zaragoza	Atizapán de Zaragoza
Huilōtl	Plorturto
Tlaōnti 2005	Februaro de 2005
Tōnalmachiyōtl	Azteka kalendaro
Tulcán	Tulcán
Chiquimollān	Ĉikimulo
San Miguel de Allende	San Miguel de Allende
Crimea	Aŭtonoma Respubliko Krimeo
Āpipipitzcatl	Franklina mevo
Ātlīxco	Atlixco
Tehuiloyohcān (āltepēcalpōlli)	Teoloyucan
Īpān Andalucia	Flago de Andaluzio
Montemorelos	Montemorelos
Ānahuāc, Yancuīc León	Anáhuac
Chīmaltēnanco	Ĉimaltenango
Okinawa, Xapon	Gubernio Okinavo
Partido de la Revolución Democrática	Partio de la Demokratia Revolucio
Kukulkán	Kukulkano
Bragança	Bragança
Ixtehuilotl	Lenso (optiko)
Ehēcalquixohuayān ītlālpancalactihuechiliz Da Nang	Flughaveno Da Nang
Santa Elena (āltepēcalpōlli)	Santa Elena (Yucatán)
Zacāpan	Zakapo
Huaraz	Huaraz
Mazāxococuahuitl	Spondias mombin
Instituto Nacional de Estadística y Geografía	INEGI
Xālāpan, Cuauhtēmallān	Halapo
Itzcuintlān	Eskvintlo
El Progreso	Progreso (departemento)
Shintō	Ŝintoismo
Ōmpōhualomōme	42 (nombro)
Irapuato	Irapuato (komunumo)
Electronica	Elektroniko (muziko)
Will Champion	Will Champion
Coclé	Kokleo (provinco)
Tumbes	Tumpiurbo
Centzontlahtōleh	Norda mokbirdo
Cuāchichiquilzōlin	Kalifornia koturno
Panasonic	Panasonic
Bono	Bono Vox
Cacomiztli	Kakomistlo
Ica	Ica (urbo)
Tehuahcān	Tehuacán
Āhuēhuētēnanco	Huehuetenango
Pichilemu tlālolīniliztli īpan 2010	Tertremo de Piĉilemo (2010)
Copan	Copán (departemento)
Santiago Tequixquiāc	Santiago Tequixquiac
Quetzaltenānco	Ketzaltenango (departemento)
2061	2061
Tlālnepantlah Baz	Tlalnepantla de Baz
Peugeot 104	Peugeot 104
Mägo de Oz	Mägo de Oz
Tlayēti 2005	Marto de 2005
Partido Acción Nacional	Meksika Partio pri Agado Nacia
Montería	Monteria
Xincoyōtl	Phrynosomatidae
Puerto Vallarta	Puerto Vallarta
VietJet Air	VietJet Air
Tlālhuāctli Guadalupe	Insulo Guadalupe
Chaplin	Chaplin
Tlālxeliuhcāyōtl La Paz (Honduras)	La Paz (hondura departemento)
Tlālxeliuhcāyōtl Ocotepēc	Ocotepeque
Ōllālco	Olancho
Tlālxeliuhcāyōtl Valle	Valle (departemento)
Tlālxeliuhcāyōtl Gracias a Dios	Gracias a Dios
Tlālxeliuhcāyōtl Colón	Colón
Cabañas	Francisco Morazán (departemento)
Calcactli	Pantoflo
Xōchitepēc, Cuauhtēmallān	Suĉitepekezo
San Marcos, Cuauhtēmallān	Sankta Marko (departemento)
Totōnicāpan	Totonikapano
Santa Rosa, Cuauhtēmallān	Sankta Roza (departemento)
Retalhuleu	Retalhuleu
Boca del Río	Boca del Río
2075	2075
2076	2076
2077	2077
2078	2078
2072	2072
2074	2074
2079	2079
2069	2069
2068	2068
2067	2067
2071	2071
2065	2065
2066	2066
2070	2070
Tlālxeliuhcāyōtl Cholōltēcac	Choluteca
Ehēcalquixohuayān Ca Mau	Flughaveno Ca Mau
Córdoba	Kordovo
Tlahcotlālpan	Tlacotalpan
Copalli	Kopalo
Tlālxeliuhcāyōtl Cabañas	Departemento Cabañas
-ll-	LL
Renault 4CV	Renault 4CV
Villa del Carbón	Villa del Carbón
Cocollān (āltepēcalpōlli)	Cocula
Isla Mujeres (āltepēcalpōlli)	Isla Mujeres
Tlālxeliuhcāyōtl San Miguel	Departemento San Miguel
Tlālxeliuhcāyōtl La Libertad (Cōzcatlān)	Departemento La Libertad (Salvadoro)
Tekantó (āltepēcalpōlli)	Tekantó
Mandi	Mandi
Jesús María (Aguascalientes īāltepēcalpōl)	Jesús María (Aguascalientes)
Reconquista, Argentina	Reconquista (Argentino)
Yakult	Yakult
Tlatlayān	Tlatlaya
Universidad de los Andes (Chile)	Universidad de Los Andes
Hocabá (āltepēcalpōlli)	Hocabá
Wilamowice	Wilamowice
Zōyapanco	Soyapango
Orchestral Manoeuvres In The Dark	Orchestral Manoeuvres in the Dark
Dolores Hidalgo	Dolores Hidalgo
Ātzitzintlān	Atzitzintla
Nanacamīlpan Mariano Arista	Nanacamilpa de Mariano Arista
Cunduacán (āltepēcalpōlli)	Cunduacán
Chīlchōtlān (āltepēcalpōlli)	Chilchota (Michoacán)
Iztāccuāuhtli	Blanka buteo
2086	2086
2089	2089
2087	2087
2088	2088
2098	2098
2080	2080
2093	2093
2092	2092
2081	2081
2090	2090
2099	2099
2096	2096
2095	2095
2091	2091
2085	2085
2083	2083
2084	2084
2094	2094
2082	2082
Chināntēcapan	Chinandega
Anamã	Anamã
Hunucmá (āltepēcalpōlli)	Hunucmá
Toquinho	Toquinho
Guaymas	Guaymas
Huilōnco	Córdoba (Veracruz)
Nogales, Sonora	Nogales (Sonora)
Ahuilizāpan	Orizaba
Āzcapōtzalco	Azcapotzalco (Meksiko)
San Luis Río Colorado	San Luis Río Colorado
Huacho	Huacho
Tōchpan, Veracruz	Túxpan
Ostia	Ostia
Mazāmictlān	Mazamitla
Izamal	Izamal
Nicān Mopōhua	Nican mopohua
Tepoztlān	Tepoztlan
Otavalo	Otavalo
Vrahovice	Vrahovice
Sincelejo	Sincelejo
2064	2064
2063	2063
2062	2062
Tlālxeliuhcāyōtl Oruro	Oruro
San Juan Chamollan	San Juan Chamula
Chiyan	Salvia hispanica
Ācxoyātōtōtl	Hararpego
Power ballad	Balado (muziko)
José Vasconcelos	José Vasconcelos
El Cerrito, Valle del Cauca	El Cerrito
Zōlin	Montezuma koturno
Tlālhuāctli Clarión	Insulo Klarjono
Cōātepēc, Veracruz	Coatepec (Veracruz)
Historia general de las cosas de Nueva España	Ĝenerala historio pri la aferoj de Nova Hispanio
Tzompanco (āltepēcalpōlli)	Zumpango (Meksikŝtato)
Tlālxeliuhcāyōtl Ocēlōtlān	Departemento Usulután
Tlālxeliuhcāyōtl Morazán	Departemento Morazán
Tlālxeliuhcāyōtl Yōllōtl	Yoro
Tlālxeliuhcāyōtl La Paz (Cōzcatlān)	Departemento La Paz (Salvadoro)
Tlālxeliuhcāyōtl San Vicente	Departemento San Vicente
Māxtlatl	Zontuko
Iztapallohcān	Ixtapaluca
Tlālxeliuhcāyōtl Cōzcatlān	Departemento Cuscatlán
Tlālxeliuhcāyōtl La Unión	Departemento La Unión
Otomih	Otomioj
Huitzolmeh	Huiĉoloj
Marqués de Comillas (āltepēcalpōlli)	Marqués de Comillas
Δ	Delto
San Jacinto Amilpas	San Jacinto Amilpas
San Antonio de la Cal	San Antonio de la Cal
San Andrés Huēyāpan	San Andrés Huayapam
San Agustín Yatareni	San Agustín Yatareni
San Agustín de las Juntas	San Agustín de las Juntas
Tlamahtlācōnti 2006	Decembro de 2006
Tlaxēxelōliztli (tlapōhualmatiliztli)	Divido
Tzanatl	Grandavosta kviskalo
Catona	Catona
Rosanna Marani	Rosanna Marani
Ehēcalquixohuayān	Flughaveno
Ra (teōtl)	Reo
Santiago	Santiago
Mixcōācuāuhtli	Urubitingo
San Sebastián Tōltlah	San Sebastián Tutla
Tlīlcuāuhtli	Monta solaglo
60 xihuitl	60-aj jaroj
50 xihuitl	50-aj jaroj
40 xihuitl	40-aj jaroj
30 xihuitl	30-aj jaroj
Tezontzapocuahuitl	Pouteria sapota
Χ	Ĥio
Cuauhtitlan Izcalli	Cuautitlán Izcalli
Ātlacomōlco	Atlacomulco
Tēnācatl	Tukano (birdo)
Tōllān Allende (āltepēcalpōlli)	Tula de Allende
Tlālhuāctli Socorro	Insulo Socorro
Neneuhcāyōtl:Teutontlālpan	Kategorio:Germanio
Neneuhcāyōtl:Italia	Kategorio:Italio
Neneuhcāyōtl:Tlacetilīlli Tlahtohcāyōtl	Kategorio:Usono
Neneuhcāyōtl:Rusia	Kategorio:Rusio
Neneuhcāyōtl:Canada	Kategorio:Kanado
Neneuhcāyōtl:Tlacetilīlli Huēyitlahtohcāyōtl	Kategorio:Unuiĝinta Reĝlando
Neneuhcāyōtl:Caxtillān	Kategorio:Hispanio
Neneuhcāyōtl:China	Kategorio:Ĉinio
Neneuhcāyōtl:Xapon	Kategorio:Japanio
Neneuhcāyōtl:Australia	Kategorio:Aŭstralio
Neneuhcāyōtl:Mēxihco	Kategorio:Meksiko
Neneuhcāyōtl:India	Kategorio:Barato
Neneuhcāyōtl:Saudarabia	Kategorio:Sauda Arabio
Neneuhcāyōtl:Israel	Kategorio:Israelo
Neneuhcāyōtl:In Vaticano	Kategorio:Vatikano
Neneuhcāyōtl:Turquia	Kategorio:Turkio
Neneuhcāyōtl:Africa Huitztlāmpa	Kategorio:Sud-Afriko
Neneuhcāyōtl:Egipto	Kategorio:Egiptio
Neneuhcāyōtl:Iran	Kategorio:Irano
Neneuhcāyōtl:Yancuīc Zetlālpan	Kategorio:Nov-Zelando
Neneuhcāyōtl:Argentina	Kategorio:Argentino
0 xihuitl	0-aj jaroj
20 xihuitl	20-aj jaroj
Volkswagen Jetta III	Volkswagen Vento
Ātōyāxocotl	Spondias purpurea
Newcastle upon Tyne	Newcastle-upon-Tyne
Pedro Páramo	Pedro Páramo
Āhuēhuētl	Ahuehuete-arbo
Cuitlacochin (nanacatl)	Maiza ustilago
1120 xihuitl	1120-aj jaroj
Armando Manzanero	Armando Manzanero
Neneuhcāyōtl:Afganistan	Kategorio:Afganio
Neneuhcāyōtl:Argelia	Kategorio:Alĝerio
Neneuhcāyōtl:Austria	Kategorio:Aŭstrio
Neneuhcāyōtl:Bangladex	Kategorio:Bangladeŝo
Neneuhcāyōtl:Cuba	Kategorio:Kubo
Neneuhcāyōtl:Etiopia	Kategorio:Etiopio
Neneuhcāyōtl:Indonesia	Kategorio:Indonezio
Neneuhcāyōtl:Irac	Kategorio:Irako
Neneuhcāyōtl:Tlanitlālpan	Kategorio:Nederlando
Neneuhcāyōtl:Nigeria	Kategorio:Niĝerio
Neneuhcāyōtl:Polonia	Kategorio:Pollando
Neneuhcāyōtl:Portugal	Kategorio:Portugalio
Neneuhcāyōtl:Singapur	Kategorio:Singapuro
Neneuhcāyōtl:Corea Huitztlāmpa	Kategorio:Sud-Koreio
Neneuhcāyōtl:Sudan	Kategorio:Sudano
Neneuhcāyōtl:Suiza	Kategorio:Svislando
Ātotonilco Tollān	Atotonilco de Tula
Neneuhcāyōtl:Tanzania	Kategorio:Tanzanio
Neneuhcāyōtl:Taitlālpan	Kategorio:Tajlando
Neneuhcāyōtl:Ucrania	Kategorio:Ukrainio
Neneuhcāyōtl:Vietnam	Kategorio:Vjetnamio
Neneuhcāyōtl:Tōtōtl	Kategorio:Birdoj
Neneuhcāyōtl:Nemiltōpīllōtl	Kategorio:Bakterioj
Neneuhcāyōtl:Tlanelhuayōmatiliztli	Kategorio:Plantoj
Neneuhcāyōtl:Iuhcāyōtl	Kategorio:Fiziko
Neneuhcāyōtl:Yōlizmatiliztli	Kategorio:Biologio
Neneuhcāyōtl:Huēhuehcāyōmatiliztli	Kategorio:Historio
Neneuhcāyōtl:Cemānāhuacāyōtl	Kategorio:Geografio
Neneuhcāyōtl:Teōmatiliztli	Kategorio:Religio
Tonānītlān	Tonanitla
Neneuhcāyōtl:Tlatilizmatiliztli	Kategorio:Scienco
Neneuhcāyōtl:Tlahtōliztli	Kategorio:Lingvo
Neneuhcāyōtl:Tlālticpactli	Kategorio:Tero
Tlālhuāctli Coronado	Insuloj Koronadoj
Mētztitlan	Metztitlán
La Paz	La-Pazo (apartigilo)
Mēxihcali (āltepēcalpōlli)	Mexicali (komunumo)
Huēyipochtlān (āltepēcalpōlli)	Hueypoxtla
Tlālxeliuhcāyōtl San Salvador	Departemento San-Salvadoro
Mulegé (āltepēcalpōllōtl)	Mulegé
Huitzitzillān	Tzintzuntzan
Ilamatzapocuahuitl	Annona macroprophyllata
Ācuīcuīyalōtl	Klifhirundo
Chiyāhualōtl	Olivo
Tequixquiāpan	Tequisquiapan
Salina Cruz	Salina Cruz
Chālco (āltepēcalpōlli)	Chalco
Otompan	Otumba
Xīlōpanco	Ilopango (urbo)
Lázaro Cárdenas (Quintana Roo īāltepēcalpōl)	Lázaro Cárdenas (Quintana Roo)
Felipe Carrillo Puerto (āltepēcalpōlli)	Felipe Carrillo Puerto
Ic cē mētztli īpan 2007	Januaro de 2007
Neneuhcāyōtl:Ōmicqueh xiuhpan 2012	Kategorio:Mortintoj en 2012
Othón P. Blanco (āltepēcalpōlli)	Othón P. Blanco
Tulum (āltepēcalpōlli)	Tulum (komunumo)
Bacalar (āltepēcalpōlli)	Bacalar
Etzapocuahuitl	Pikilanono
Xōchitlān Zaragoza	Juchitán de Zaragoza
Tabatinga, Amazonas	Tabatinga (Amazonio)
Mazātlān (Chiyapan īāltepēcalpōllō)	Mazatán (Chiapas)
Alikovo	Alikovo
Cōācalco Berriozábal	Coacalco de Berriozábal
Ātēnco	Atenco (komunumo)
Tetlapanaloyān	Tlapanaloya
Chico Anysio	Chico Anysio
Urucurituba	Urucurituba
La Libertad	La Libertad
Tōnallān, Xālīxco	Tonalá
Metepēc (Tlahtohcāyōtl Mēxihco īāltepēcalpōl)	Metepec (Meksikŝtato)
Huēyi Caxtillān xōnacatl	Poreo
Tabatinga, São Paulo	Tabatinga (São Paulo)
Cuauhtitlan (Tlahtohcāyōtl Mēxihco īāltepēcalpōl)	Cuautitlán
Ācōlmān	Acolman
Tlamācuīlti 2006	Majo de 2006
Guerrero (Cōāhuillān īāltepēcalpōl)	Guerrero (Coahuila)
Motul (āltepēcalpōlli)	Motul
Hecelchakán	Hecelchakán
Tīzayohcān	Tizayuca
Aldama (āltepēcalpōlli)	Aldama
Benemérito de las Américas (āltepēcalpōlli)	Benemérito de las Américas
Tlalconetl	Limako
Tecamac	Tecámac
Chihcōloāpan	Chicoloapan
Ālmolōyān Juárez	Almoloya de Juárez
Tzinācantepēc (Tlahtohcāyōtl Mēxihco īāltepēcalpōl)	Zinacantepec
Lerma (āltepēcalpōlli)	Lerma (Meksikŝtato)
Īxtlahuahcān	Ixtlahuaca
Cōātepēc, Michhuahcān	Zitácuaro
Lagos de Moreno	Lagos de Moreno
Valle de Chālco Solidaridad	Valle de Chalco Solidaridad
Huēyimanco (āltepēcalpōlli)	Huimanguillo
Neneuhcāyōtl:Olimpicayoh neāhuiltiliztli	Kategorio:Olimpikoj
Neneuhcāyōtl:Cristianismo	Kategorio:Kristanismo
Neneuhcāyōtl:Islam	Kategorio:Islamo
Neneuhcāyōtl:Judaísmo	Kategorio:Judismo
Chris Wolstenholme	Chris Wolstenholme
Valle de Bravo	Valle de Bravo
Calpōllāpan	Calpulalpan
Tlachco (Tlaxcallān īāltepēcalpōl)	Tlaxco (komunumo)
Cuauhtlāntzinco	Cuautlancingo
Āquīxtlān	Aquixtla
Āhuēhuētitlan	Ahuehuetitla
Xāltocān, Hidalgo	Jaltocán
Atitalaquiāc	Atitalaquia
Honey	Honey
Ācatzinco	Acatzingo
Āhuatlān	Ahuatlán
Coyōmehāpan	Coyomeapan
Ācatēnoh	Acateno
Ātzitzihuahcān	Atzitzihuacán
Janos (āltepēcalpōlli)	Janos
Panōco (Zacatēcapan īāltepēcalpōl)	Pánuco (Zacatecas)
Āteōpan	Acteopan
Ācōloahco	Coronango
Ācaxtlāhuacān	Albino Zertuche
Maní (āltepēcalpōlli)	Maní (komunumo)
Tlamahtlācti 2006	Oktobro de 2006
Zoquitlān	Zoquitlán
Ātēxcal	Atexcal
Āmixtlān	Amixtlán
Xōchipālli	Salmo (koloro)
Ahome (āltepēcalpōlli)	Ahome
Iztapan Iztātl (āltepēcalpōlli)	Ixtapan de la Sal
Abdelmajid Lakhal	Abdelmajid Lakhal
Pinahuizāpan	Perote
Playas de Rosarito	Playas de Rosarito
Tlacuīcaliztli	Ensemblo (muziko)
Cuāuhtli	Aglo
Tzompanco Ocampo	Zumpango de Ocampo
Malīnalco (āltepēcalpōlli)	Malinalco
El Oro (Tlahtohcāyōtl Mēxihco īāltepēcalpōl)	El Oro (Meksikŝtato)
Wolfgang Schüssel	Wolfgang Schüssel
Puebla īāltepēcalpōlhuān	Listo de komunumoj de Puebla
Xīlōtzinco	Jilotzingo
Zōltepēc	Sultepec
Tzayānalquilāpan Juárez	Soyaniquilpan de Juárez
Āmatepēc	Amatepec
Comalcalco (āltepēcalpōlli)	Comalcalco (komunumo)
Jerez de García Salinas	Jerez (Zacatecas)
Coyōtepēc (Tlahtohcāyōtl Mēxihco īāltepēcalpōl)	Coyotepec (Meksikŝtato)
Huēhuehtohcān (āltepēcalpōlli)	Huehuetoca
Tlapālpan	Tapalpa
Huitzquillohcān	Huixquilucan
Tlachiucnāuhti 2007	Septembro de 2007
La Paz (Tlahtohcāyōtl Mēxihco īāltepēcalpōl)	La Paz (Meksikŝtato)
Xīlōtepēc (Tlahtohcāyōtl Mēxihco īāltepēcalpōl)	Jilotepec (Estado de México)
Ācōlco	Aculco
Candelaria, Campeche	Candelaria (Campeche)
Escárcega	Escárcega
Tlahtohcāyōtl Mēxihco īāltepēcalpōlhuān	Listo de komunumoj de Meksikŝtato
Mineral del Monte	Mineral del Monte
San Mateo Ātēnco	San Mateo Atenco
Ocoyacac	Ocoyoacac
Xōchitepēc (Tlahtohcāyōtl Mēxihco īāltepēcalpōl)	Juchitepec
Ālmolōyān Alquisiras	Almoloya de Alquisiras
Arandas, Xālīxco	Arandas (Jalisco)
Benedicta Boccoli	Benedicta Boccoli
Dzidzantún (āltepēcalpōlli)	Dzidzantún
Āhuacatlān, Puebla	Ahuacatlán (Puebla)
Sotuta (āltepēcalpōlli)	Sotuta
Dzemul (āltepēcalpōlli)	Dzemul
San Blas (āltepēcalpōlli)	San Blas
Kaua (āltepēcalpōlli)	Kaua
Río Lagartos (āltepēcalpōlli)	Río Lagartos
Satevó (āltepēcalpōlli)	Satevó
Chiyauhtlah, Puebla	Chiautla de Tapia
Huitzilāc	Huitzilac
Aconchi (āltepēcalpōlli)	Aconchi
San Felipe del Progreso	San Felipe del Progreso
El Llano, Aguascalientes	El Llano
Huitzāpan	Huichapan
Guazapares	Guazapares
Ālmolōyān Ātōyātl (āltepēcalpōlli)	Almoloya del Río
Chihuahhua (āltepēcalpōlli)	Chihuahua (komunumo)
Tzinācantlān	Zinacantán
Carolina Ferraz	Carolina Ferraz
Guerrero (Chihuahhua īāltepēcalpōl)	Guerrero (Chihuahua)
Xālōztōc	Xaloztoc
Madera (āltepēcalpōlli)	Madera
Zacatlān	Zacatlán
Jérôme Ruggiero	Jérôme Ruggiero
Īxīptlayōlizyacānqui	Reĝisoro
Chicxulub Pueblo (āltepēcalpōlli)	Chicxulub Pueblo
Tlālmanalco	Tlalmanalco
Campeche (āltepēcalpōlli)	Campeche (komunumo)
Tizimín (āltepēcalpōlli)	Tizimín
Tepetlaōztōc	Tepetlaoxtoc
Akil (āltepēcalpōlli)	Akil
Cantamayec (āltepēcalpōlli)	Cantamayec
Calotmul (āltepēcalpōlli)	Calotmul
Baca (āltepēcalpōlli)	Baca (Yucatán)
Conkal (āltepēcalpōlli)	Conkal
Cenotillo (āltepēcalpōlli)	Cenotillo
Xālpan (Tabasco īāltepēcalpōl)	Jalpa de Méndez
Cacalchén (āltepēcalpōlli)	Cacalchén
Yaxcabá (āltepēcalpōlli)	Yaxcabá
Bokobá (āltepēcalpōlli)	Bokobá
Dzan (āltepēcalpōlli)	Dzan
Chocholá (āltepēcalpōlli)	Chocholá
Dzilam González (āltepēcalpōlli)	Dzilam González
Chikindzonot (āltepēcalpōlli)	Chikindzonot
Homún (āltepēcalpōlli)	Homún
Hoctún (āltepēcalpōlli)	Hoctún
Cuncunul (āltepēcalpōlli)	Cuncunul
Chankom (āltepēcalpōlli)	Chankom
Kantunil (āltepēcalpōlli)	Kantunil
Chacsinkín (āltepēcalpōlli)	Chacsinkín
Chapab (āltepēcalpōlli)	Chapab
Dzilam de Bravo (āltepēcalpōlli)	Dzilam de Bravo
Ucú (āltepēcalpōlli)	Ucú
Temax (āltepēcalpōlli)	Temax
Tetiz (āltepēcalpōlli)	Tetiz
Tixcacalcupul (āltepēcalpōlli)	Tixcacalcupul
Sinanché (āltepēcalpōlli)	Sinanché
Sanahcat (āltepēcalpōlli)	Sanahcat
Muna (āltepēcalpōllōtl)	Muna
Huhí (āltepēcalpōlli)	Huhí
Sacalum (āltepēcalpōlli)	Sacalum
Yaxkukul (āltepēcalpōlli)	Yaxkukul
Quintana Roo (āltepēcalpōlli)	Quintana Roo (Yucatán)
Timucuy (āltepēcalpōlli)	Timucuy
Seyé (āltepēcalpōlli)	Seyé
Kinchil (āltepēcalpōlli)	Kinchil
Mocochá (āltepēcalpōlli)	Mocochá
Tahdziú (āltepēcalpōlli)	Tahdziú
Suma (āltepēcalpōlli)	Suma (Jukatanio)
Tepakán (āltepēcalpōlli)	Tepakán
Tekit (āltepēcalpōlli)	Tekit
Mama (āltepēcalpōlli)	Mama (Jukatanio)
Xocchel (āltepēcalpōlli)	Xocchel
Tahmek (āltepēcalpōlli)	Tahmek
Telchac Puerto (āltepēcalpōlli)	Telchac Puerto
Yobaín (āltepēcalpōlli)	Yobaín
Tixpéhual (āltepēcalpōlli)	Tixpéhual
Samahil (āltepēcalpōlli)	Samahil
Kopomá (āltepēcalpōlli)	Kopomá
Āohtlān Navarro	Autlán de Navarro
Uayma (āltepēcalpōlli)	Uayma
Sucilá (āltepēcalpōlli)	Sucilá
Tekal de Venegas (āltepēcalpōlli)	Tekal de Venegas
Teya (āltepēcalpōlli)	Teya
Sudzal (āltepēcalpōlli)	Sudzal
Tixméhuac (āltepēcalpōlli)	Tixméhuac
Tenānco Ēhēcatl	Tenango del Aire
Tlalyacapan	Tlayacapan
Cōātepēc Yōltextli	Coatepec Harinas
Santa Ana Chiyauhtēmpan	Chiautempan
Tlalpoxahuac Rayón	Tlalpujahua
Gran Morelos	Gran Morelos
Cimapan	Zimapán
San Francisco del Oro (āltepēcalpōlli)	San Francisco del Oro
López (āltepēcalpōlli)	López (Chihuahua)
Ātlauhtlān	Atlautla
Teōtenānco	Tenango del Valle
Mēxihcatlahtohcāyōtl	Azteka imperio
Nāyohpan	Naupan
Chiyauhtlah	Chiautla
Tōltitlan	Tultitlán
Eduardo Neri (āltepēcalpōlli)	Eduardo Neri
Calnalli	Calnali
Melchor Ocampo (Tlahtohcāyōtl Mēxihco īāltepēcalpōl)	Melchor Ocampo
Victoria (Guanajuato īāltepēcalpōl)	Victoria (Guanajuato)
Āpozōlli (āltepēcalpōlli)	Apozol
Ātocpan, Veracruz	Actopan (Veracruz)
Ācatlān, Puebla	Acatlán de Osorio
Alto Lucero de Gutiérrez Barrios	Alto Lucero de Gutiérrez Barrios
Ācatlān, Veracruz	Acatlán (Veracruz)
Nava (āltepēcalpōlli)	Nava (Coahuila)
Maxcanú (āltepēcalpōlli)	Maxcanú
Āxālpan	Ajalpan
Mérida (Yucatān īāltepēcalpōllō)	Mérida (Yucatán)
Tiyanquiztēnco	Tianguistenco
Chālchiuhcomōllān Sesma	Chalchicomula de Sesma
Tlāchquiyāuhco	Heroica Ciudad de Tlaxiaco
Matamoros (Chihuahhua īāltepēcalpōl)	Matamoros (Chihuahua)
Cōzauhuayān	El Arenal (Hidalgo)
Manuel Benavides (āltepēcalpōlli)	Manuel Benavides
Tetzontepēc Aldama	Tezontepec de Aldama
Namiquipa (āltepēcalpōlli)	Namiquipa
Nuevo Casas Grandes (āltepēcalpōlli)	Nuevo Casas Grandes
Rosales (āltepēcalpōlli)	Rosales (komunumo)
Yanga (āltepēcalpōlli)	Yanga
Valladolid (Yucatān īāltepēcalpōl)	Valladolid (Yucatán)
Sabinas (āltepēcalpōlli)	Sabinas
Guachochi (āltepēcalpōlli)	Guachochi
Lamadrid (āltepēcalpōlli)	Lamadrid
Tzucacab (āltepēcalpōlli)	Tzucacab
Ātōyātēmpan	Atoyatempan
Santa María Quiegolani	Santa María Quiegolani
Tixkokob (āltepēcalpōlli)	Tixkokob
Francisco I. Madero (Hidalgo īāltepēcalpōl)	Francisco I. Madero (Hidalgo)
Moris (āltepēcalpōlli)	Moris (Chihuahua)
Julimes (āltepēcalpōlli)	Julimes
Calvillo (āltepēcalpōlli)	Calvillo
Bolaños	Bolaños
Tekom (āltepēcalpōlli)	Tekom
Umán (āltepēcalpōlli)	Umán
Tunkás (āltepēcalpōlli)	Tunkás
Ticul (āltepēcalpōlli)	Ticul
Cuzamá (āltepēcalpōlli)	Cuzamá
Cansahcab (āltepēcalpōlli)	Cansahcab
Panabá (āltepēcalpōlli)	Panabá
Xālāpan (Tabasco īāltepēcalpōl)	Jalapa (Tabasco)
Nacaxocān (āltepēcalpōlli)	Nacajuca
Macuspana (āltepēcalpōlli)	Macuspana
Balancán (āltepēcalpōlli)	Balancán
Tlahcotalpan (āltepēcalpōlli)	Tacotalpa
Telchac Pueblo (āltepēcalpōlli)	Telchac Pueblo
Chemax (āltepēcalpōlli)	Chemax
San Felipe (Yucatān īāltepēcalpōl)	San Felipe (Yucatán)
Xonotlān (āltepēcalpōlli)	Jonuta
Paraíso (āltepēcalpōlli)	Paraíso
Acanceh (āltepēcalpōlli)	Acanceh
Renault Symbol II	Renault Symbol
Conrad Bain	Conrad Bain
Calmecac	Kalmekako
Ācatīc (āltepēcalpōlli)	Acatic
Mayapán (āltepēcalpōlli)	Mayapán
Santa Isabel (Chihuahhua īāltepēcalpōl)	Santa Isabel (Chihuahua)
Ahmozoc	Amozoc
Tlachcoāpan	Tlaxcoapan
Āmanalco	Amanalco
Ojinaga (āltepēcalpōlli)	Ojinaga
Āhuexōyohcān	Alfajayucan
Neneuhcāyōtl:Machiyōtl	Kategorio:Ĝermo
Neneuhcāyōtl:Nehnencācītlalli	Kategorio:Planedoj
Neneuhcāyōtl:Categoría	Kategorio:Kategorioj
Neneuhcāyōtl:Xihuitl	Kategorio:Jaroj
Neneuhcāyōtl:Cemantoc tlālli	Kategorio:Kontinentoj
Cárdenas (Tabasco īāltepēcalpōl)	Cárdenas (Tabasco)
Tecoh (āltepēcalpōlli)	Tecoh
Peto (āltepēcalpōlli)	Peto (komunumo)
Chumayel (āltepēcalpōlli)	Chumayel
Teāpan (āltepēcalpōlli)	Teapa
Espita (āltepēcalpōlli)	Espita
Temozón (āltepēcalpōlli)	Temozón
Teabo (āltepēcalpōlli)	Teabo
Ācaxitetl, Puebla	Acajete (Puebla)
Chiucnāuhāpan	Chignahuapan
Cuauhchinānco	Huauchinango
Āhuazoltepēc	Ahuazotepec
Ocampo (Chihuahhua īāltepēcalpōl)	Ocampo (Chihuahua)
Āxacopan	Ajacuba
Canauhtlān (āltepēcalpōlli)	Canatlán
Chiyapan Mota	Chapa de Mota
Ācaxōchitlān (āltepēcalpōlli)	Acaxochitlán
Oxkutzcab (āltepēcalpōlli)	Oxkutzcab
Matachí (āltepēcalpōlli)	Matachí
Galeana (āltepēcalpōlli)	Galeana (Chihuahua)
Maravatío	Maravatío
Ahumada	Ahumada
Donato Guerra (āltepēcalpōlli)	Donato Guerra
Āpan	Apan
Hidalgo del Parral (āltepēcalpōlli)	Hidalgo del Parral
Manzanillo (Cōlimān īāltepēcalpōllō)	Manzanillo (Colima)
Abalá (āltepēcalpōlli)	Abalá
Cintlān (āltepēcalpōlli)	Centla
Meoqui (āltepēcalpōlli)	Meoqui
Ignacio Zaragoza (āltepēcalpōlli)	Ignacio Zaragoza
Riva Palacio	Riva Palacio
Abasolo (Guanajuato īāltepēcalpōl)	Abasolo (Guanajuato)
Āmacōzāc	Amacuzac
Ōmetepēc	Ometepec
Santa Clara del Cobre	Salvador Escalante
Centro (āltepēcalpōlli)	Centro (Tabasco)
Nayaritetlahtōlli	Koraa lingvo
Guadalupe y Calvo (āltepēcalpōlli)	Guadalupe y Calvo
Guadalupe (Chihuahhua īāltepēcalpōl)	Guadalupe (Chihuahua)
Nonoava (āltepēcalpōlli)	Nonoava
Pahuatlān	Pahuatlán
Halachó (āltepēcalpōlli)	Halachó
Nohpaltepēc	Nopaltepec
Luvianos	Luvianos
Morelos (Tlahtohcāyōtl Mēxihco īāltepēcalpōl)	Morelos (Meksikŝtato)
Xālātlauhco (āltepēcalpōlli)	Xalatlaco
Villa Guerrero (Xālīxco īāltepēcalpōl)	Villa Guerrero (Jalisco)
Mazācōātlān	Mascota
10 xihuitl	10-aj jaroj
Broken/Tōnatiuh īchān	Ŝablono:Sunsistemo
Cōcohtitlan	Cocotitlán
Torreón (āltepēcalpōlli)	Torreón (komunumo)
Xocotitlan	Jocotitlán
Harry Potter	Hari Poter (ulo)
Calīxcuātl:Cuīcayōtl	Portalo:Muziko
Calīxcuātl:Cemānāhuacāyōtl	Portalo:Geografio
Cuauhtlah, Xālīxco	Cuautla (Jalisco)
Temīlpan	Timilpan
Texohpilco	Tejupilco
Xōnacatlān	Xonacatlán
Xiquipilco	Jiquipilco
Tzapotlān Juárez	Zapotlán de Juárez
Ocēlōtepēc	Otzolotepec
Texcalyacac	Texcalyacac
Tepēīxpan	Tepetlixpa
Calimayān	Calimaya
Tetzonyohcān	Tezoyuca
Ōztōmpan	Ozumba
Hidalgotitlan (āltepēcalpōlli)	Hidalgotitlán
Zoquitzinco	Joquicingo
Temazcalāpan	Temascalapa
Pāpalōtlān (āltepēcalpōlli)	Papalotla
Temamatlah	Temamatla
Polotitlan	Polotitlán
Zacatzonāpan	Zacazonapan
Āyauhpanco	Ayapango
Ocuillān	Ocuilan
Coyametl Zotolli	Coyame del Sotol
Ocēlōāpan	Otzoloapan
Temazcaltzinco	Temascalcingo
Cihuātepēc	San Simón de Guerrero
Mēxihcaltzinco	Mexicaltzingo
Capolhuac	Capulhuac
Iztapan Teōcuitlatl	Ixtapan del Oro
Nezahualcoyōtl (āltepēcalpōlli)	Nezahualcóyotl (komunumo)
Isidro Fabela (āltepēcalpōlli)	Isidro Fabela (komunumo)
Citlallān (āltepēcalpōlli)	Zitlala
Nizo Neto	Nizo Neto
Naranjacuahuitl	Oranĝujo
Francisco Gabilondo Soler	Francisco Gabilondo Soler
São Paulo Metro - Pāntli 1	Linio 1 de Metroo en San-Paŭlo
Ātīzapan	Atizapán
Cadyer	Cadyer
Villa Victoria	Villa Victoria (Meksikŝtato)
Mineral de la Reforma	Mineral de la Reforma
Ātocpan (Hidalgo īāltepēcalpōl)	Actopan (Hidalgo)
San Salvador (Hidalgo īāltepēcalpōl)	San Salvador (Hidalgo)
San Antonio la Isla	San Antonio la Isla
Tlalhuelilpan	Tlahuelilpan
Tōlcayohcān	Tolcayuca
Chapoltepēc, Tlahtohcāyōtl Mēxihco	Chapultepec (Meksikŝtato)
Mōlanco	Molango de Escamilla
Tenānco Doria	Tenango de Doria
Temazcaltepēc	Temascaltepec
Omitlān Juárez	Omitlán de Juárez
San Martín de las Pirámides	San Martín de las Pirámides
Chiyapantōnco	Chapantongo
Tōnayān	Tonaya
Zaragoza (Cōāhuillān īāltepēcalpōl)	Zaragoza (Coahuila)
Chapōlhuahcān	Chapulhuacán
Yohualicān	Yahualica
Juárez (Cōāhuillān īāltepēcalpōl)	Juárez (Coahuila)
Mineral del Chico	Mineral del Chico
General Cepeda (āltepēcalpōlli)	General Cepeda
Progreso (Cōāhuillān īāltepēcalpōl)	Progreso (Coahuila)
Cardonal (āltepēcalpōlli)	Cardonal (komunumo)
Tepētitlan (Hidalgo īāltepēcalpōl)	Tepetitlán
Tenāntzinco Degollado	Tenancingo (Meksikŝtato)
Tlālxinolli (āltepēcalpōlli)	Tlanchinol
Tetepanco	Tetepango
Temōhuayān	Temoaya
Progreso de Obregón	Progreso de Obregón
Ālxoxōuhcān	Aljojuca
Ocampo (Cōāhuillān īāltepēcalpōl)	Ocampo (Coahuila)
Santa María Coyōtepēc	Santa María Coyotepec
Cuauhtlah, Hidalgo	Huautla
Jiménez (Cōāhuillān īāltepēcalpōl)	Jiménez (Coahuila)
Gómez Farías (āltepēcalpōlli)	Gómez Farías (Tamaulipas)
Tzoncoliuhcān	Zongolica
Escobedo (Cōāhuillān īāltepēcalpōl)	Escobedo
Aguililla (āltepēcalpōlli)	Aguililla
Acuitzio	Acuitzio
Mizquiyahuallān Juárez	Mixquiahuala de Juárez
Viesca (āltepēcalpōlli)	Viesca
Abasolo (Cōāhuillān īāltepēcalpōl)	Abasolo (Coahuila)
Sierra Mojada (āltepēcalpōlli)	Sierra Mojada
Juárez Hidalgo (āltepēcalpōlli)	Juárez Hidalgo
Castaños (āltepēcalpōlli)	Castaños
Villa Unión (āltepēcalpōlli)	Villa Unión
Morelos (Cōāhuillān īāltepēcalpōl)	Morelos (Coahuila)
Ramos Arizpe (āltepēcalpōlli)	Ramos Arizpe
Monclova (āltepēcalpōlli)	Monclova
Santiago de Anaya	Santiago de Anaya
Arteaga (Cōāhuillān īāltepēcalpōl)	Arteaga (Coahuila)
Candela (Cōāhuillān īāltepēcalpōl)	Candela (Coahuila)
Sacramento (Cōāhuillān īāltepēcalpōl)	Sacramento (Coahuila)
Teōtitlan Flores Magón	Teotitlán de Flores Magón
Santa María Xadani (āltepēcalpōllōtl)	Santa María Xadani
Tecōlmān (āltepēcalpōlli)	Tecomán
Hidalgo (Cōāhuillān īāltepēcalpōl)	Hidalgo (Coahuila)
San José del Rincón	San José del Rincón
Piedras Negras (āltepēcalpōlli)	Piedras Negras
Tepētzalan (āltepēcalpōlli)	Tepezalá
Nadadores (āltepēcalpōlli)	Nadadores
San Buenaventura (Cōāhuillān īāltepēcalpōl)	San Buenaventura (Coahuila)
Jiménez (Chihuahhua īāltepēcalpōl)	Jiménez (Tamaulipas)
Allende (Cōāhuillān īāltepēcalpōl)	Allende (Coahuila)
Santa Cruz Amilpas	Santa Cruz Amilpas
Cuatrociénegas (āltepēcalpōlli)	Cuatro Ciénegas
Villa de Allende	Villa de Allende
Matamoros (Cōāhuillān īāltepēcalpōl)	Matamoros (Coahuila)
Frontera (āltepēcalpōlli)	Frontera (Coahuila)
Rayón (Tlahtohcāyōtl Mēxihco īāltepēcalpōl)	Rayón (Meksikŝtato)
Āmiztli	Marleono
Villa Guerrero	Villa Guerrero
Ācatlān (Hidalgo īāltepēcalpōl)	Acatlán (Hidalgo)
Tenāntzinco (Tlaxcallān īāltepēcalpōl)	Tenancingo (Tlaxcala)
Tozantlān (āltepēcalpōlli)	Tuzantla
San Bartolo Coyōtepēc	San Bartolo Coyotepec
Cītlaltepēc Trinidad Sánchez Santos	Zitlaltepec de Trinidad Sánchez Santos
Āyōtōchco	Ayotoxco de Guerrero
Camohcuautlah	Camocuautla
Caltepēc, Puebla	Caltepec
Ātzālan	Atzala
Āxōtlān	Axutla
Ātēmpan	Atempan
Calpan	Calpan
Cuauhtzalan	Cohetzala
Angamacutiro	Angamacutiro
Ātotonilco in Hueyi	Atotonilco el Grande
Parras (āltepēcalpōlli)	Parras
Āhuatomatl	Glano
Mangocuahuitl	Mangarbo
Nemachiyōtīlli:Tl	Ŝablono:Ŝ
Nemachiyōtīlli:Userbox	Ŝablono:Uzantoskatolo1
Nemachiyōtīlli:Calīxatl:Āxcāncāyōtl	Ŝablono:ĈefPaĝoMondAktualaĵo
Neneuhcāyōtl:Tlācatiyān	Kategorio:Landoj
Huiquipedia:Tētlamahmacanih	Vikipedio:Administrantoj
Neneuhcāyōtl:Mēxihco īmācēhualcalpōlhuān	Kategorio:Etnoj en Meksiko
Neneuhcāyōtl:Cazactlālpan	Kategorio:Kazaĥio
Neneuhcāyōtl:Tīciyōtl	Kategorio:Medicino
Neneuhcāyōtl:Cemitquimatiliztli	Kategorio:Politiko
Neneuhcāyōtl:Tōltēcayōtl	Kategorio:Arto
Egipto	Egiptujo
Rincón de Romos (āltepēcalpōlli)	Rincón de Romos
Nemachiyōtīlli:Bot	Ŝablono:Bot
Canada	Kanado
Neneuhcāyōtl:Hungria	Kategorio:Hungario
Neneuhcāyōtl:Belgica	Kategorio:Belgio
Neneuhcāyōtl:Chipre	Kategorio:Kipro
Neneuhcāyōtl:Chequia	Kategorio:Ĉeĥio
Neneuhcāyōtl:Dinamarca	Kategorio:Danio
Neneuhcāyōtl:Estonia	Kategorio:Estonio
Neneuhcāyōtl:Fintlālpan	Kategorio:Finnlando
Neneuhcāyōtl:Grecia	Kategorio:Grekio
Neneuhcāyōtl:Letonia	Kategorio:Latvio
Neneuhcāyōtl:Iztlālpan	Kategorio:Islando
Neneuhcāyōtl:Luxemburgo	Kategorio:Luksemburgo
Neneuhcāyōtl:Lituania	Kategorio:Litovio
Neneuhcāyōtl:Malta	Kategorio:Malto
Neneuhcāyōtl:Suecia	Kategorio:Svedio
Neneuhcāyōtl:Eslovaquia	Kategorio:Slovakio
Neneuhcāyōtl:Eslovenia	Kategorio:Slovenio
Puruándiro (āltepēcalpōlli)	Puruándiro
Tetzcohco Mora	Texcoco
Ánimas Trujano	Ánimas Trujano
Neneuhcāyōtl:Berlin	Kategorio:Berlino
Neneuhcāyōtl:Europan	Kategorio:Eŭropo
Nemachiyōtīlli:Documentation	Ŝablono:Dok
Neneuhcāyōtl:Tlatequitiltililli ic tlahtōlli	Kategorio:Vikipediistoj laŭ lingvo
Huiquipedia:Tlatequitiltilīlli nemachiyotilli	Vikipedio:Uzantoskatolo
Huiquipedia:Calīxcuātl	Vikipedio:Portaloj
Ācaxitetl, Veracruz	Acajete (Veracruz)
Sung Jae-gi	Sung Jae-gi
Āmaxac Guerrero	Amaxac de Guerrero
Āxapochco	Axapusco
Nemachiyōtīlli:Softredirect	Ŝablono:Intervikia plusendilo
Nemachiyōtīlli:Destruir	Ŝablono:Forigu tuj
Nemachiyōtīlli:Sucesion	Ŝablono:Sinsekvo
Ezxococuahuitl	Puniko
Neneuhcāyōtl:Tlahtōlli	Kategorio:Lingvoj
Tlazohmatiliztlācatl	Filozofo
Neneuhcāyōtl:Huiquipedia	Kategorio:Vikipedio
Itzmiquilpan (āltepēcalpōlli)	Ixmiquilpan
Chicōntepēc	Chicontepec
Huiquipedia:General disclaimer	Vikipedio:Malgarantio
Huiquipedia:Manual de estilo	Vikipedio:Stilogvido
Nemachiyōtīlli:Navbox	Ŝablono:Navigilo2
Caxhuahcān	Caxhuacan
Nemachiyōtīlli:Tlahuiltequiliztli	Ŝablono:Mallongigo
Chapolco	Chapulco
Cōātepēc, Puebla	Coatepec (Puebla)
Cōātzinco	Coatzingo
Cuauhyohcān	Cuayuca de Andrade
Ohuihcān	Cohuecán
Coyōtepēc, Puebla	Coyotepec (Puebla)
Cuāuhtinchān	Cuautinchán
Cuappiyaztlān	Cuapiaxtla de Madero
Cuauhtēmpan	Cuautempan
Cuetzallān Progreso	Cuetzalan del Progreso
Ayohtli	Kukurbo
Españita	Españita
Nemachiyōtīlli:!	Ŝablono:!
Nemachiyōtīlli:Tnavbar	Ŝablono:Tnavbar
Neneuhcāyōtl:Africa	Kategorio:Afriko
Neneuhcāyōtl:Tlachicōnti	Kategorio:Julio
Neneuhcāyōtl:Tlachicuazti	Kategorio:Junio
Nemachiyōtīlli:Babel	Ŝablono:Babelejo
Nemachiyōtīlli:Commons	Ŝablono:Commons
Nemachiyōtīlli:Link GA	Ŝablono:LigoLeginda
Nemachiyōtīlli:AFG	Ŝablono:AFG
Nemachiyōtīlli:AGO	Ŝablono:AGO
Nemachiyōtīlli:Gnunote	Ŝablono:Gnunote
Nemachiyōtīlli:Tzīmpēhualiztli	Ŝablono:Ĝermo
Nemachiyōtīlli:Tlatequitiltilīlli af-1	Ŝablono:Vikipediisto af-1
Nemachiyōtīlli:Tlatequitiltilīlli ast-1	Ŝablono:Vikipediisto ast-1
Nemachiyōtīlli:Tlatequitiltilīlli bar-1	Ŝablono:Vikipediisto bar-1
Nemachiyōtīlli:Tlatequitiltilīlli eo-1	Ŝablono:Vikipediisto eo-1
Nemachiyōtīlli:Tlatequitiltilīlli ca-1	Ŝablono:Vikipediisto ca-1
Nemachiyōtīlli:Tlatequitiltilīlli ca-4	Ŝablono:Vikipediisto ca-4
Nemachiyōtīlli:Tlatequitiltilīlli eo-3	Ŝablono:Vikipediisto eo-3
Nemachiyōtīlli:Tlatequitiltilīlli de	Ŝablono:Vikipediisto de
Nemachiyōtīlli:Tlatequitiltilīlli de-1	Ŝablono:Vikipediisto de-1
Nemachiyōtīlli:Tlatequitiltililli eu-4	Ŝablono:Vikipediisto eu-4
Nemachiyōtīlli:Tlatequitiltilīlli es	Ŝablono:Vikipediisto es
Nemachiyōtīlli:Tlatequitiltilīlli de-3	Ŝablono:Vikipediisto de-3
Nemachiyōtīlli:Tlatequitiltilīlli en-3	Ŝablono:Vikipediisto en-3
Nemachiyōtīlli:Tlatequitiltilīlli en-1	Ŝablono:Vikipediisto en-1
Nemachiyōtīlli:Tlatequitiltilīlli en-2	Ŝablono:Vikipediisto en-2
Nemachiyōtīlli:Tlatequitiltilīlli eo-2	Ŝablono:Vikipediisto eo-2
Nemachiyōtīlli:Tlatequitiltilīlli en-4	Ŝablono:Vikipediisto en-4
Nemachiyōtīlli:Tlatequitiltilīlli en-0	Ŝablono:Vikipediisto en-0
Nemachiyōtīlli:Tlatequitiltilīlli es-4	Ŝablono:Vikipediisto es-4
Nemachiyōtīlli:Tlatequitiltilīlli en	Ŝablono:Vikipediisto en
Nemachiyōtīlli:Tlatequitiltilīlli de-2	Ŝablono:Vikipediisto de-2
Nemachiyōtīlli:Tlatequitiltilīlli es-1	Ŝablono:Vikipediisto es-1
Nemachiyōtīlli:Tlatequitiltilīlli fi-1	Ŝablono:Vikipediisto fi-1
Nemachiyōtīlli:Tlatequitiltilīlli fr-1	Ŝablono:Vikipediisto fr-1
Nemachiyōtīlli:Tlatequitiltilīlli it-3	Ŝablono:Vikipediisto it-3
Nemachiyōtīlli:Tlatequitiltilīlli ja-1	Ŝablono:Vikipediisto ja-1
Nemachiyōtīlli:Tlatequitiltilīlli it-1	Ŝablono:Vikipediisto it-1
Nemachiyōtīlli:Tlatequitiltilīlli fr	Ŝablono:Vikipediisto fr
Cuzco	Kusko
Neneuhcāyōtl:Tlaōnti	Kategorio:Februaro
Neneuhcāyōtl:Moldova	Kategorio:Moldavio
Nemachiyōtīlli:HRV	Ŝablono:HRV
Neneuhcāyōtl:Azerbaiyan	Kategorio:Azerbajĝano
Neneuhcāyōtl:Asia	Kategorio:Azio
Neneuhcāyōtl:Chile	Kategorio:Ĉilio
Neneuhcāyōtl:Mācuīlpōhualxihuitl XXI	Kategorio:21-a jarcento
Neneuhcāyōtl:Lesoto	Kategorio:Lesoto
Neneuhcāyōtl:Huiquipedia:Plantillas de mantenimiento	Kategorio:Ŝablono:Zorgilo
Neneuhcāyōtl:Tlatequitiltilīlli uk	Kategorio:Vikipediisto uk
Neneuhcāyōtl:Ixachitlān Huitztlāmpa	Kategorio:Sudameriko
Neneuhcāyōtl:Caxtillah īhuān León	Kategorio:Kastilio kaj Leono
Neneuhcāyōtl:Tlatequitiltilīlli uk-N	Kategorio:Vikipediisto uk-D
Nemachiyōtīlli:Esoteric	Ŝablono:Esotera
Neneuhcāyōtl:Malasia	Kategorio:Malajzio
Neneuhcāyōtl:Tlacualli	Kategorio:Manĝaĵoj
Nemachiyōtīlli:Mod	Ŝablono:Mod
Nemachiyōtīlli:SIL	Ŝablono:ISO639-3 ligilo
Nemachiyōtīlli:Tlatequitiltilīlli it	Ŝablono:Vikipediisto it
Nemachiyōtīlli:Tlatequitiltilīlli uk	Ŝablono:Vikipediisto uk
Nemachiyōtīlli:Tlatequitiltilīlli es-2	Ŝablono:Vikipediisto es-2
Nemachiyōtīlli:Meses	Ŝablono:MonatEnkonduko
Neneuhcāyōtl:Mētztli	Kategorio:Luno
Nemachiyōtīlli:USA	Ŝablono:USA
Neneuhcāyōtl:Tlahtōlmatiliztli	Kategorio:Lingvoscienco
Nemachiyōtīlli:ITA	Ŝablono:ITA
Nemachiyōtīlli:GEO	Ŝablono:GEO
Nemachiyōtīlli:BOL	Ŝablono:BOL
Nemachiyōtīlli:MEX	Ŝablono:MEX
Neneuhcāyōtl:Tlatequitiltilīlli fr-1	Kategorio:Vikipediisto fr-1
Nemachiyōtīlli:Image label	Ŝablono:Marko sur bildo
Nemachiyōtīlli:MAR	Ŝablono:MAR
Nemachiyōtīlli:MAD	Ŝablono:MDG
Nemachiyōtīlli:Olympics infobox	Ŝablono:Informkesto olimpiko
Nemachiyōtīlli:Ixiptlaltic tliltetl	Ŝablono:Geografia ĉirkaŭaĵo
Nemachiyōtīlli:KSV	Ŝablono:KOS
Nemachiyōtīlli:TWN	Ŝablono:TWN
Nemachiyōtīlli:KGZ	Ŝablono:KGZ
Nemachiyōtīlli:ISR	Ŝablono:ISR
Nemachiyōtīlli:STP	Ŝablono:STP
Nemachiyōtīlli:VEN	Ŝablono:VEN
Nemachiyōtīlli:UKR	Ŝablono:UKR
Nemachiyōtīlli:TUR	Ŝablono:TUR
Nemachiyōtīlli:Caxitl mopēhua	Ŝablono:Komencskatolo
Nemachiyōtīlli:DJI	Ŝablono:DJI
Nemachiyōtīlli:Tlatequitiltilīlli es-0	Ŝablono:Vikipediisto es-0
Nemachiyōtīlli:Featured article	Ŝablono:Elstara
Neneuhcāyōtl:Ōtlācatqueh xiuhpan 1875	Kategorio:Naskiĝintoj en 1875
Neneuhcāyōtl:Ghana	Kategorio:Ganao
Neneuhcāyōtl:Paris	Kategorio:Parizo
Neneuhcāyōtl:Tlatequitiltilīlli en-4	Kategorio:Vikipediisto en-4
Neneuhcāyōtl:Togo	Kategorio:Togolando
Neneuhcāyōtl:Tlatequitiltilīlli en	Kategorio:Vikipediisto en
Neneuhcāyōtl:Tlatequitiltilīlli zh	Kategorio:Vikipediisto zh
Neneuhcāyōtl:Croacia	Kategorio:Kroatio
Neneuhcāyōtl:Tlatequitiltilīlli en-2	Kategorio:Vikipediisto en-2
Nemachiyōtīlli:Tlatequitiltilīlli eo	Ŝablono:Vikipediisto eo
Neneuhcāyōtl:Machiyōtlahtōltecpantiliztli	Kategorio:Alfabeto
Nemachiyōtīlli:Legend	Ŝablono:Priskribo
Neneuhcāyōtl:Neneuhcāyōtl īpampa tlācatiyān	Kategorio:Kategorioj laŭ landoj
Neneuhcāyōtl:Āltepētl īpan Turquia	Kategorio:Urboj de Turkio
Nemachiyōtīlli:GeoTemplate	Ŝablono:GeoTemplate
Nemachiyōtīlli:Coor URL	Ŝablono:KoordinatojURL
Nemachiyōtīlli:Tlatequitiltilīlli nl-1	Ŝablono:Vikipediisto nl-1
Nemachiyōtīlli:Min	Ŝablono:Minimumo
Nemachiyōtīlli:Wikispecies	Ŝablono:Vikispecoj
Neneuhcāyōtl:Rosaceae	Kategorio:Rozacoj
Nemachiyōtīlli:Tlatequitiltilīlli ru	Ŝablono:Vikipediisto ru
Neneuhcāyōtl:Mācuīlpōhualxihuitl XX	Kategorio:20-a jarcento
Nemachiyōtīlli:Occetlatequitil4	Ŝablono:TemasPri
Neneuhcāyōtl:Chinatibettlahtōlli	Kategorio:Ĉinotibeta lingvaro
Nemachiyōtīlli:USATlahtohcātēīxiptla	Ŝablono:Prezidentoj de Usono
Neneuhcāyōtl:Wikipedia:Plantillas Babel	Kategorio:Babelaj ŝablonoj
Nemachiyōtīlli:LangWithName	Ŝablono:LingvoKunNomo
Neneuhcāyōtl:Āltepētl īpan Marruecos	Kategorio:Urboj de Maroko
Nemachiyōtīlli:Mācēhualcalpōlli	Ŝablono:Informkesto etnaj grupoj
Nemachiyōtīlli:CPV	Ŝablono:CPV
Nemachiyōtīlli:Tlatequitiltilīlli eo-4	Ŝablono:Vikipediisto eo-4
Neneuhcāyōtl:Ōtlācatqueh xiuhpan 1879	Kategorio:Naskiĝintoj en 1879
Neneuhcāyōtl:1955 tlācatiliztli	Kategorio:Naskiĝintoj en 1955
Neneuhcāyōtl:1963 tlācatiliztli	Kategorio:Naskiĝintoj en 1963
Neneuhcāyōtl:Ōtlācatqueh xiuhpan 1812	Kategorio:Naskiĝintoj en 1812
Neneuhcāyōtl:Ōtlācatqueh xiuhpan 1829	Kategorio:Naskiĝintoj en 1829
Neneuhcāyōtl:Ōtlācatqueh xiuhpan 1998	Kategorio:Naskiĝintoj en 1998
Neneuhcāyōtl:Ōtlācatqueh xiuhpan 1834	Kategorio:Naskiĝintoj en 1834
Neneuhcāyōtl:Ōmicqueh xiuhpan 1417	Kategorio:Mortintoj en 1417
Neneuhcāyōtl:Malpighiales	Kategorio:Malpigialoj
Nemachiyōtīlli:Familytree/end	Ŝablono:Genealogia arbo/fino
Neneuhcāyōtl:Mācuīlpōhualxihuitl XIX	Kategorio:19-a jarcento
Neneuhcāyōtl:Tlahcuilōni	Kategorio:Verkistoj
Nemachiyōtīlli:Music-stub	Ŝablono:Ĝermo-muziko
Neneuhcāyōtl:Tlacēnti	Kategorio:Januaro
Nemachiyōtīlli:GTM	Ŝablono:GTM
Nemachiyōtīlli:MYS	Ŝablono:MYS
Nemachiyōtīlli:PLW	Ŝablono:PLW
Nemachiyōtīlli:TJK	Ŝablono:TJK
Nemachiyōtīlli:Image label end	Ŝablono:Marko sur bildo fino
Nemachiyōtīlli:Tlanitlâkuilòlistli	Ŝablono:Ŝablona navigado
Nemachiyōtīlli:GHA	Ŝablono:GHA
Nemachiyōtīlli:GMB	Ŝablono:GAM
Nemachiyōtīlli:DMA	Ŝablono:DMA
Nemachiyōtīlli:ZAF	Ŝablono:ZAF
Quetzaltōtōtl	Kecaloj
Nemachiyōtīlli:Āxcāyōtl-Tlācatiyān	Ŝablono:Naciaj domajnoj de plej alta nivelo
Nemachiyōtīlli:BWA	Ŝablono:BWA
Nemachiyōtīlli:URY	Ŝablono:URY
Nemachiyōtīlli:CUB	Ŝablono:CUB
Nemachiyōtīlli:CMR	Ŝablono:CMR
Nemachiyōtīlli:CODt	Ŝablono:COD
Nemachiyōtīlli:GIN	Ŝablono:GIN
Nemachiyōtīlli:Tlx	Ŝablono:Tlx
Nemachiyōtīlli:CAN	Ŝablono:CAN
Nemachiyōtīlli:DNK	Ŝablono:DNK
Nemachiyōtīlli:FJI	Ŝablono:FJI
Nemachiyōtīlli:SAU	Ŝablono:SAU
Nemachiyōtīlli:DEU	Ŝablono:DEU
Nemachiyōtīlli:BEN	Ŝablono:BEN
Nemachiyōtīlli:Logo	Ŝablono:Emblemo
Nemachiyōtīlli:WSM	Ŝablono:WSM
Nemachiyōtīlli:YEM	Ŝablono:YEM
Xippālli	Turkisa
Xiuhquilipitzāhuac (tlapālli)	Indiga
Nemachiyōtīlli:Babel4	Ŝablono:Babel kadro 4
Nemachiyōtīlli:Image label small	Ŝablono:Marko sur bildo malgranda
Neneuhcāyōtl:Brassicaceae	Kategorio:Brasikacoj
Nemachiyōtīlli:Tlatequitiltilīlli fr-3	Ŝablono:Vikipediisto fr-3
Neneuhcāyōtl:Caxtillān ītepēhuān	Kategorio:Montoj en Hispanio
Neneuhcāyōtl:Tunez	Kategorio:Tunizio
Nemachiyōtīlli:JPN	Ŝablono:JPN
Nemachiyōtīlli:PAN	Ŝablono:PAN
Nemachiyōtīlli:SOM	Ŝablono:SOM
Nemachiyōtīlli:VAT	Ŝablono:VAT
Nemachiyōtīlli:SWZ	Ŝablono:SWZ
Nemachiyōtīlli:Tlatequitiltilīlli nds-1	Ŝablono:Vikipediisto nds-1
Neneuhcāyōtl:Āltepētl īpan Xapon	Kategorio:Urboj de Japanio
Neneuhcāyōtl:Cactaceae	Kategorio:Kaktoj
Nemachiyōtīlli:ISL	Ŝablono:ISL
Nemachiyōtīlli:MUS	Ŝablono:MUS
Nemachiyōtīlli:COL	Ŝablono:COL
Nemachiyōtīlli:GNB	Ŝablono:GNB
Nemachiyōtīlli:ERI	Ŝablono:ERI
Nemachiyōtīlli:MRT	Ŝablono:MRT
Nemachiyōtīlli:GAB	Ŝablono:GAB
Nemachiyōtīlli:IRN	Ŝablono:IRN
Nemachiyōtīlli:MLI	Ŝablono:MLI
Nemachiyōtīlli:JOR	Ŝablono:JOR
Nemachiyōtīlli:NPL	Ŝablono:NPL
Nemachiyōtīlli:NAM	Ŝablono:NAM
Nemachiyōtīlli:MHL	Ŝablono:MHL
Nemachiyōtīlli:DOM	Ŝablono:DOM
Nemachiyōtīlli:CAF	Ŝablono:CAF
Nemachiyōtīlli:MKD	Ŝablono:MKD
Nemachiyōtīlli:GNQ	Ŝablono:GNQ
Nemachiyōtīlli:COM	Ŝablono:COM
Nemachiyōtīlli:ZMB	Ŝablono:ZMB
Nemachiyōtīlli:LKA	Ŝablono:LKA
Nemachiyōtīlli:VCT	Ŝablono:VCT
Nemachiyōtīlli:MWI	Ŝablono:MWI
Nemachiyōtīlli:TZA	Ŝablono:TZA
Nemachiyōtīlli:KAZ	Ŝablono:KAZ
Nemachiyōtīlli:OMN	Ŝablono:OMN
Nemachiyōtīlli:NER	Ŝablono:NER
Nemachiyōtīlli:COG	Ŝablono:COG
Nemachiyōtīlli:SMR	Ŝablono:SMR
Nemachiyōtīlli:PER	Ŝablono:PER
Nemachiyōtīlli:SUR	Ŝablono:SUR
Nemachiyōtīlli:TTO	Ŝablono:TTO
Nemachiyōtīlli:GUY	Ŝablono:GUY
Nemachiyōtīlli:ETH	Ŝablono:ETH
Nemachiyōtīlli:NGA	Ŝablono:NGA
Nemachiyōtīlli:PRK	Ŝablono:PRK
Nemachiyōtīlli:FSM	Ŝablono:FSM
Nemachiyōtīlli:KIR	Ŝablono:KIR
Nemachiyōtīlli:NIC	Ŝablono:NIC
Nemachiyōtīlli:KNA	Ŝablono:KNA
Nemachiyōtīlli:PNG	Ŝablono:PNG
Nemachiyōtīlli:LBR	Ŝablono:LBR
Nemachiyōtīlli:TKM	Ŝablono:TKM
Nemachiyōtīlli:NRU	Ŝablono:NRU
Nemachiyōtīlli:SLB	Ŝablono:SLB
Nemachiyōtīlli:GRL	Ŝablono:GRL
Nemachiyōtīlli:LBY	Ŝablono:LBY
Nemachiyōtīlli:LSO	Ŝablono:LES
Nemachiyōtīlli:THA	Ŝablono:THA
Nemachiyōtīlli:BFA	Ŝablono:BFA
Nemachiyōtīlli:TCD	Ŝablono:TCD
Nemachiyōtīlli:PRY	Ŝablono:PAR
Nemachiyōtīlli:ECU	Ŝablono:ECU
Nemachiyōtīlli:BTN	Ŝablono:BTN
Nemachiyōtīlli:MLV	Ŝablono:MDV
Nemachiyōtīlli:SYC	Ŝablono:SYC
Nemachiyōtīlli:TLS	Ŝablono:TLS
Nemachiyōtīlli:LCA	Ŝablono:LCA
Nemachiyōtīlli:SLE	Ŝablono:SLE
Nemachiyōtīlli:VUT	Ŝablono:VUT
Nemachiyōtīlli:Chicōntonalli	Ŝablono:Tagoj de la semajno
Neneuhcāyōtl:Necuiltōnolācalquīxōhuayān	Kategorio:Porto-Riko
Neneuhcāyōtl:Tlatequitiltilīlli ja-N	Kategorio:Vikipediisto ja-D
Neneuhcāyōtl:Tzitzimicītlalli	Kategorio:Saturno
Neneuhcāyōtl:Payīnalcītlalli	Kategorio:Merkuro
Neneuhcāyōtl:Āltepētl īpan Tlacetilīlli Tlahtohcāyōtl	Kategorio:Urboj de Usono
Neneuhcāyōtl:Inglatlālpan tlacuīcaliztli	Kategorio:Anglaj muzikaj grupoj
Neneuhcāyōtl:Ōtlācatqueh xiuhpan 1903	Kategorio:Naskiĝintoj en 1903
Neneuhcāyōtl:Ōtlācatqueh xiuhpan 1925	Kategorio:Naskiĝintoj en 1925
Neneuhcāyōtl:Ōtlācatqueh xiuhpan 1936	Kategorio:Naskiĝintoj en 1936
Neneuhcāyōtl:Ōtlācatqueh xiuhpan 1916	Kategorio:Naskiĝintoj en 1916
Neneuhcāyōtl:Ōtlācatqueh xiuhpan 1910	Kategorio:Naskiĝintoj en 1910
Neneuhcāyōtl:Ōtlācatqueh xiuhpan 1939	Kategorio:Naskiĝintoj en 1939
Nemachiyōtīlli:CHE	Ŝablono:CHE
Neneuhcāyōtl:Poaceae	Kategorio:Poacoj
Nemachiyōtīlli:Roman	Ŝablono:Romiaj ciferoj
Nemachiyōtīlli:Familytree/start	Ŝablono:Genealogia arbo/komenco
Tlaxcallān (āltepēcalpōlli)	Tlaxcala (komunumo)
Cuapiquiloni	Ĉapo
Nemachiyōtīlli:Tlahtōlmelāhuacātlāliztli	Ŝablono:Apartigilo
Neneuhcāyōtl:Suazitlālpan	Kategorio:Svazilando
Neneuhcāyōtl:Wikipedia:Fichas	Kategorio:Ŝablono:Informkesto
Neneuhcāyōtl:Ōmicqueh xiuhpan 2013	Kategorio:Mortintoj en 2013
Neneuhcāyōtl:1938 tlācatiliztli	Kategorio:Naskiĝintoj en 1938
Nemachiyōtīlli:ATG	Ŝablono:ATG
Nemachiyōtīlli:LAO	Ŝablono:LAO
Nemachiyōtīlli:ARE	Ŝablono:ARE
Nemachiyōtīlli:PRT	Ŝablono:PRT
Nemachiyōtīlli:BGD	Ŝablono:BGD
Nemachiyōtīlli:BAR	Ŝablono:BRB
Nemachiyōtīlli:ZWE	Ŝablono:ZWE
Nemachiyōtīlli:BLZ	Ŝablono:BLZ
Nemachiyōtīlli:AUS	Ŝablono:AUS
Nemachiyōtīlli:LVA	Ŝablono:LVA
Nemachiyōtīlli:AZE	Ŝablono:AZE
Nemachiyōtīlli:Lang-en	Ŝablono:Lang-en
Nemachiyōtīlli:DZA	Ŝablono:DZA
Neneuhcāyōtl:Teconxinachtli	Kategorio:Magnoliofitoj
Nemachiyōtīlli:KHM	Ŝablono:KHM
Nemachiyōtīlli:MNE	Ŝablono:MNE
Nemachiyōtīlli:NLD	Ŝablono:NLD
Nemachiyōtīlli:GBR	Ŝablono:GBR
Nemachiyōtīlli:KWT	Ŝablono:KUW
Nemachiyōtīlli:TUV	Ŝablono:TUV
Nemachiyōtīlli:VNM	Ŝablono:VNM
Nemachiyōtīlli:LIE	Ŝablono:LIE
Nemachiyōtīlli:MDA	Ŝablono:MDA
Neneuhcāyōtl:Āltepētl īpan Panama	Kategorio:Urboj de Panamo
Nemachiyōtīlli:SEN	Ŝablono:SEN
Nemachiyōtīlli:NZL	Ŝablono:NZL
Neneuhcāyōtl:Calmanaliztli	Kategorio:Arkitekturo
Nemachiyōtīlli:MMR	Ŝablono:MMR
Nemachiyōtīlli:KOR	Ŝablono:KOR
Neneuhcāyōtl:Aztēcah	Kategorio:Aztekoj
Nemachiyōtīlli:Tlatequitiltilīlli sv-2	Ŝablono:Vikipediisto sv-2
Neneuhcāyōtl:Tlatequitiltilīlli gsw-1	Kategorio:Vikipediisto gsw-1
Nemachiyōtīlli:Tlatequitiltilīlli it-2	Ŝablono:Vikipediisto it-2
Nemachiyōtīlli:Lang-fr	Ŝablono:Lang-fr
Nemachiyōtīlli:LBN	Ŝablono:LBN
Nemachiyōtīlli:FRA	Ŝablono:FRA
Nemachiyōtīlli:Tlācatl	Ŝablono:Informkesto homoj
Neneuhcāyōtl:Mongolia	Kategorio:Mongolio
Nemachiyōtīlli:Tlatequitiltilīlli Francitēcatl	Ŝablono:Uzanto Francio
Nemachiyōtīlli:Wikimedia CAT	Ŝablono:Wikimedia CAT
Neneuhcāyōtl:Āltepētl īpan Andorra	Kategorio:Urboj de Andoro
Neneuhcāyōtl:Ōtlācatqueh īpan mācuīlpōhualxihuitl XX	Kategorio:Naskiĝintoj en la 20-a jarcento
Neneuhcāyōtl:Ōtlācatqueh īpan mācuīlpōhualxihuitl XIX	Kategorio:Naskiĝintoj en la 19-a jarcento
Neneuhcāyōtl:Ōtlācatqueh īpan mācuīlpōhualxihuitl XXI	Kategorio:Naskiĝintoj en la 21-a jarcento
Neneuhcāyōtl:Ōtlācatqueh īpan mācuīlpōhualxihuitl XVIII	Kategorio:Naskiĝintoj en la 18-a jarcento
Neneuhcāyōtl:Ōtlācatqueh īpan mācuīlpōhualxihuitl XVII	Kategorio:Naskiĝintoj en la 17-a jarcento
Neneuhcāyōtl:Ōtlācatqueh īpan mācuīlpōhualxihuitl XVI	Kategorio:Naskiĝintoj en la 16-a jarcento
Neneuhcāyōtl:Ōtlācatqueh īpan mācuīlpōhualxihuitl XV	Kategorio:Naskiĝintoj en la 15-a jarcento
Nemachiyōtīlli:Tlatequitiltilīlli lb-1	Ŝablono:Vikipediisto lb-1
Neneuhcāyōtl:Āltepētl īpan Uruguay	Kategorio:Urboj de Urugvajo
Neneuhcāyōtl:Granada (tlācatiyān)	Kategorio:Grenado
Neneuhcāyōtl:Calabria	Kategorio:Kalabrio
Neneuhcāyōtl:Galicia	Kategorio:Galegio
Nemachiyōtīlli:Tlatequitiltilīlli fr-4	Ŝablono:Vikipediisto fr-4
Neneuhcāyōtl:Groentlālpan	Kategorio:Gronlando
Neneuhcāyōtl:Lamiales	Kategorio:Lamialoj
Emiliano Zapata (Tabasco īāltepēcalpōl)	Emiliano Zapata (Tabasco)
Neneuhcāyōtl:Tlācatlahtohcāyōtl Macedonia	Kategorio:Respubliko Makedonio
Neneuhcāyōtl:Tlatequitiltilīlli sco	Kategorio:Vikipediisto sco
Neneuhcāyōtl:Tlatequitiltilīlli sl	Kategorio:Vikipediisto sl
Neneuhcāyōtl:Tlatequitiltilīlli eo	Kategorio:Vikipediisto eo
Neneuhcāyōtl:Tlatequitiltilīlli et	Kategorio:Vikipediisto et
Neneuhcāyōtl:Tlatequitiltilīlli fr	Kategorio:Vikipediisto fr
Neneuhcāyōtl:Tlatequitiltilīlli gl	Kategorio:Vikipediisto gl
Neneuhcāyōtl:Tlatequitiltilīlli gn	Kategorio:Vikipediisto gn
Neneuhcāyōtl:Tlatequitiltilīlli ia	Kategorio:Vikipediisto ia
Neneuhcāyōtl:Tlatequitiltilīlli ja	Kategorio:Vikipediisto ja
Neneuhcāyōtl:Tlatequitiltilīlli la	Kategorio:Vikipediisto la
Neneuhcāyōtl:Tlatequitiltilīlli li	Kategorio:Vikipediisto li
Neneuhcāyōtl:Tlatequitiltilīlli lt	Kategorio:Vikipediisto lt
Neneuhcāyōtl:Tlatequitiltilīlli nn	Kategorio:Vikipediisto nn
Neneuhcāyōtl:Tlatequitiltilīlli pt	Kategorio:Vikipediisto pt
Neneuhcāyōtl:Tlatequitiltilīlli ro	Kategorio:Vikipediisto ro
Neneuhcāyōtl:Tlatequitiltilīlli sv	Kategorio:Vikipediisto sv
Neneuhcāyōtl:Tlatequitiltilīlli sl-3	Kategorio:Vikipediisto sl-3
Neneuhcāyōtl:Tlatequitiltilīlli fr-3	Kategorio:Vikipediisto fr-3
Neneuhcāyōtl:Tlatequitiltilīlli it-3	Kategorio:Vikipediisto it-3
Neneuhcāyōtl:Tlatequitiltilīlli ja-3	Kategorio:Vikipediisto ja-3
Neneuhcāyōtl:Tlatequitiltilīlli tr-3	Kategorio:Vikipediisto tr-3
Neneuhcāyōtl:Tlatequitiltilīlli ar-3	Kategorio:Vikipediisto ar-3
Neneuhcāyōtl:Tlatequitiltilīlli an-1	Kategorio:Vikipediisto an-1
Neneuhcāyōtl:Tlatequitiltilīlli da-1	Kategorio:Vikipediisto da-1
Neneuhcāyōtl:Tlatequitiltilīlli sco-1	Kategorio:Vikipediisto sco-1
Neneuhcāyōtl:Tlatequitiltilīlli et-1	Kategorio:Vikipediisto et-1
Neneuhcāyōtl:Tlatequitiltilīlli fi-1	Kategorio:Vikipediisto fi-1
Neneuhcāyōtl:Tlatequitiltilīlli nl-1	Kategorio:Vikipediisto nl-1
Neneuhcāyōtl:Tlatequitiltilīlli tr-1	Kategorio:Vikipediisto tr-1
Neneuhcāyōtl:Tlatequitiltilīlli ar-1	Kategorio:Vikipediisto ar-1
Neneuhcāyōtl:Tlatequitiltilīlli fr-4	Kategorio:Vikipediisto fr-4
Neneuhcāyōtl:Tlatequitiltilīlli it-4	Kategorio:Vikipediisto it-4
Neneuhcāyōtl:Tlatequitiltilīlli da-2	Kategorio:Vikipediisto da-2
Neneuhcāyōtl:Tlatequitiltilīlli fr-2	Kategorio:Vikipediisto fr-2
Neneuhcāyōtl:Tlatequitiltilīlli gn-2	Kategorio:Vikipediisto gn-2
Neneuhcāyōtl:Tlatequitiltilīlli ia-2	Kategorio:Vikipediisto ia-2
Neneuhcāyōtl:Tlatequitiltilīlli it-2	Kategorio:Vikipediisto it-2
Neneuhcāyōtl:Tlatequitiltilīlli ja-2	Kategorio:Vikipediisto ja-2
Neneuhcāyōtl:Tlatequitiltilīlli la-2	Kategorio:Vikipediisto la-2
Neneuhcāyōtl:Tlatequitiltilīlli pl-2	Kategorio:Vikipediisto pl-2
Neneuhcāyōtl:Tlatequitiltilīlli sv-2	Kategorio:Vikipediisto sv-2
Neneuhcāyōtl:Tlatequitiltilīlli ar-2	Kategorio:Vikipediisto ar-2
Neneuhcāyōtl:Tlatequitiltilīlli ast-N	Kategorio:Vikipediisto ast-D
Neneuhcāyōtl:Tlatequitiltilīlli sl-N	Kategorio:Vikipediisto sl-D
Neneuhcāyōtl:Tlatequitiltilīlli fr-N	Kategorio:Vikipediisto fr-D
Neneuhcāyōtl:Tlatequitiltilīlli it-N	Kategorio:Vikipediisto it-D
Neneuhcāyōtl:Tlatequitiltilīlli lt-N	Kategorio:Vikipediisto lt-D
Neneuhcāyōtl:Tlatequitiltilīlli nl-N	Kategorio:Vikipediisto nl-D
Neneuhcāyōtl:Tlatequitiltilīlli no-N	Kategorio:Vikipediisto no-D
Neneuhcāyōtl:Tlatequitiltilīlli ru-N	Kategorio:Vikipediisto ru-D
Neneuhcāyōtl:Tlatequitiltilīlli ar-N	Kategorio:Vikipediisto ar-D
Neneuhcāyōtl:Tlatequitiltilīlli eu-N	Kategorio:Vikipediisto eu-D
Neneuhcāyōtl:Tlatequitiltilīlli af	Kategorio:Vikipediisto af
Neneuhcāyōtl:Tlatequitiltilīlli af-1	Kategorio:Vikipediisto af-1
Neneuhcāyōtl:Tlatequitiltilīlli an	Kategorio:Vikipediisto an
Neneuhcāyōtl:Tlatequitiltilīlli an-4	Kategorio:Vikipediisto an-4
Neneuhcāyōtl:Tlatequitiltilīlli ar	Kategorio:Vikipediisto ar
Neneuhcāyōtl:Tlatequitiltilīlli ast	Kategorio:Vikipediisto ast
Neneuhcāyōtl:Tlatequitiltilīlli ast-1	Kategorio:Vikipediisto ast-1
Neneuhcāyōtl:Tlatequitiltilīlli bar	Kategorio:Vikipediisto bar
Neneuhcāyōtl:Tlatequitiltilīlli ca	Kategorio:Vikipediisto ca
Neneuhcāyōtl:Tlatequitiltilīlli ca-1	Kategorio:Vikipediisto ca-1
Neneuhcāyōtl:Tlatequitiltilīlli ca-2	Kategorio:Vikipediisto ca-2
Neneuhcāyōtl:Tlatequitiltilīlli ca-3	Kategorio:Vikipediisto ca-3
Neneuhcāyōtl:Tlatequitiltilīlli ca-4	Kategorio:Vikipediisto ca-4
Neneuhcāyōtl:Tlatequitiltilīlli ca-N	Kategorio:Vikipediisto ca-D
Neneuhcāyōtl:Tlatequitiltilīlli cs	Kategorio:Vikipediisto cs
Neneuhcāyōtl:Tlatequitiltilīlli da	Kategorio:Vikipediisto da
Neneuhcāyōtl:Tlatequitiltilīlli da-3	Kategorio:Vikipediisto da-3
Neneuhcāyōtl:Tlatequitiltilīlli de	Kategorio:Vikipediisto de
Neneuhcāyōtl:Tlatequitiltilīlli de-2	Kategorio:Vikipediisto de-2
Neneuhcāyōtl:Tlatequitiltilīlli de-3	Kategorio:Vikipediisto de-3
Neneuhcāyōtl:Tlatequitiltilīlli de-4	Kategorio:Vikipediisto de-4
Neneuhcāyōtl:Tlatequitiltilīlli de-N	Kategorio:Vikipediisto de-D
Neneuhcāyōtl:Tlatequitiltilīlli el	Kategorio:Vikipediisto el
Neneuhcāyōtl:Tlatequitiltilīlli el-1	Kategorio:Vikipediisto el-1
Neneuhcāyōtl:Tlatequitiltilīlli el-2	Kategorio:Vikipediisto el-2
Neneuhcāyōtl:Tlatequitiltilīlli el-3	Kategorio:Vikipediisto el-3
Neneuhcāyōtl:Tlatequitiltilīlli el-N	Kategorio:Vikipediisto el-D
Neneuhcāyōtl:Tlatequitiltilīlli en-0	Kategorio:Vikipediisto en-0
Neneuhcāyōtl:Tlatequitiltilīlli en-3	Kategorio:Vikipediisto en-3
Neneuhcāyōtl:Tlatequitiltilīlli en-N	Kategorio:Vikipediisto en-D
Neneuhcāyōtl:Tlatequitiltilīlli eo-1	Kategorio:Vikipediisto eo-1
Neneuhcāyōtl:Tlatequitiltilīlli eo-2	Kategorio:Vikipediisto eo-2
Neneuhcāyōtl:Tlatequitiltilīlli eo-3	Kategorio:Vikipediisto eo-3
Neneuhcāyōtl:Tlatequitiltilīlli eo-4	Kategorio:Vikipediisto eo-4
Neneuhcāyōtl:Tlatequitiltilīlli eo-N	Kategorio:Vikipediisto eo-D
Neneuhcāyōtl:Tlatequitiltilīlli es	Kategorio:Vikipediisto es
Neneuhcāyōtl:Tlatequitiltilīlli es-1	Kategorio:Vikipediisto es-1
Neneuhcāyōtl:Tlatequitiltilīlli es-2	Kategorio:Vikipediisto es-2
Neneuhcāyōtl:Tlatequitiltilīlli es-3	Kategorio:Vikipediisto es-3
Neneuhcāyōtl:Tlatequitiltilīlli es-4	Kategorio:Vikipediisto es-4
Neneuhcāyōtl:Tlatequitiltilīlli es-N	Kategorio:Vikipediisto es-D
Neneuhcāyōtl:Santo Tomé īhuān Tlahtohcāpilli	Kategorio:Sao-Tomeo kaj Principeo
Neneuhcāyōtl:Tlatequitiltilīlli eu	Kategorio:Vikipediisto eu
Neneuhcāyōtl:Tlatequitiltilīlli eu-1	Kategorio:Vikipediisto eu-1
Neneuhcāyōtl:Tlatequitiltilīlli fi	Kategorio:Vikipediisto fi
Neneuhcāyōtl:Tlatequitiltilīlli fi-2	Kategorio:Vikipediisto fi-2
Neneuhcāyōtl:Tlatequitiltilīlli fi-3	Kategorio:Vikipediisto fi-3
Neneuhcāyōtl:Tlatequitiltilīlli fi-4	Kategorio:Vikipediisto fi-4
Neneuhcāyōtl:Tlatequitiltilīlli fi-N	Kategorio:Vikipediisto fi-D
Neneuhcāyōtl:Tlatequitiltilīlli gsw	Kategorio:Vikipediisto gsw
Neneuhcāyōtl:Tlatequitiltilīlli io	Kategorio:Vikipediisto io
Neneuhcāyōtl:Tlatequitiltilīlli is	Kategorio:Vikipediisto is
Neneuhcāyōtl:Tlatequitiltilīlli is-1	Kategorio:Vikipediisto is-1
Neneuhcāyōtl:Chiyapan īāltepēcalpōllōhuān	Kategorio:Komunumoj de Chiapas
Neneuhcāyōtl:Tlahtohcāyōtl Mēxihco	Kategorio:Estado de México
Iglesia Anglicana	Anglikanismo
Nemachiyōtīlli:Tlatequitiltilīlli swg-1	Ŝablono:Vikipediisto swg-1
Neneuhcāyōtl:Tlatequitiltilīlli pt-3	Kategorio:Vikipediisto pt-3
Neneuhcāyōtl:Tlatequitiltilīlli pt-1	Kategorio:Vikipediisto pt-1
Neneuhcāyōtl:Huehuehmēxihcayōtl	Kategorio:Aztekaj dioj
Neneuhcāyōtl:Asterales	Kategorio:Asteraloj
Neneuhcāyōtl:Āltepētl īpan Argelia	Kategorio:Urboj de Alĝerio
Neneuhcāyōtl:Āltepētl īpan Israel	Kategorio:Urboj de Israelo
Nemachiyōtīlli:Tētlamahmacani	Ŝablono:Uzanto Vikiadministranto
Neneuhcāyōtl:Tlatequitiltilīlli it	Kategorio:Vikipediisto it
Neneuhcāyōtl:Tlatequitiltilīlli it-1	Kategorio:Vikipediisto it-1
Neneuhcāyōtl:Tlatequitiltilīlli ja-1	Kategorio:Vikipediisto ja-1
Neneuhcāyōtl:Malvaceae	Kategorio:Malvacoj
Neneuhcāyōtl:Tlatequitiltilīlli ko	Kategorio:Vikipediisto ko
Neneuhcāyōtl:Tlatequitiltilīlli ko-3	Kategorio:Vikipediisto ko-3
Neneuhcāyōtl:Tlatequitiltilīlli ksh	Kategorio:Vikipediisto ksh
Neneuhcāyōtl:Tlatequitiltilīlli ksh-N	Kategorio:Vikipediisto ksh-D
Neneuhcāyōtl:Tlatequitiltilīlli la-1	Kategorio:Vikipediisto la-1
Nemachiyōtīlli:Tomīn	Ŝablono:Informkesto valuto
Neneuhcāyōtl:Ōmicqueh xiuhpan 1585	Kategorio:Mortintoj en 1585
Neneuhcāyōtl:Ōmicqueh xiuhpan 1521	Kategorio:Mortintoj en 1521
Neneuhcāyōtl:Ōmicqueh xiuhpan 1536	Kategorio:Mortintoj en 1536
Neneuhcāyōtl:Āltepētl īpan Grecia	Kategorio:Urboj de Grekio
Neneuhcāyōtl:Fabales	Kategorio:Fabaloj
Nemachiyōtīlli:BRA	Ŝablono:BRA
Neneuhcāyōtl:Catolicismo Romano	Kategorio:Romkatolika Eklezio
Neneuhcāyōtl:Tlamahtlāccēti	Kategorio:Novembro
Neneuhcāyōtl:Iglesia Anglicana	Kategorio:Anglikanismo
Neneuhcāyōtl:Ōmicqueh xiuhpan 1793	Kategorio:Mortintoj en 1793
Neneuhcāyōtl:Ōmicqueh xiuhpan 1931	Kategorio:Mortintoj en 1931
Neneuhcāyōtl:Ōmicqueh xiuhpan 1827	Kategorio:Mortintoj en 1827
Neneuhcāyōtl:Tlatequitiltilīlli ru-1	Kategorio:Vikipediisto ru-1
Huiquipedia:Babel	Vikipedio:Babelejo
Nemachiyōtīlli:Tlatequitiltilīlli sv-1	Ŝablono:Vikipediisto sv-1
Neneuhcāyōtl:Caryophyllaceae	Kategorio:Kariofilacoj
Neneuhcāyōtl:Tlayēti	Kategorio:Marto
Neneuhcāyōtl:Tlachiucnāuhti	Kategorio:Septembro
Nemachiyōtīlli:TUN	Ŝablono:TUN
Neneuhcāyōtl:Tlamahtlācti	Kategorio:Oktobro
Neneuhcāyōtl:Āltepētl īpan Cōzcatlān	Kategorio:Urboj de Salvadoro
Neneuhcāyōtl:Ōtlācatqueh xiuhpan 1906	Kategorio:Naskiĝintoj en 1906
Neneuhcāyōtl:Āltepētl īpan Polonia	Kategorio:Urboj de Pollando
Neneuhcāyōtl:Tlamahtlācōnti	Kategorio:Decembro
Neneuhcāyōtl:Tlachicuēiti	Kategorio:Aŭgusto
Neneuhcāyōtl:Tlamācuīlti	Kategorio:Majo
Nemachiyōtīlli:Tlatequitiltilīlli Mēxihco	Ŝablono:Uzanto Meksiko
Neneuhcāyōtl:Fabaceae	Kategorio:Fabacoj
Neneuhcāyōtl:Mirconesia	Kategorio:Federacio de Mikronezio
Neneuhcāyōtl:Solanales	Kategorio:Solanaloj
Neneuhcāyōtl:Solanaceae	Kategorio:Solanacoj
Neneuhcāyōtl:Inglatlālpan	Kategorio:Anglio
Neneuhcāyōtl:Machiyōtlahcuilōlli	Kategorio:Tipografio
Neneuhcāyōtl:Tlanāuhti	Kategorio:Aprilo
Neneuhcāyōtl:Saxifragales	Kategorio:Saksifragaloj
Neneuhcāyōtl:Ōmicqueh xiuhpan 2009	Kategorio:Mortintoj en 2009
Neneuhcāyōtl:Rutaceae	Kategorio:Rutacoj
Neneuhcāyōtl:Tlatequitiltilīlli nds	Kategorio:Vikipediisto nds
Neneuhcāyōtl:Tlatequitiltilīlli nds-1	Kategorio:Vikipediisto nds-1
Nemachiyōtīlli:LUX	Ŝablono:LUX
Neneuhcāyōtl:Tlatequitiltilīlli nds-NL	Kategorio:Vikipediisto nds-NL
Neneuhcāyōtl:Tōnatiuh īchān	Kategorio:Sunsistemo
Neneuhcāyōtl:Dominicanatlācatlahtohcāyōtl	Kategorio:Domingo
Neneuhcāyōtl:Lythraceae	Kategorio:Litrumacoj
Neneuhcāyōtl:Sapindales	Kategorio:Sapindaloj
Neneuhcāyōtl:Ebenaceae	Kategorio:Ebonacoj
Neneuhcāyōtl:Ōmicqueh xiuhpan 1321	Kategorio:Mortintoj en 1321
Neneuhcāyōtl:Arecaceae	Kategorio:Arekacoj
Neneuhcāyōtl:Ōtlācatqueh xiuhpan 1983	Kategorio:Naskiĝintoj en 1983
Nemachiyōtīlli:TON	Ŝablono:TON
Neneuhcāyōtl:Ōmicqueh xiuhpan 1992	Kategorio:Mortintoj en 1992
Neneuhcāyōtl:Ōtlācatqueh xiuhpan 1992	Kategorio:Naskiĝintoj en 1992
Neneuhcāyōtl:Ōmicqueh xiuhpan 1980	Kategorio:Mortintoj en 1980
Neneuhcāyōtl:Ōmicqueh xiuhpan 2008	Kategorio:Mortintoj en 2008
Neneuhcāyōtl:Ōmicqueh xiuhpan 1986	Kategorio:Mortintoj en 1986
Neneuhcāyōtl:Ōmicqueh xiuhpan 1966	Kategorio:Mortintoj en 1966
Neneuhcāyōtl:Ōtlācatqueh xiuhpan 1984	Kategorio:Naskiĝintoj en 1984
Neneuhcāyōtl:Ōmicqueh xiuhpan 1959	Kategorio:Mortintoj en 1959
Neneuhcāyōtl:Ōtlācatqueh xiuhpan 1990	Kategorio:Naskiĝintoj en 1990
Neneuhcāyōtl:Ōmicqueh xiuhpan 1949	Kategorio:Mortintoj en 1949
Neneuhcāyōtl:Ōtlācatqueh xiuhpan 1974	Kategorio:Naskiĝintoj en 1974
Neneuhcāyōtl:Ōmicqueh xiuhpan 1947	Kategorio:Mortintoj en 1947
Neneuhcāyōtl:Ōmicqueh xiuhpan 2007	Kategorio:Mortintoj en 2007
Neneuhcāyōtl:1965 tlācatiliztli	Kategorio:Naskiĝintoj en 1965
Neneuhcāyōtl:1940 tlācatiliztli	Kategorio:Naskiĝintoj en 1940
Neneuhcāyōtl:Ōtlācatqueh xiuhpan 1898	Kategorio:Naskiĝintoj en 1898
Neneuhcāyōtl:Ōtlācatqueh xiuhpan 1863	Kategorio:Naskiĝintoj en 1863
Neneuhcāyōtl:Ōtlācatqueh xiuhpan 1867	Kategorio:Naskiĝintoj en 1867
Neneuhcāyōtl:Ōtlācatqueh xiuhpan 1871	Kategorio:Naskiĝintoj en 1871
Neneuhcāyōtl:Ōtlācatqueh xiuhpan 1977	Kategorio:Naskiĝintoj en 1977
Neneuhcāyōtl:1899 tlācatiliztli	Kategorio:Naskiĝintoj en 1899
Neneuhcāyōtl:1931 tlācatiliztli	Kategorio:Naskiĝintoj en 1931
Neneuhcāyōtl:1915 tlācatiliztli	Kategorio:Naskiĝintoj en 1915
Neneuhcāyōtl:1929 tlācatiliztli	Kategorio:Naskiĝintoj en 1929
Neneuhcāyōtl:Orchidaceae	Kategorio:Orkidacoj
Neneuhcāyōtl:Iridaceae	Kategorio:Iridacoj
Neneuhcāyōtl:Magnoliaceae	Kategorio:Magnoliacoj
Neneuhcāyōtl:Magnoliales	Kategorio:Magnolialoj
Neneuhcāyōtl:Asteraceae	Kategorio:Asteracoj
Neneuhcāyōtl:Anacardiaceae	Kategorio:Anakardiacoj
Neneuhcāyōtl:Asparagales	Kategorio:Asparagaloj
Neneuhcāyōtl:Lauraceae	Kategorio:Laŭracoj
Neneuhcāyōtl:Laurales	Kategorio:Laŭraloj
Neneuhcāyōtl:Salicaceae	Kategorio:Salikacoj
Neneuhcāyōtl:Quintana Roo īāltepēcalpōlhuān	Kategorio:Komunumoj de Quintana Roo
Neneuhcāyōtl:1954 tlācatiliztli	Kategorio:Naskiĝintoj en 1954
Neneuhcāyōtl:1980s tlacuīcaliztli	Kategorio:Naskiĝintoj en 1980-1989
Neneuhcāyōtl:Belarus	Kategorio:Belorusio
Neneuhcāyōtl:1960 tlācatiliztli	Kategorio:Naskiĝintoj en 1960
Neneuhcāyōtl:Altepetl ipan Mexico	Kategorio:Meksikurbo
Nemachiyōtīlli:MCO	Ŝablono:MCO
Neneuhcāyōtl:Ōmicqueh xiuhpan 1993	Kategorio:Mortintoj en 1993
Neneuhcāyōtl:Ōmicqueh xiuhpan 1998	Kategorio:Mortintoj en 1998
Neneuhcāyōtl:Āltepētl īpan São Paulo	Kategorio:Municipoj de San-Paŭlo
Neneuhcāyōtl:1951 tlācatiliztli	Kategorio:Naskiĝintoj en 1951
Neneuhcāyōtl:Ōmicqueh xiuhpan 1883	Kategorio:Mortintoj en 1883
Neneuhcāyōtl:Ōtlācatqueh xiuhpan 1265	Kategorio:Naskiĝintoj en 1265
Neucpahtli	Siropo
Neneuhcāyōtl:Ōtlācatqueh xiuhpan 1397	Kategorio:Naskiĝintoj en 1397
Neneuhcāyōtl:Ōtlācatqueh xiuhpan 1398	Kategorio:Naskiĝintoj en 1398
Nemachiyōtīlli:Tlatequitiltilīlli ru-2	Ŝablono:Vikipediisto ru-2
Neneuhcāyōtl:Chīchīlcītlalli	Kategorio:Marso
Neneuhcāyōtl:Catōlicoquīxtianayōtl	Kategorio:Katolikismo
Nemachiyōtīlli:Tlatequitiltilīlli eu-1	Ŝablono:Vikipediisto eu-1
Nemachiyōtīlli:Caxitl ayāc	Ŝablono:Sukcedo postenulo
Neneuhcāyōtl:Ōmicqueh xiuhpan 1440	Kategorio:Mortintoj en 1440
Neneuhcāyōtl:Ōmicqueh xiuhpan 1469	Kategorio:Mortintoj en 1469
Neneuhcāyōtl:Ōtlācatqueh xiuhpan 1474	Kategorio:Naskiĝintoj en 1474
Neneuhcāyōtl:Ōtlācatqueh xiuhpan 1479	Kategorio:Naskiĝintoj en 1479
Neneuhcāyōtl:Tlatequitiltilīlli pt-2	Kategorio:Vikipediisto pt-2
Neneuhcāyōtl:Tlatequitiltilīlli pt-4	Kategorio:Vikipediisto pt-4
Neneuhcāyōtl:Tlatequitiltilīlli pt-N	Kategorio:Vikipediisto pt-D
Neneuhcāyōtl:Ōmicqueh xiuhpan 1486	Kategorio:Mortintoj en 1486
Neneuhcāyōtl:Tlatequitiltilīlli ro-N	Kategorio:Vikipediisto ro-D
Neneuhcāyōtl:Tlatequitiltilīlli ru	Kategorio:Vikipediisto ru
Neneuhcāyōtl:Tlatequitiltilīlli ru-2	Kategorio:Vikipediisto ru-2
Neneuhcāyōtl:Tlatequitiltilīlli ru-3	Kategorio:Vikipediisto ru-3
Neneuhcāyōtl:Ōmicqueh xiuhpan 1502	Kategorio:Mortintoj en 1502
Neneuhcāyōtl:Ōmicqueh xiuhpan 1520	Kategorio:Mortintoj en 1520
Neneuhcāyōtl:Ōmicqueh xiuhpan 1526	Kategorio:Mortintoj en 1526
Neneuhcāyōtl:Ōmicqueh xiuhpan 1529	Kategorio:Mortintoj en 1529
Neneuhcāyōtl:Ōtlācatqueh xiuhpan 1532	Kategorio:Naskiĝintoj en 1532
Neneuhcāyōtl:Tlatequitiltilīlli sv-1	Kategorio:Vikipediisto sv-1
Neneuhcāyōtl:Tlatequitiltilīlli sv-3	Kategorio:Vikipediisto sv-3
Neneuhcāyōtl:Tlatequitiltilīlli sv-N	Kategorio:Vikipediisto sv-D
Neneuhcāyōtl:Ōmicqueh xiuhpan 1548	Kategorio:Mortintoj en 1548
Neneuhcāyōtl:Ōmicqueh xiuhpan 1554	Kategorio:Mortintoj en 1554
Neneuhcāyōtl:Ōmicqueh xiuhpan 1562	Kategorio:Mortintoj en 1562
Neneuhcāyōtl:Ōmicqueh xiuhpan 1565	Kategorio:Mortintoj en 1565
Neneuhcāyōtl:Ōtlācatqueh xiuhpan 1566	Kategorio:Naskiĝintoj en 1566
Neneuhcāyōtl:Ōmicqueh xiuhpan 1571	Kategorio:Mortintoj en 1571
Neneuhcāyōtl:Ōtlācatqueh xiuhpan 1572	Kategorio:Naskiĝintoj en 1572
Neneuhcāyōtl:Tlatequitiltilīlli tr	Kategorio:Vikipediisto tr
Neneuhcāyōtl:Tlatequitiltilīlli tr-N	Kategorio:Vikipediisto tr-D
Neneuhcāyōtl:Ōmicqueh xiuhpan 1639	Kategorio:Mortintoj en 1639
Neneuhcāyōtl:Tlatequitiltilīlli wa	Kategorio:Vikipediisto wa
Neneuhcāyōtl:Tlatequitiltilīlli wa-N	Kategorio:Vikipediisto wa-D
Nemachiyōtīlli:En	Ŝablono:En
Neneuhcāyōtl:Ōtlācatqueh xiuhpan 1713	Kategorio:Naskiĝintoj en 1713
Neneuhcāyōtl:Cuīcatiani	Kategorio:Muzikistoj
Nemachiyōtīlli:Lang	Ŝablono:Lang
Neneuhcāyōtl:Ōmicqueh xiuhpan 1969	Kategorio:Mortintoj en 1969
Neneuhcāyōtl:Ōtlācatqueh xiuhpan 1881	Kategorio:Naskiĝintoj en 1881
Neneuhcāyōtl:Āltepētl īpan Eritrea	Kategorio:Urboj de Eritreo
Neneuhcāyōtl:Āltepētl īpan Francia	Kategorio:Komunumoj de Francio
Neneuhcāyōtl:1944 tlācatiliztli	Kategorio:Naskiĝintoj en 1944
Neneuhcāyōtl:1932 tlācatiliztli	Kategorio:Naskiĝintoj en 1932
Neneuhcāyōtl:1934 tlācatiliztli	Kategorio:Naskiĝintoj en 1934
Neneuhcāyōtl:1935 tlācatiliztli	Kategorio:Naskiĝintoj en 1935
Neneuhcāyōtl:1941 tlācatiliztli	Kategorio:Naskiĝintoj en 1941
Neneuhcāyōtl:Ōtlācatqueh īpan mācuīlpōhualxihuitl XIII	Kategorio:Naskiĝintoj en la 13-a jarcento
Neneuhcāyōtl:Ōtlācatqueh īpan mācuīlpōhualxihuitl XIV	Kategorio:Naskiĝintoj en la 14-a jarcento
Nemachiyōtīlli:IRL	Ŝablono:IRL
Neneuhcāyōtl:Ōtlācatqueh xiuhpan 1667	Kategorio:Naskiĝintoj en 1667
Neneuhcāyōtl:Ōtlācatqueh xiuhpan 1729	Kategorio:Naskiĝintoj en 1729
Neneuhcāyōtl:Ōtlācatqueh xiuhpan 1730	Kategorio:Naskiĝintoj en 1730
Neneuhcāyōtl:Ōtlācatqueh xiuhpan 1731	Kategorio:Naskiĝintoj en 1731
Neneuhcāyōtl:1732 tlācatiliztli	Kategorio:Naskiĝintoj en 1732
Neneuhcāyōtl:Ōtlācatqueh xiuhpan 1756	Kategorio:Naskiĝintoj en 1756
Neneuhcāyōtl:Ōtlācatqueh xiuhpan 1768	Kategorio:Naskiĝintoj en 1768
Neneuhcāyōtl:Ōtlācatqueh xiuhpan 1776	Kategorio:Naskiĝintoj en 1776
Neneuhcāyōtl:Ōtlācatqueh xiuhpan 1792	Kategorio:Naskiĝintoj en 1792
Neneuhcāyōtl:Ōtlācatqueh xiuhpan 1806	Kategorio:Naskiĝintoj en 1806
Neneuhcāyōtl:Ōtlācatqueh xiuhpan 1818	Kategorio:Naskiĝintoj en 1818
Neneuhcāyōtl:Ōtlācatqueh xiuhpan 1820	Kategorio:Naskiĝintoj en 1820
Neneuhcāyōtl:Ōtlācatqueh xiuhpan 1828	Kategorio:Naskiĝintoj en 1828
Neneuhcāyōtl:Ōtlācatqueh xiuhpan 1830	Kategorio:Naskiĝintoj en 1830
Neneuhcāyōtl:Ōtlācatqueh xiuhpan 1835	Kategorio:Naskiĝintoj en 1835
Neneuhcāyōtl:Ōtlācatqueh xiuhpan 1845	Kategorio:Naskiĝintoj en 1845
Neneuhcāyōtl:Ōtlācatqueh xiuhpan 1848	Kategorio:Naskiĝintoj en 1848
Neneuhcāyōtl:Ōtlācatqueh xiuhpan 1852	Kategorio:Naskiĝintoj en 1852
Neneuhcāyōtl:Ōtlācatqueh xiuhpan 1859	Kategorio:Naskiĝintoj en 1859
Neneuhcāyōtl:Ōtlācatqueh xiuhpan 1872	Kategorio:Naskiĝintoj en 1872
Neneuhcāyōtl:Ōtlācatqueh xiuhpan 1873	Kategorio:Naskiĝintoj en 1873
Neneuhcāyōtl:Ōtlācatqueh xiuhpan 1874	Kategorio:Naskiĝintoj en 1874
Neneuhcāyōtl:Ōtlācatqueh xiuhpan 1876	Kategorio:Naskiĝintoj en 1876
Neneuhcāyōtl:Ōtlācatqueh xiuhpan 1877	Kategorio:Naskiĝintoj en 1877
Neneuhcāyōtl:Ōtlācatqueh xiuhpan 1880	Kategorio:Naskiĝintoj en 1880
Neneuhcāyōtl:Ōtlācatqueh xiuhpan 1882	Kategorio:Naskiĝintoj en 1882
Neneuhcāyōtl:Ōtlācatqueh xiuhpan 1883	Kategorio:Naskiĝintoj en 1883
Neneuhcāyōtl:Ōtlācatqueh xiuhpan 1886	Kategorio:Naskiĝintoj en 1886
Neneuhcāyōtl:Ōtlācatqueh xiuhpan 1890	Kategorio:Naskiĝintoj en 1890
Neneuhcāyōtl:Ōtlācatqueh xiuhpan 1891	Kategorio:Naskiĝintoj en 1891
Neneuhcāyōtl:Ōtlācatqueh xiuhpan 1892	Kategorio:Naskiĝintoj en 1892
Neneuhcāyōtl:Ōtlācatqueh xiuhpan 1893	Kategorio:Naskiĝintoj en 1893
Neneuhcāyōtl:Ōtlācatqueh xiuhpan 1894	Kategorio:Naskiĝintoj en 1894
Neneuhcāyōtl:Ōtlācatqueh xiuhpan 1895	Kategorio:Naskiĝintoj en 1895
Neneuhcāyōtl:Ōtlācatqueh xiuhpan 1896	Kategorio:Naskiĝintoj en 1896
Neneuhcāyōtl:Ōtlācatqueh xiuhpan 1897	Kategorio:Naskiĝintoj en 1897
Neneuhcāyōtl:Ōtlācatqueh xiuhpan 1900	Kategorio:Naskiĝintoj en 1900
Neneuhcāyōtl:Ōtlācatqueh xiuhpan 1901	Kategorio:Naskiĝintoj en 1901
Neneuhcāyōtl:Ōtlācatqueh xiuhpan 1902	Kategorio:Naskiĝintoj en 1902
Neneuhcāyōtl:Ōtlācatqueh xiuhpan 1904	Kategorio:Naskiĝintoj en 1904
Neneuhcāyōtl:Ōtlācatqueh xiuhpan 1905	Kategorio:Naskiĝintoj en 1905
Neneuhcāyōtl:Ōtlācatqueh xiuhpan 1907	Kategorio:Naskiĝintoj en 1907
Neneuhcāyōtl:Ōtlācatqueh xiuhpan 1908	Kategorio:Naskiĝintoj en 1908
Neneuhcāyōtl:1909 tlācatiliztli	Kategorio:Naskiĝintoj en 1909
Neneuhcāyōtl:1912 tlācatiliztli	Kategorio:Naskiĝintoj en 1912
Neneuhcāyōtl:1913 tlācatiliztli	Kategorio:Naskiĝintoj en 1913
Neneuhcāyōtl:1914 tlācatiliztli	Kategorio:Naskiĝintoj en 1914
Neneuhcāyōtl:1917 tlācatiliztli	Kategorio:Naskiĝintoj en 1917
Neneuhcāyōtl:1918 tlācatiliztli	Kategorio:Naskiĝintoj en 1918
Neneuhcāyōtl:1919 tlācatiliztli	Kategorio:Naskiĝintoj en 1919
Neneuhcāyōtl:1922 tlācatiliztli	Kategorio:Naskiĝintoj en 1922
Neneuhcāyōtl:1923 tlācatiliztli	Kategorio:Naskiĝintoj en 1923
Neneuhcāyōtl:1927 tlācatiliztli	Kategorio:Naskiĝintoj en 1927
Neneuhcāyōtl:1928 tlācatiliztli	Kategorio:Naskiĝintoj en 1928
Neneuhcāyōtl:1942 tlācatiliztli	Kategorio:Naskiĝintoj en 1942
Neneuhcāyōtl:1943 tlācatiliztli	Kategorio:Naskiĝintoj en 1943
Neneuhcāyōtl:1945 tlācatiliztli	Kategorio:Naskiĝintoj en 1945
Neneuhcāyōtl:1947 tlācatiliztli	Kategorio:Naskiĝintoj en 1947
Neneuhcāyōtl:1949 tlācatiliztli	Kategorio:Naskiĝintoj en 1949
Neneuhcāyōtl:1952 tlācatiliztli	Kategorio:Naskiĝintoj en 1952
Neneuhcāyōtl:1953 tlācatiliztli	Kategorio:Naskiĝintoj en 1953
Neneuhcāyōtl:1957 tlācatiliztli	Kategorio:Naskiĝintoj en 1957
Neneuhcāyōtl:1958 tlācatiliztli	Kategorio:Naskiĝintoj en 1958
Neneuhcāyōtl:1959 tlācatiliztli	Kategorio:Naskiĝintoj en 1959
Neneuhcāyōtl:1961 tlācatiliztli	Kategorio:Naskiĝintoj en 1961
Neneuhcāyōtl:1962 tlācatiliztli	Kategorio:Naskiĝintoj en 1962
Neneuhcāyōtl:1966 tlācatiliztli	Kategorio:Naskiĝintoj en 1966
Neneuhcāyōtl:1967 tlācatiliztli	Kategorio:Naskiĝintoj en 1967
Neneuhcāyōtl:1968 tlācatiliztli	Kategorio:Naskiĝintoj en 1968
Neneuhcāyōtl:1969 tlācatiliztli	Kategorio:Naskiĝintoj en 1969
Neneuhcāyōtl:Ōtlācatqueh xiuhpan 1971	Kategorio:Naskiĝintoj en 1971
Neneuhcāyōtl:Ōtlācatqueh xiuhpan 1972	Kategorio:Naskiĝintoj en 1972
Neneuhcāyōtl:Ōtlācatqueh xiuhpan 1973	Kategorio:Naskiĝintoj en 1973
Neneuhcāyōtl:Ōtlācatqueh xiuhpan 1975	Kategorio:Naskiĝintoj en 1975
Neneuhcāyōtl:Ōtlācatqueh xiuhpan 1976	Kategorio:Naskiĝintoj en 1976
Neneuhcāyōtl:Ōtlācatqueh xiuhpan 1978	Kategorio:Naskiĝintoj en 1978
Neneuhcāyōtl:Ōtlācatqueh xiuhpan 1979	Kategorio:Naskiĝintoj en 1979
Neneuhcāyōtl:Ōtlācatqueh xiuhpan 1980	Kategorio:Naskiĝintoj en 1980
Neneuhcāyōtl:Ōtlācatqueh xiuhpan 1981	Kategorio:Naskiĝintoj en 1981
Neneuhcāyōtl:Ōtlācatqueh xiuhpan 1982	Kategorio:Naskiĝintoj en 1982
Neneuhcāyōtl:Ōtlācatqueh xiuhpan 1985	Kategorio:Naskiĝintoj en 1985
Neneuhcāyōtl:Ōtlācatqueh xiuhpan 1986	Kategorio:Naskiĝintoj en 1986
Neneuhcāyōtl:Ōtlācatqueh xiuhpan 1987	Kategorio:Naskiĝintoj en 1987
Neneuhcāyōtl:Ōtlācatqueh xiuhpan 1988	Kategorio:Naskiĝintoj en 1988
Neneuhcāyōtl:Ōtlācatqueh xiuhpan 1989	Kategorio:Naskiĝintoj en 1989
Neneuhcāyōtl:Ōtlācatqueh xiuhpan 1991	Kategorio:Naskiĝintoj en 1991
Neneuhcāyōtl:Ōtlācatqueh xiuhpan 1993	Kategorio:Naskiĝintoj en 1993
Neneuhcāyōtl:Ōtlācatqueh xiuhpan 1994	Kategorio:Naskiĝintoj en 1994
Neneuhcāyōtl:Ōtlācatqueh xiuhpan 1995	Kategorio:Naskiĝintoj en 1995
Neneuhcāyōtl:Ōtlācatqueh xiuhpan 1996	Kategorio:Naskiĝintoj en 1996
Neneuhcāyōtl:Ōtlācatqueh xiuhpan 1997	Kategorio:Naskiĝintoj en 1997
Neneuhcāyōtl:Ōtlācatqueh xiuhpan 1999	Kategorio:Naskiĝintoj en 1999
Neneuhcāyōtl:Ōtlācatqueh xiuhpan 2000	Kategorio:Naskiĝintoj en 2000
Nemachiyōtīlli:AND	Ŝablono:AND
Nemachiyōtīlli:ARG	Ŝablono:ARG
Neneuhcāyōtl:Mācuīlpōhualxihuitl XI	Kategorio:11-a jarcento
Neneuhcāyōtl:Mācuīlpōhualxihuitl XVII	Kategorio:17-a jarcento
Nemachiyōtīlli:Tlatequitiltilīlli ca	Ŝablono:Vikipediisto ca
Nemachiyōtīlli:BDI	Ŝablono:BDI
Nemachiyōtīlli:BHS	Ŝablono:BHS
Neneuhcāyōtl:Italicotlahtōlli	Kategorio:Italika lingvaro
Neneuhcāyōtl:Ōmicqueh xiuhpan 1395	Kategorio:Mortintoj en 1395
Neneuhcāyōtl:Ōmicqueh xiuhpan 1427	Kategorio:Mortintoj en 1427
Neneuhcāyōtl:Tlani California īāltepēcalpōlhuān	Kategorio:Komunumoj de Baja California
Nemachiyōtīlli:Tlatequitiltilīlli sv-3	Ŝablono:Vikipediisto sv-3
Nemachiyōtīlli:CIV	Ŝablono:CIV
Nemachiyōtīlli:CRI	Ŝablono:CRI
Nemachiyōtīlli:CYP	Ŝablono:CYP
Neneuhcāyōtl:Ōmicqueh xiuhpan 1510	Kategorio:Mortintoj en 1510
Neneuhcāyōtl:Ōmicqueh xiuhpan 1525	Kategorio:Mortintoj en 1525
Neneuhcāyōtl:Ōmicqueh xiuhpan 1530	Kategorio:Mortintoj en 1530
Neneuhcāyōtl:Ōmicqueh xiuhpan 1533	Kategorio:Mortintoj en 1533
Neneuhcāyōtl:Tlacuīcaliztli Cemānāhuac	Kategorio:Muzikaj grupoj laŭ nacieco
Neneuhcāyōtl:Teōmatiliztli īpan Mēxihco	Kategorio:Religio en Meksiko
Neneuhcāyōtl:Ōmicqueh xiuhpan 1629	Kategorio:Mortintoj en 1629
Neneuhcāyōtl:Ōmicqueh xiuhpan 1715	Kategorio:Mortintoj en 1715
Neneuhcāyōtl:Ōmicqueh xiuhpan 1745	Kategorio:Mortintoj en 1745
Neneuhcāyōtl:Ōmicqueh xiuhpan 1755	Kategorio:Mortintoj en 1755
Neneuhcāyōtl:Ōmicqueh xiuhpan 1761	Kategorio:Mortintoj en 1761
Neneuhcāyōtl:Ōmicqueh xiuhpan 1784	Kategorio:Mortintoj en 1784
Neneuhcāyōtl:Ōmicqueh xiuhpan 1788	Kategorio:Mortintoj en 1788
Neneuhcāyōtl:Sardegna	Kategorio:Sardio
Neneuhcāyōtl:Rhein Mictlāmpa-Westfalen	Kategorio:Nordrejn-Vestfalio
Neneuhcāyōtl:Florida	Kategorio:Florido
Nemachiyōtīlli:EST	Ŝablono:EST
Neneuhcāyōtl:Nevada	Kategorio:Nevado
Neneuhcāyōtl:Yancuīc Mēxihco	Kategorio:Nov-Meksiko
Neneuhcāyōtl:Arizona	Kategorio:Arizono
Neneuhcāyōtl:California	Kategorio:Kalifornio
Neneuhcāyōtl:Colorado	Kategorio:Koloradio
Neneuhcāyōtl:Texas	Kategorio:Teksaso
Neneuhcāyōtl:Mēxihcah cemitqui olōlli	Kategorio:Politikaj partioj de Meksiko
Nemachiyōtīlli:QAT	Ŝablono:QAT
Nemachiyōtīlli:RUS	Ŝablono:RUS
Nemachiyōtīlli:TGO	Ŝablono:TGO
Nemachiyōtīlli:AUT	Ŝablono:AUT
Neneuhcāyōtl:Francitēcah tlahcuilōni	Kategorio:Francaj verkistoj
Nemachiyōtīlli:CHL	Ŝablono:CHL
Neneuhcāyōtl:Mīmiztin	Kategorio:Felisedoj
Nemachiyōtīlli:GRD	Ŝablono:GRD
Neneuhcāyōtl:Caxtiltēcah āmatlahcuilōnih	Kategorio:Hispanaj verkistoj
Neneuhcāyōtl:Machiyōmatiliztli	Kategorio:Semiotiko
Nemachiyōtīlli:SYR	Ŝablono:SYR
Nemachiyōtīlli:Familytree/step2	Ŝablono:Genealogia arbo/paŝo2
Nemachiyōtīlli:CHN	Ŝablono:CHN
Neneuhcāyōtl:Calmananimeh	Kategorio:Arkitektoj
Neneuhcāyōtl:Ōmicqueh xiuhpan 1928	Kategorio:Mortintoj en 1928
Neneuhcāyōtl:Angola	Kategorio:Angolo
Neneuhcāyōtl:Benin	Kategorio:Benino
Neneuhcāyōtl:Botzhuana	Kategorio:Bocvano
Neneuhcāyōtl:Burquina Faso	Kategorio:Burkino
Neneuhcāyōtl:Burundi	Kategorio:Burundo
Neneuhcāyōtl:Tlanomihuēyātēnco	Kategorio:Ebur-Bordo
Neneuhcāyōtl:Guinea Tlahcotlālticpac	Kategorio:Ekvatora Gvineo
Neneuhcāyōtl:Eritrea	Kategorio:Eritreo
Neneuhcāyōtl:Gabon	Kategorio:Gabono
Neneuhcāyōtl:Gambia	Kategorio:Gambio
Neneuhcāyōtl:Guinea	Kategorio:Gvineo
Neneuhcāyōtl:Guinea Bissau	Kategorio:Gvineo Bisaŭa
Neneuhcāyōtl:Camerun	Kategorio:Kameruno
Neneuhcāyōtl:Cabo Xoxoctic	Kategorio:Kabo-Verdo
Neneuhcāyōtl:Quenia	Kategorio:Kenjo
Neneuhcāyōtl:Comoras	Kategorio:Komoroj
Neneuhcāyōtl:Liberia	Kategorio:Liberio
Neneuhcāyōtl:Libia	Kategorio:Libio
Neneuhcāyōtl:Madagascar	Kategorio:Madagaskaro
Neneuhcāyōtl:Malahui	Kategorio:Malavio
Neneuhcāyōtl:Mali	Kategorio:Malio
Neneuhcāyōtl:Marruecos	Kategorio:Maroko
Neneuhcāyōtl:Mauritania	Kategorio:Maŭritanio
Neneuhcāyōtl:Mauricio	Kategorio:Maŭricio
Neneuhcāyōtl:Mozambique	Kategorio:Mozambiko
Neneuhcāyōtl:Namibia	Kategorio:Namibio
Neneuhcāyōtl:Niger	Kategorio:Niĝero
Neneuhcāyōtl:Ruanda	Kategorio:Ruando
Neneuhcāyōtl:Ōmicqueh xiuhpan 1595	Kategorio:Mortintoj en 1595
Neneuhcāyōtl:Ōmicqueh xiuhpan 1597	Kategorio:Mortintoj en 1597
Nemachiyōtīlli:ENG	Ŝablono:ENG
Neneuhcāyōtl:Ōmicqueh xiuhpan 2011	Kategorio:Mortintoj en 2011
Nemachiyōtīlli:HTI	Ŝablono:HTI
Nemachiyōtīlli:IRQ	Ŝablono:IRQ
Neneuhcāyōtl:Ōmicqueh xiuhpan 1541	Kategorio:Mortintoj en 1541
Neneuhcāyōtl:Baden-Württemberg	Kategorio:Baden-Virtembergo
Neneuhcāyōtl:Ōmicqueh xiuhpan 1811	Kategorio:Mortintoj en 1811
Neneuhcāyōtl:Ōmicqueh xiuhpan 1818	Kategorio:Mortintoj en 1818
Neneuhcāyōtl:Tlani California	Kategorio:Baja California
Neneuhcāyōtl:Burseraceae	Kategorio:Burseracoj
Neneuhcāyōtl:Ōmicqueh xiuhpan 1849	Kategorio:Mortintoj en 1849
Neneuhcāyōtl:Ōmicqueh xiuhpan 1862	Kategorio:Mortintoj en 1862
Neneuhcāyōtl:Ōmicqueh xiuhpan 1870	Kategorio:Mortintoj en 1870
Neneuhcāyōtl:Ōmicqueh xiuhpan 1873	Kategorio:Mortintoj en 1873
Neneuhcāyōtl:Ōmicqueh xiuhpan 1879	Kategorio:Mortintoj en 1879
Neneuhcāyōtl:Ōmicqueh xiuhpan 1887	Kategorio:Mortintoj en 1887
Neneuhcāyōtl:Ōmicqueh xiuhpan 1893	Kategorio:Mortintoj en 1893
Neneuhcāyōtl:Ōmicqueh xiuhpan 1895	Kategorio:Mortintoj en 1895
Neneuhcāyōtl:Ōmicqueh xiuhpan 1898	Kategorio:Mortintoj en 1898
Neneuhcāyōtl:Ōmicqueh xiuhpan 1913	Kategorio:Mortintoj en 1913
Neneuhcāyōtl:Ōmicqueh xiuhpan 1919	Kategorio:Mortintoj en 1919
Neneuhcāyōtl:Ōmicqueh xiuhpan 1936	Kategorio:Mortintoj en 1936
Neneuhcāyōtl:Ōmicqueh xiuhpan 1940	Kategorio:Mortintoj en 1940
Neneuhcāyōtl:Ōmicqueh xiuhpan 1948	Kategorio:Mortintoj en 1948
Neneuhcāyōtl:Ōmicqueh xiuhpan 1952	Kategorio:Mortintoj en 1952
Neneuhcāyōtl:Ōmicqueh xiuhpan 1955	Kategorio:Mortintoj en 1955
Neneuhcāyōtl:Ōmicqueh xiuhpan 1958	Kategorio:Mortintoj en 1958
Neneuhcāyōtl:Ōmicqueh xiuhpan 1964	Kategorio:Mortintoj en 1964
Neneuhcāyōtl:Ōmicqueh xiuhpan 1965	Kategorio:Mortintoj en 1965
Neneuhcāyōtl:Ōmicqueh xiuhpan 1971	Kategorio:Mortintoj en 1971
Neneuhcāyōtl:Ōmicqueh xiuhpan 1973	Kategorio:Mortintoj en 1973
Neneuhcāyōtl:Ōmicqueh xiuhpan 1983	Kategorio:Mortintoj en 1983
Neneuhcāyōtl:Ōmicqueh xiuhpan 1984	Kategorio:Mortintoj en 1984
Neneuhcāyōtl:Ōmicqueh xiuhpan 1989	Kategorio:Mortintoj en 1989
Neneuhcāyōtl:Ōmicqueh xiuhpan 1990	Kategorio:Mortintoj en 1990
Neneuhcāyōtl:Ōmicqueh xiuhpan 1995	Kategorio:Mortintoj en 1995
Neneuhcāyōtl:Ōmicqueh xiuhpan 1996	Kategorio:Mortintoj en 1996
Neneuhcāyōtl:Ōmicqueh xiuhpan 1997	Kategorio:Mortintoj en 1997
Neneuhcāyōtl:Ōmicqueh xiuhpan 2000	Kategorio:Mortintoj en 2000
Neneuhcāyōtl:Ōmicqueh xiuhpan 2001	Kategorio:Mortintoj en 2001
Neneuhcāyōtl:Ōmicqueh xiuhpan 2002	Kategorio:Mortintoj en 2002
Neneuhcāyōtl:Ōmicqueh xiuhpan 2004	Kategorio:Mortintoj en 2004
Neneuhcāyōtl:Xālīxco īāltepēcalpōlhuān	Kategorio:Komunumoj de Jalisco
Nemachiyōtīlli:Tlatequitiltilīlli ca-2	Ŝablono:Vikipediisto ca-2
Nemachiyōtīlli:Tlatequitiltilīlli ca-3	Ŝablono:Vikipediisto ca-3
Nemachiyōtīlli:Tlatequitiltilīlli pl-2	Ŝablono:Vikipediisto pl-2
Nemachiyōtīlli:Tlatequitiltilīlli pt	Ŝablono:Vikipediisto pt
Nemachiyōtīlli:Tlatequitiltililli ru-0	Ŝablono:Vikipediisto ru-0
Nemachiyōtīlli:Tlatequitiltilīlli ru-1	Ŝablono:Vikipediisto ru-1
Nemachiyōtīlli:Tlatequitiltilīlli tr-1	Ŝablono:Vikipediisto tr-1
Nemachiyōtīlli:Tlatequitiltilīlli tr-3	Ŝablono:Vikipediisto tr-3
Neneuhcāyōtl:Zambia	Kategorio:Zambio
Neneuhcāyōtl:Senegal	Kategorio:Senegalo
Neneuhcāyōtl:Mēxihco ītlahtōllō	Kategorio:Historio de Meksiko
Neneuhcāyōtl:Gentianales	Kategorio:Gencianaloj
Neneuhcāyōtl:Seychelles	Kategorio:Sejŝeloj
Neneuhcāyōtl:Tepētlah Leona	Kategorio:Siera-Leono
Neneuhcāyōtl:Zimbabhue	Kategorio:Zimbabvo
Neneuhcāyōtl:Somalia	Kategorio:Somalio
Neneuhcāyōtl:Sudan Huitztlāmpa	Kategorio:Sud-Sudano
Neneuhcāyōtl:Chad	Kategorio:Ĉado
Neneuhcāyōtl:Uganda	Kategorio:Ugando
Neneuhcāyōtl:Greciatlācah	Kategorio:Grekoj
Neneuhcāyōtl:Brasillācah	Kategorio:Brazilanoj
Neneuhcāyōtl:Tlahtōlmatinimeh	Kategorio:Lingvistoj
Neneuhcāyōtl:Filipinas	Kategorio:Filipinoj
Neneuhcāyōtl:Tlatequitiltilīlli nl	Kategorio:Vikipediisto nl
Neneuhcāyōtl:Tlatequitiltilīlli nn-3	Kategorio:Vikipediisto nn-3
Neneuhcāyōtl:Tlatequitiltilīlli no-2	Kategorio:Vikipediisto no-2
Neneuhcāyōtl:Tlatequitiltilīlli no	Kategorio:Vikipediisto no
Neneuhcāyōtl:Tlatequitiltilīlli nds-NL-1	Kategorio:Vikipediisto nds-NL-1
Neneuhcāyōtl:Tlatequitiltilīlli zh-1	Kategorio:Vikipediisto zh-1
Neneuhcāyōtl:Tlatequitiltilīlli zh-4	Kategorio:Vikipediisto zh-4
Neneuhcāyōtl:Tlatequitiltilīlli zh-2	Kategorio:Vikipediisto zh-2
Neneuhcāyōtl:Ulmaceae	Kategorio:Ulmacoj
Neneuhcāyōtl:Inglatēcah mecahuēhuētini	Kategorio:Britaj gitaristoj
Neneuhcāyōtl:Tlanitlālpan tlacuīcaliztli	Kategorio:Nederlandaj muzikaj grupoj
Neneuhcāyōtl:Armenia	Kategorio:Armenio
Neneuhcāyōtl:Bahrein	Kategorio:Barejno
Neneuhcāyōtl:Butan	Kategorio:Butano
Neneuhcāyōtl:Tlahcuilōlli	Kategorio:Skribo
Neneuhcāyōtl:Siria	Kategorio:Sirio
Neneuhcāyōtl:Tlācatilizilhuitl	Kategorio:Kristnasko
Neneuhcāyōtl:Mācuīlpōhualxihuitl XIV	Kategorio:14-a jarcento
Neneuhcāyōtl:Mācuīlpōhualxihuitl	Kategorio:Jarcentoj
Neneuhcāyōtl:Mācuīlpōhualxihuitl XIII	Kategorio:13-a jarcento
Neneuhcāyōtl:Mācuīlpōhualxihuitl XVI	Kategorio:16-a jarcento
Neneuhcāyōtl:Mācuīlpōhualxihuitl IV	Kategorio:4-a jarcento
Neneuhcāyōtl:Mācuīlpōhualxihuitl XVIII	Kategorio:18-a jarcento
Neneuhcāyōtl:Miquiztli	Kategorio:Morto
Neneuhcāyōtl:Pianotini	Kategorio:Pianistoj
Neneuhcāyōtl:Tlapōhualli	Kategorio:Entjeroj
Neneuhcāyōtl:Mēxihcah cemitqueh	Kategorio:Meksikaj politikistoj
Neneuhcāyōtl:Saxonia	Kategorio:Saksio
Neneuhcāyōtl:Ōmicqueh xiuhpan 1988	Kategorio:Mortintoj en 1988
Neneuhcāyōtl:Perutlācah	Kategorio:Peruanoj
Neneuhcāyōtl:Mēxihcah	Kategorio:Meksikanoj
Neneuhcāyōtl:Āltepētl īpan Irac	Kategorio:Urboj de Irako
Neneuhcāyōtl:Bavaria	Kategorio:Bavario
Neneuhcāyōtl:Tzitzimicītlalli īmētz	Kategorio:Lunoj de Saturno
Neneuhcāyōtl:Huēyitzitzimicītlalli īmētz	Kategorio:Lunoj de Jupitero
Neneuhcāyōtl:Ilhuicateōcītlalli	Kategorio:Urano
Neneuhcāyōtl:Huēyitzitzimicītlalli	Kategorio:Jupitero
Neneuhcāyōtl:Indoeuropantlahtōlli	Kategorio:Hindeŭropa lingvaro
Neneuhcāyōtl:Ōmicqueh xiuhpan 1809	Kategorio:Mortintoj en 1809
Neneuhcāyōtl:Ōmicqueh xiuhpan 1981	Kategorio:Mortintoj en 1981
Neneuhcāyōtl:Ōmicqueh xiuhpan 1999	Kategorio:Mortintoj en 1999
Neneuhcāyōtl:Cualtzin tlahcuilōlli	Kategorio:Legindaj artikoloj
Nemachiyōtīlli:Tlatequitiltilīlli pfl-1	Ŝablono:Vikipediisto pfl-1
Neneuhcāyōtl:Mācuīlpōhualxihuitl XV	Kategorio:15-a jarcento
Neneuhcāyōtl:Ōmicqueh īpan mācuīlpōhualxihuitl XVI	Kategorio:Mortintoj en la 16-a jarcento
Neneuhcāyōtl:Ōmicqueh īpan mācuīlpōhualxihuitl XVII	Kategorio:Mortintoj en la 17-a jarcento
Neneuhcāyōtl:Ōmicqueh īpan mācuīlpōhualxihuitl XVIII	Kategorio:Mortintoj en la 18-a jarcento
Neneuhcāyōtl:Ōmicqueh īpan mācuīlpōhualxihuitl XIX	Kategorio:Mortintoj en la 19-a jarcento
Neneuhcāyōtl:Ōmicqueh īpan mācuīlpōhualxihuitl XX	Kategorio:Mortintoj en la 20-a jarcento
Neneuhcāyōtl:Ōmicqueh īpan mācuīlpōhualxihuitl XXI	Kategorio:Mortintoj en la 21-a jarcento
Neneuhcāyōtl:Corea Mictlāmpa	Kategorio:Nord-Koreio
Neneuhcāyōtl:Georgia	Kategorio:Kartvelio
Neneuhcāyōtl:Camboya	Kategorio:Kamboĝo
Neneuhcāyōtl:Portugallācah	Kategorio:Portugaloj
Neneuhcāyōtl:Ōmicqueh xiuhpan 1848	Kategorio:Mortintoj en 1848
Neneuhcāyōtl:Ōmicqueh xiuhpan 1868	Kategorio:Mortintoj en 1868
Neneuhcāyōtl:Vanuatu	Kategorio:Vanuatuo
Neneuhcāyōtl:Tequiyōtl īpan Mēxihco	Kategorio:Ekonomio de Meksiko
Neneuhcāyōtl:Jamaica	Kategorio:Jamajko
Neneuhcāyōtl:Mēxihcah cuīcanih	Kategorio:Meksikaj kantistoj
Neneuhcāyōtl:Āltepētl īpan Ghana	Kategorio:Urboj de Ganao
Neneuhcāyōtl:Catar	Kategorio:Kataro
Neneuhcāyōtl:Quirguiztlālpan	Kategorio:Kirgizio
Neneuhcāyōtl:Cuhuait	Kategorio:Kuvajto
Neneuhcāyōtl:Lao	Kategorio:Laoso
Neneuhcāyōtl:Libano	Kategorio:Libano
Neneuhcāyōtl:Mianma	Kategorio:Birmo
Neneuhcāyōtl:Nepal	Kategorio:Nepalo
Neneuhcāyōtl:Omān	Kategorio:Omano
Neneuhcāyōtl:Ōmicqueh īpan mācuīlpōhualxihuitl XV	Kategorio:Mortintoj en la 15-a jarcento
Neneuhcāyōtl:Sri Lanca	Kategorio:Sri-Lanko
Neneuhcāyōtl:Tayictlālpan	Kategorio:Taĝikio
Neneuhcāyōtl:Timor Tlāpcopa	Kategorio:Orienta Timoro
Neneuhcāyōtl:Turcmentlālpan	Kategorio:Turkmenio
Neneuhcāyōtl:Uzbectlālpan	Kategorio:Uzbekio
Neneuhcāyōtl:Tlacetilīlli Arabiaemiryōtl	Kategorio:Unuiĝintaj Arabaj Emirlandoj
Neneuhcāyōtl:Ōmicqueh īpan mācuīlpōhualxihuitl XIV	Kategorio:Mortintoj en la 14-a jarcento
Neneuhcāyōtl:Caxtiltēcah	Kategorio:Hispanoj
Neneuhcāyōtl:Macedonia	Kategorio:Makedonio
Nemachiyōtīlli:Tlatequitiltilīlli de-4	Ŝablono:Vikipediisto de-4
Neneuhcāyōtl:Quribati	Kategorio:Kiribato
Neneuhcāyōtl:San Marino	Kategorio:San-Marino
Neneuhcāyōtl:Iordania	Kategorio:Jordanio
Neneuhcāyōtl:Samoa	Kategorio:Samoo
Neneuhcāyōtl:Necuiltōnolhuēyātēnco	Kategorio:Kostariko
Neneuhcāyōtl:Trinidad īhuān Tobago	Kategorio:Trinidado kaj Tobago
Neneuhcāyōtl:Surinam	Kategorio:Surinamo
Neneuhcāyōtl:Nicānāhuac	Kategorio:Nikaragvo
Neneuhcāyōtl:Bosnia īhuān Hertzegovina	Kategorio:Bosnio kaj Hercegovino
Neneuhcāyōtl:Noruega	Kategorio:Norvegio
Neneuhcāyōtl:Barbados	Kategorio:Barbado
Neneuhcāyōtl:Panama	Kategorio:Panamo
Neneuhcāyōtl:Paraguay	Kategorio:Paragvajo
Neneuhcāyōtl:Fiyi	Kategorio:Fiĝioj
Neneuhcāyōtl:Papua Yancuīc Guinea	Kategorio:Papuo-Nov-Gvineo
Neneuhcāyōtl:Marshall Tlālhuāctli	Kategorio:Marŝala Insularo
Neneuhcāyōtl:Liechtenstein	Kategorio:Liĥtenŝtejno
Neneuhcāyōtl:Salomón Tlālhuāctli	Kategorio:Salomonoj
Neneuhcāyōtl:Honduras	Kategorio:Honduro
Neneuhcāyōtl:Uruguay	Kategorio:Urugvajo
Neneuhcāyōtl:Andorra	Kategorio:Andoro
Neneuhcāyōtl:San Vicente īhuān in Granadinas	Kategorio:Sankta Vincento kaj Grenadinoj
Neneuhcāyōtl:Serbia	Kategorio:Serbio
Neneuhcāyōtl:Belice	Kategorio:Belizo
Neneuhcāyōtl:Cōzcatlān	Kategorio:Salvadoro
Neneuhcāyōtl:Haiti	Kategorio:Haitio
Neneuhcāyōtl:Ecuador	Kategorio:Ekvadoro
Neneuhcāyōtl:Yemen	Kategorio:Jemeno
Neneuhcāyōtl:Peru	Kategorio:Peruo
Neneuhcāyōtl:Dominica	Kategorio:Dominiko
Neneuhcāyōtl:Bolivia	Kategorio:Bolivio
Neneuhcāyōtl:Albania	Kategorio:Albanio
Neneuhcāyōtl:Monaco	Kategorio:Monako
Neneuhcāyōtl:Mīmichtin	Kategorio:Fiŝoj
Neneuhcāyōtl:Xōchihcualli	Kategorio:Fruktoj
Neneuhcāyōtl:Cemitqui olōlli	Kategorio:Politikaj partioj
Neneuhcāyōtl:Ōntzīntiliztica	Kategorio:Magnoliopsidoj
Neneuhcāyōtl:Xapontlahtōlli	Kategorio:Japana lingvo
Neneuhcāyōtl:Latintlahtōlli	Kategorio:Latina lingvo
Neneuhcāyōtl:Teutontlahtōlli	Kategorio:Germana lingvo
Neneuhcāyōtl:Mēxihco ītlahtōlhuān	Kategorio:Lingvoj de Meksiko
Neneuhcāyōtl:Rusiatlahtōlli	Kategorio:Rusa lingvo
Neneuhcāyōtl:Mēxihco ītepēhuān	Kategorio:Montoj en Meksiko
Neneuhcāyōtl:Guanajuato	Kategorio:Guanajuato
Neneuhcāyōtl:Campeche	Kategorio:Campeche
Neneuhcāyōtl:Quintana Roo	Kategorio:Quintana Roo
Neneuhcāyōtl:Mēxihco ītlahtohcāyōhuān	Kategorio:Provincoj de Meksiko
Neneuhcāyōtl:Chihuahhua	Kategorio:Chihuahua
Neneuhcāyōtl:Tamaulipas	Kategorio:Tamaulipas
Neneuhcāyōtl:Sinaloa	Kategorio:Sinaloa
Neneuhcāyōtl:Chontalpan	Kategorio:Tabasco
Neneuhcāyōtl:Nayarit	Kategorio:Nayarit
Neneuhcāyōtl:Tlani California Huitztlāmpa	Kategorio:Baja California Sur
Neneuhcāyōtl:Puebla	Kategorio:Puebla
Neneuhcāyōtl:Huāxyacac	Kategorio:Oaxaca
Neneuhcāyōtl:Guerrero	Kategorio:Guerrero
Neneuhcāyōtl:Aguascalientes	Kategorio:Aguascalientes
Neneuhcāyōtl:Hessen	Kategorio:Hesio
Neneuhcāyōtl:Coahuillān	Kategorio:Coahuila
Neneuhcāyōtl:Āltepētl īpan Venezuela	Kategorio:Urboj de Venezuelo
Neneuhcāyōtl:Annonaceae	Kategorio:Anonacoj
Neneuhcāyōtl:Apocynaceae	Kategorio:Apocinacoj
Neneuhcāyōtl:Cucurbitaceae	Kategorio:Kukurbacoj
Nemachiyōtīlli:ESP	Ŝablono:ESP
Neneuhcāyōtl:Yōlcatl	Kategorio:Bestoj
Neneuhcāyōtl:Nauru	Kategorio:Nauro
Neneuhcāyōtl:Palau	Kategorio:Palaŭo
Neneuhcāyōtl:Tonga	Kategorio:Tongo
Neneuhcāyōtl:Tuvalu	Kategorio:Tuvalo
Neneuhcāyōtl:Antigua īhuān Barbuda	Kategorio:Antigvo-Barbudo
Neneuhcāyōtl:Guyana	Kategorio:Gujano
Neneuhcāyōtl:Colombia	Kategorio:Kolombio
Neneuhcāyōtl:Cosovo	Kategorio:Kosovo
Neneuhcāyōtl:Tlahtōlcenyeliztli	Kategorio:Lingvaj familioj
Neneuhcāyōtl:East Sussex	Kategorio:East Sussex
Neneuhcāyōtl:Cemānāhuac āltepēnānyōtl	Kategorio:Ĉefurboj
Neneuhcāyōtl:Āltēpetl īpan Noruegia	Kategorio:Urboj de Norvegio
Neneuhcāyōtl:Āltepētl īpan Eslovenia	Kategorio:Urboj de Slovenio
Neneuhcāyōtl:Āltepētl īpan Suiza	Kategorio:Urboj de Svislando
Neneuhcāyōtl:Āltepētl īpan Rusia	Kategorio:Urboj de Rusio
Neneuhcāyōtl:Āltepētl īpan Hungria	Kategorio:Urboj de Hungario
Neneuhcāyōtl:Āltepētl īpan Africa Huitztlāmpa	Kategorio:Urboj de Sud-Afriko
Neneuhcāyōtl:Caxtillah-La Mancha	Kategorio:Kastilio-Manĉo
Neneuhcāyōtl:Asturia	Kategorio:Asturio
Neneuhcāyōtl:Andalucia	Kategorio:Andaluzio
Neneuhcāyōtl:Apple Computer	Kategorio:Apple
Neneuhcāyōtl:Tlatequitiltilīlli pl	Kategorio:Vikipediisto pl
Neneuhcāyōtl:Irtlālpan tlacuīcaliztli	Kategorio:Irlandaj muzikaj grupoj
Neneuhcāyōtl:Romatlahtōlli	Kategorio:Latinida lingvaro
Neneuhcāyōtl:Mictlāntēuccītlalli	Kategorio:Plutono
Neneuhcāyōtl:Cītlalpōl	Kategorio:Venuso
Neneuhcāyōtl:Ixachitlān Mictlāmpa	Kategorio:Nordameriko
Neneuhcāyōtl:Pāntli	Kategorio:Flagoj
Neneuhcāyōtl:Mecahuēhuētini	Kategorio:Gitaristoj
Neneuhcāyōtl:Yutanāhuatlahtōlli	Kategorio:Jut-azteka lingvaro
Nemachiyōtīlli:Tlatequitiltililli af-0	Ŝablono:Vikipediisto af-0
Neneuhcāyōtl:Āltepētl īpan Argentina	Kategorio:Urboj de Argentino
Neneuhcāyōtl:Āltepētl īpan China	Kategorio:Urboj de Ĉinio
Neneuhcāyōtl:Cuauhtēmallān	Kategorio:Gvatemalo
Neneuhcāyōtl:Tlīltepēc	Kategorio:Montenegro
Neneuhcāyōtl:Caxtillāntlahtōlli	Kategorio:Hispana lingvo
Neneuhcāyōtl:Huehcāuh Tlācatiyān	Kategorio:Pereintaj landoj
Neneuhcāyōtl:Sonora	Kategorio:Sonora
Xōchicamohtli	Karoto
Neneuhcāyōtl:Poales	Kategorio:Poaloj
Neneuhcāyōtl:Araceae	Kategorio:Arumacoj
Neneuhcāyōtl:Xiuhcopa tlacuīcaliztli	Kategorio:Muzikaj grupoj laŭ tempo
The Prodigy	The Prodigy
Puebla (āltepēcalpōlli)	Puebla de Zaragoza
Neneuhcāyōtl:Āltepētl īpan Mēxihco	Kategorio:Urboj de Meksiko
Neneuhcāyōtl:Queen	Kategorio:Queen
Neneuhcāyōtl:Āltepētl īpan Cuauhtēmallān	Kategorio:Urboj de Gvatemalo
Neneuhcāyōtl:Āltepētl īpan Nicānāhuac	Kategorio:Urboj de Nikaragvo
Neneuhcāyōtl:Āltepētl īpan Vietnam	Kategorio:Urboj de Vjetnamio
Neneuhcāyōtl:Āltepētl īpan Belgica	Kategorio:Urboj de Belgio
Neneuhcāyōtl:Āltepētl īpan Belice	Kategorio:Urboj de Belizo
Neneuhcāyōtl:Āltepētl īpan Burundi	Kategorio:Urboj de Burundo
Neneuhcāyōtl:Āltepētl īpan Brasil	Kategorio:Urboj de Brazilo
Neneuhcāyōtl:Āltepētl īpan San Marino	Kategorio:Municipoj de San-Marino
Neneuhcāyōtl:Āltepētl īpan Caxtillān	Kategorio:Urboj de Hispanio
Neneuhcāyōtl:Āltepētl īpan Azerbaiyan	Kategorio:Urboj de Azerbajĝano
Neneuhcāyōtl:Āltepētl īpan Afganistan	Kategorio:Urboj de Afganio
Neneuhcāyōtl:Āltepētl īpan Australia	Kategorio:Urboj de Aŭstralio
Neneuhcāyōtl:Āltepētl īpan Iordania	Kategorio:Urboj de Jordanio
Neneuhcāyōtl:Āltepētl īpan Ucrania	Kategorio:Urboj de Ukrainio
Neneuhcāyōtl:Āltepētl īpan Italia	Kategorio:Urboj de Italio
Neneuhcāyōtl:Āltepētl īpan Peru	Kategorio:Urboj de Peruo
Neneuhcāyōtl:Āltepētl īpan Gambia	Kategorio:Urboj de Gambio
Neneuhcāyōtl:Āltepētl īpan Angola	Kategorio:Urboj de Angolo
Neneuhcāyōtl:Āltepētl īpan Honduras	Kategorio:Urboj de Honduro
Neneuhcāyōtl:Āltepētl īpan Egipto	Kategorio:Urboj de Egiptio
Neneuhcāyōtl:Āltepētl īpan Cuba	Kategorio:Urboj de Kubo
Neneuhcāyōtl:Brassicales	Kategorio:Brasikaloj
Neneuhcāyōtl:Āltepētl īpan Lituania	Kategorio:Urboj de Litovio
Neneuhcāyōtl:Apiales	Kategorio:Apialoj
Neneuhcāyōtl:Cucurbitales	Kategorio:Kukurbaloj
José Sixto Verduzco (āltepēcalpōlli)	José Sixto Verduzco
Neneuhcāyōtl:Malvales	Kategorio:Malvaloj
Santa Ana Nohpallohcān	Santa Ana Nopalucan
Neneuhcāyōtl:Inglatēcah pianotini	Kategorio:Anglaj pianistoj
Neneuhcāyōtl:Nippontlahtōlli	Kategorio:Japana lingvaro
Neneuhcāyōtl:Catalania	Kategorio:Katalunio
Neneuhcāyōtl:2000s tlacuīcaliztli	Kategorio:Muzikaj grupoj 2000-2009
Nemachiyōtīlli:UGA	Ŝablono:UGA
Nemachiyōtīlli:UZB	Ŝablono:UZB
Nemachiyōtīlli:WLS	Ŝablono:Kimrio
Neneuhcāyōtl:Mēxihco ītlālmachiyōhuān	Kategorio:Naciaj simboloj de Meksiko
Neneuhcāyōtl:Huiquipedia:Cualtzin tlahcuilōlli īpan h:de	Kategorio:Elstaraj artikoloj en de.wiki
Neneuhcāyōtl:Huiquipedia:Cualtzin tlahcuilōlli īpan h:el	Kategorio:Elstaraj artikoloj en el.wiki
Neneuhcāyōtl:Huiquipedia:Cualtzin tlahcuilōlli īpan h:en	Kategorio:Elstaraj artikoloj en en.wiki
Neneuhcāyōtl:Huiquipedia:Cualtzin tlahcuilōlli īpan h:es	Kategorio:Elstaraj artikoloj en es.wiki
Neneuhcāyōtl:Huiquipedia:Cualtzin tlahcuilōlli īpan h:fr	Kategorio:Elstaraj artikoloj en fr.wiki
Neneuhcāyōtl:Huiquipedia:Cualtzin tlahcuilōlli īpan h:pl	Kategorio:Elstaraj artikoloj en pl.wiki
Neneuhcāyōtl:Huiquipedia:Cualtzin tlahcuilōlli īpan h:pt	Kategorio:Elstaraj artikoloj en pt.wiki
Nemachiyōtīlli:Pantli2	Ŝablono:Flago
Nemachiyōtīlli:Lang-pl	Ŝablono:Lang-pl
Trojany	Trojany
Nemachiyōtīlli:Tlatequitiltilīlli an-1	Ŝablono:Vikipediisto an-1
Neneuhcāyōtl:Piperales	Kategorio:Piperaloj
Neneuhcāyōtl:Huiquipedia:Tlātlatequitiltilīltin Mēxihco	Kategorio:Vikipediistoj de Meksiko
Nemachiyōtīlli:Tlatequitiltilīlli nah-2	Ŝablono:Vikipediisto nah-2
Nemachiyōtīlli:Tlatequitiltilīlli it-4	Ŝablono:Vikipediisto it-4
Nemachiyōtīlli:Tlatequitiltilīlli gmh-1	Ŝablono:Vikipediisto gmh-1
Nemachiyōtīlli:Tlatequitiltilīlli an-4	Ŝablono:Vikipediisto an-4
Nemachiyōtīlli:SLV	Ŝablono:SLV
Nemachiyōtīlli:RWA	Ŝablono:RWA
Nemachiyōtīlli:MLT	Ŝablono:MLT
Nemachiyōtīlli:KEN	Ŝablono:KEN
Nemachiyōtīlli:JAM	Ŝablono:JAM
Nemachiyōtīlli:HND	Ŝablono:HND
Nemachiyōtīlli:Tlatequitiltilīlli ast	Ŝablono:Vikipediisto ast
Neneuhcāyōtl:Vitaceae	Kategorio:Vitacoj
Neneuhcāyōtl:Ihiyohuiliztli in Wikimedia CAT	Kategorio:Vikipediistoj subtenantaj Wikimedia CAT
Asientos (calpollolco)	Asientos
Neneuhcāyōtl:Alismatales	Kategorio:Alismaloj
Neneuhcāyōtl:Amaranthaceae	Kategorio:Amarantacoj
Neneuhcāyōtl:Tlatequitiltilīlli tokipona	Kategorio:Vikipediisto tokipona
Neneuhcāyōtl:Huehuehāltepētl īpan Mēxihco	Kategorio:Arkeologiaj lokoj en Meksiko
Neneuhcāyōtl:Apiaceae	Kategorio:Apiacoj
Neneuhcāyōtl:Arecales	Kategorio:Arekaloj
Neneuhcāyōtl:Tlapōhuallōtl	Kategorio:Aritmetiko
Neneuhcāyōtl:Convolvulaceae	Kategorio:Konvolvulacoj
Neneuhcāyōtl:Rhamnaceae	Kategorio:Ramnacoj
Neneuhcāyōtl:Euphorbiaceae	Kategorio:Eŭforbiacoj
Neneuhcāyōtl:Urticaceae	Kategorio:Urtikacoj
Neneuhcāyōtl:Atapascātlahtōlli	Kategorio:Atabaska lingvaro
Neneuhcāyōtl:Arutlahtōlli	Kategorio:Ajmara lingvaro
Neneuhcāyōtl:Pinaceae	Kategorio:Pinacoj
Chicōncōāc	Chiconcuac
Cōzcatlān, Puebla	Coxcatlán (Puebla)
Neneuhcāyōtl:Tlapiyalmeh	Kategorio:Dombestoj
Neneuhcāyōtl:Commelinales	Kategorio:Komenilaloj
Neneuhcāyōtl:Iglesia Ortodoxa	Kategorio:Ortodoksismo
Neneuhcāyōtl:Ericales	Kategorio:Erikaloj
Neneuhcāyōtl:Extremadura	Kategorio:Ekstremaduro
Neneuhcāyōtl:Cupressaceae	Kategorio:Cipresacoj
Neneuhcāyōtl:Fagaceae	Kategorio:Fagacoj
Neneuhcāyōtl:Germaniatlahtōlli	Kategorio:Ĝermana lingvaro
Neneuhcāyōtl:Greciamachiyōtlahtōltecpantiliztli	Kategorio:Greka alfabeto
Neneuhcāyōtl:Hordaland	Kategorio:Hordaland
Neneuhcāyōtl:Irtlālpan	Kategorio:Irlando
Neneuhcāyōtl:Tēmelāhuanimeh Jehová	Kategorio:Atestantoj de Jehovo
Neneuhcāyōtl:Lamiaceae	Kategorio:Lamiacoj
Neneuhcāyōtl:Tlahtōlāmoxtlahcuilōnimeh	Kategorio:Leksikografoj
Neneuhcāyōtl:Linaceae	Kategorio:Linacoj
Neneuhcāyōtl:Lombardia	Kategorio:Lombardio
Neneuhcāyōtl:Mayatlahtōlli	Kategorio:Majaa lingvaro
Neneuhcāyōtl:Quechhuatlahtōlli	Kategorio:Keĉua lingvaro
Neneuhcāyōtl:Mēxihco tlacuīcaliztli	Kategorio:Meksikaj muzikaj grupoj
Neneuhcāyōtl:Tlāloccītlalli īmētz	Kategorio:Lunoj de Neptuno
Neneuhcāyōtl:Yucatān īāltepēcalpōlhuān	Kategorio:Komunumoj de Yucatán
Neneuhcāyōtl:Taihuan	Kategorio:Respubliko Ĉinio
Neneuhcāyōtl:Myrtaceae	Kategorio:Mirtacoj
Neneuhcāyōtl:Nāhuatlahtōlli	Kategorio:Naŭatla lingvo
Neneuhcāyōtl:Rosales	Kategorio:Rozaloj
Neneuhcāyōtl:San Cristóbal īhuān Nevis	Kategorio:Sankta-Kito kaj Neviso
Neneuhcāyōtl:Santa Lucía	Kategorio:Sankta Lucio
Neneuhcāyōtl:Sapotaceae	Kategorio:Sapotacoj
Neneuhcāyōtl:Semitatlahtōlli	Kategorio:Semida lingvaro
Nemachiyōtīlli:NIR	Ŝablono:NIR
Neneuhcāyōtl:Eslavotlahtōlli	Kategorio:Slava lingvaro
Nemachiyōtīlli:BEL	Ŝablono:BEL
Neneuhcāyōtl:Myrtales	Kategorio:Mirtaloj
Neneuhcāyōtl:Piperaceae	Kategorio:Piperacoj
Neneuhcāyōtl:Sterculiaceae	Kategorio:Sterkuliacoj
Neneuhcāyōtl:The Beatles	Kategorio:The Beatles
Neneuhcāyōtl:Tlatequitiltilīlli tokipona-1	Kategorio:Vikipediisto tokipona-1
Neneuhcāyōtl:São Paulo	Kategorio:San-Paŭlo (urbo)
Neneuhcāyōtl:Tequixquiāc	Kategorio:Tequixquiac
Neneuhcāyōtl:Texas ītēucyōhuān	Kategorio:Kantonoj de Teksaso
Neneuhcāyōtl:Bahamas	Kategorio:Bahamoj
Neneuhcāyōtl:Tōllohcān	Kategorio:Toluca
Neneuhcāyōtl:Tlapālli	Kategorio:Koloroj
Neneuhcāyōtl:Algicatlahtōlli	Kategorio:Algia lingvaro
Neneuhcāyōtl:Aragón	Kategorio:Aragono
Neneuhcāyōtl:Musaceae	Kategorio:Muzacoj
Neneuhcāyōtl:Betulaceae	Kategorio:Betulacoj
Neneuhcāyōtl:Brunei	Kategorio:Brunejo
Neneuhcāyōtl:Tepoztlahcuilōliztli	Kategorio:Presado
Neneuhcāyōtl:California ītēucyōhuān	Kategorio:Kantonoj de Kalifornio
Neneuhcāyōtl:Tlaxcallān	Kategorio:Tlaxcala
Nemachiyōtīlli:Image label begin	Ŝablono:Marko sur bildo komenco
Neneuhcāyōtl:Caryophyllales	Kategorio:Kariofilaloj
Neneuhcāyōtl:Centzīntiliztica	Kategorio:Unukotiledonaj
Neneuhcāyōtl:Chīchīlcītlalli īmētz	Kategorio:Lunoj de Marso
Neneuhcāyōtl:Moraceae	Kategorio:Morusacoj
Neneuhcāyōtl:Aguascalientes īāltepēcalpōllōhuān	Kategorio:Komunumoj de Aguascalientes
Neneuhcāyōtl:Tlani California Huitztlāmpa īāltepēcalpōlhuān	Kategorio:Komunumoj de Baja California Sur
Neneuhcāyōtl:Campeche īāltepēcalpōlhuān	Kategorio:Komunumoj de Campeche
Neneuhcāyōtl:Chihuahhua īāltepēcalpōlhuān	Kategorio:Komunumoj de Chihuahua
Neneuhcāyōtl:Hidalgo īāltepēcalpōlhuān	Kategorio:Komunumoj de Hidalgo
Neneuhcāyōtl:Mēxihco īāltepēcalpōlhuān	Kategorio:Komunumoj de Meksiko
Neneuhcāyōtl:Tlahtohcāyōtl Mēxihco īāltepēcalpōlhuān	Kategorio:Komunumoj de Estado de México
Neneuhcāyōtl:Papaveraceae	Kategorio:Papavacoj
Neneuhcāyōtl:Nadenetlahtōlli	Kategorio:Na-denea lingvaro
Neneuhcāyōtl:Bantutlahtōlli	Kategorio:Niĝerkonga lingvaro
Neneuhcāyōtl:Ilhuicateōcītlalli īmētz	Kategorio:Lunoj de Urano
Nise da Silveira	Nise da Silveira
Neneuhcāyōtl:São Paulo Metro	Kategorio:Metroo en San-Paŭlo
Neneuhcāyōtl:Otommanguetlahtōlli	Kategorio:Otomi-mangea lingvaro
Neneuhcāyōtl:Mēxihcah Tlahtohcātēīxiptla	Kategorio:Prezidantoj de Meksiko
Nemachiyōtīlli:Tlahtōllibabel	Ŝablono:Babellingva enhavo
Álvaro Obregón (āltepēcalpōlli)	Álvaro Obregón (Michoacán)
Neneuhcāyōtl:Huāxyacac īāltepēcalpōlhuān	Kategorio:Komunumoj de Oaxaca
Neneuhcāyōtl:Puebla īāltepēcalpōlhuān	Kategorio:Komunumoj de Puebla
Neneuhcāyōtl:Tabasco īāltepēcalpōlhuān	Kategorio:Komunumoj de Tabasco
Nemachiyōtīlli:HUN	Ŝablono:HUN
Neneuhcāyōtl:Tlatequitiltilīlli lfn	Kategorio:Vikipediisto lfn
Neneuhcāyōtl:Tlatequitiltilīlli ru-0	Kategorio:Vikipediisto ru-0
Neneuhcāyōtl:Tlatequitiltilīlli es-0	Kategorio:Vikipediisto es-0
Neneuhcāyōtl:Tlatequitiltilīlli af-0	Kategorio:Vikipediisto af-0
Nemachiyōtīlli:Otroscal	Ŝablono:Jaro en la aliaj kalendaroj
Neneuhcāyōtl:Tlatequitiltilīlli en-1	Kategorio:Vikipediisto en-1
Neneuhcāyōtl:Ōtlācatqueh xiuhpan 1930	Kategorio:Naskiĝintoj en 1930
Neneuhcāyōtl:1946 tlācatiliztli	Kategorio:Naskiĝintoj en 1946
Neneuhcāyōtl:Tlatequitiltilīlli de-1	Kategorio:Vikipediisto de-1
Neneuhcāyōtl:1920 tlācatiliztli	Kategorio:Naskiĝintoj en 1920
Neneuhcāyōtl:Ōtlācatqueh xiuhpan 1956	Kategorio:Naskiĝintoj en 1956
Neneuhcāyōtl:1933 tlācatiliztli	Kategorio:Naskiĝintoj en 1933
Neneuhcāyōtl:1911 tlācatiliztli	Kategorio:Naskiĝintoj en 1911
Neneuhcāyōtl:Ōtlācatqueh xiuhpan 1937	Kategorio:Naskiĝintoj en 1937
Neneuhcāyōtl:1948 tlācatiliztli	Kategorio:Naskiĝintoj en 1948
Neneuhcāyōtl:Tlatequitiltilīlli da-N	Kategorio:Vikipediisto da-D
Neneuhcāyōtl:Ōmicqueh xiuhpan 1978	Kategorio:Mortintoj en 1978
Neneuhcāyōtl:1921 tlācatiliztli	Kategorio:Naskiĝintoj en 1921
Neneuhcāyōtl:1924 tlācatiliztli	Kategorio:Naskiĝintoj en 1924
Neneuhcāyōtl:Ōtlācatqueh xiuhpan 1926	Kategorio:Naskiĝintoj en 1926
Neneuhcāyōtl:1950 tlācatiliztli	Kategorio:Naskiĝintoj en 1950
Neneuhcāyōtl:1964 tlācatiliztli	Kategorio:Naskiĝintoj en 1964
Neneuhcāyōtl:Āltepētl īpan Teutontlālpan	Kategorio:Urboj de Germanio
Neneuhcāyōtl:Ōmicqueh xiuhpan 1979	Kategorio:Mortintoj en 1979
Neneuhcāyōtl:Ōmicqueh xiuhpan 2010	Kategorio:Mortintoj en 2010
Cristina Ferreira	Cristina Ferreira
Tlachco, Puebla	Tlaxco
Zoquiāpan	Zoquiapan
Nemachiyōtīlli:Tlatequitiltilīlli ru-3	Ŝablono:Vikipediisto ru-3
Nemachiyōtīlli:Tlatequitiltilīlli sco-1	Ŝablono:Vikipediisto sco-1
Tenabo	Tenabo
Acaltetepon	Kajmano
Huāzacazalōyān	Huasca de Ocampo
Schwaben	Ŝvaboj
Pāpalōtl	Rhopalocera
Rāhuano	Kultiva rafano
Nemachiyōtīlli:GeoTemplate/Lang	Ŝablono:GeoTemplate/Lang
-21	-21
Neneuhcāyōtl:Fagales	Kategorio:Fagaloj
Ehēcatepēc Morelos	Ecatepec de Morelos
Yun Hyon-seok	Yun Hyon-seok
Coreca	Coreca
Nōncuahquīzqui:CambiosRecientes	Specialaĵo:Lastaj ŝanĝoj
Neneuhcāyōtl:Tlatequitiltilīlli ja-4	Kategorio:Vikipediisto ja-4
Ebola cocoliztli īpan tlācah īpan 2014	Ebola epidemio en Okcidentafriko (2014)
Īpān Puerto Rico	Flago de Porto-Riko
Tlācatlahtocāyōtl Āltepēhuahcāyōtl Donetsk	Popola Respubliko de Donecko
Huēxotlah Reyes	Huejutla de Reyes
Maurizio Malvestiti	Maurizio Malvestiti
