Naakaii Łizhiní Bikéyah	Afriko
Binaʼadaałtzózí Dinéʼiʼ Bikéyah	Japanio
Bitsiighaʼ Łichííʼí Bikéyah	Irlando
Hángewii	Hungario
Dibé Diníí Bikéyah	Hispanio
Wááshindoon Bikéyah Ałhidadiidzooígíí	Usono
Bélgii Bikéyah	Belgio
Látsębooʼ	Luksemburgo (lando)
Yágháhookáán	Universo
Nahasdzáán	Tero
Nahoditsʼǫʼłání	Finnlando
Déinish Dineʼé Bikéyah	Danio
Póolish Dineʼé Bikéyah	Pollando
Łitʼoowę́ęya	Litovio
Ídelii	Italio
Swis Bikéyah	Svislando
Óóswiya	Aŭstrio
Gwíík Dineʼé Bikéyah	Grekio
Tʼóok Bikéyah	Turkio
Béésh Bichʼahníí Bikéyah	Eŭropo
(*@@@u0026asia")	Azio
Shádiʼááhjí kéyah yistinígíí	Antarkto
Kéyah Wóyahgo Siʼánígíí	Nederlando
Béésh bee akʼeʼelchíhí tʼáá bí nitsékeesígíí	Komputilo
Hastiin alą́ąjįʼ dahsidáhígíí Barack Obama	Barack Obama
Táłtłʼááh Chʼosh Bitooh (Kéyah Dah Siʼánígíí)	Urugvajo
Bilasáana	Pomo
Méhigo	Meksiko
Akééháshį́į́h Hahoodzo	Kalifornio
Máaz	Marso
Kénya	Kenjo
Iithiyópya	Etiopio
Gáana	Ganao
Náshdóítsoh bitsiijįʼ daditłʼooígíí	Leono
Dáághahii Dinéʼiʼ Bikéyah	Francio
Łééchąąʼí	Hundo
Tótaʼ Dinéʼiʼ Bikéyah	Unuiĝinta Reĝlando
Mósí	Hejma kato
Dáághahii bizaad	Franca lingvo
Łóóʼ	Fiŝoj
Bwazííl	Brazilo
Biʼééʼ Łichííʼí Bikéyah	Rusio
Łóóʼtsoh dóó Tééh hóyáanii	Cetacoj
Naakaii bichʼil łitsxooí	Mango (frukto)
Élábéemah Hahoodzo	Alabamo
Béésh Bichʼahii Bikéyah	Germanio
Bééshbichʼahii bizaad	Germana lingvo
Tin Bikéyah	Islando
Ééstii Bikéyah	Estonio
Séetin	Saturno (planedo)
Didzéchííʼ	Ĉerizo
Chidí naatʼaʼí	Aviadilo
Hastiin alą́ąjįʼ dahsidáhígíí George W. Bush	George W. Bush
Létbiiya	Latvio
Yóókwein	Ukrainio
Chek Bikéyah	Ĉeĥio
Słóbaʼ Bikéyah	Slovakio
Słobíín Bikéyah	Slovenio
Wooméiniya	Rumanio
Bálgaa Bikéyah	Bulgario
Dziłigaii Bikéyah	Albanio
Haʼaʼaahjí Hakʼaz Dineʼé Bikéyah	Gronlando
Kwóóʼad Bikéyah	Kroatio
Bosna dóó Hetsog Bikéyah	Bosnio kaj Hercegovino
Azééwii Bikéyah	Azerbajĝano
Andówa	Andoro
Béésh Łichíiʼii Bikéyah	Kipro
Jóojah (Kéyah)	Kartvelio
Kʼazah Bikéyah	Kazaĥio
Dziłizhin Bikéyah	Montenegro
Bádikin Sídii	Vatikano
San Mawínoo Bikéyah	San-Marino
Kyóoba	Kubo
Hashkʼaan Bikéyah	Barbado
Indoníízha	Indonezio
Tʼóok bizaad	Turka lingvo
Kéyah Naakai Łizhinii Bikéyah Shádiʼááhjí Siʼánígíí	Sud-Afriko
Aljííya	Alĝerio
Ózbeʼ Bikéyah	Uzbekujo
Tó	Akvo
Níłchʼi naalkidí	Televido
Chíilii	Ĉilio
Doodaatsaahii (Jíísas)	Jesuo Kristo
Mókiwii	Merkuro (planedo)
Ákáʼátʼįįł (béésh ntsékeesígíí álʼíní)	Apple
Biinis	Venuso (planedo)
Jíbitoo	Jupitero (planedo)
Yoowéinis	Urano (planedo)
Néʼtoon	Neptuno (planedo)
Sį́ʼgaboo	Singapuro
Tłóotoo	Plutono
Łííhtensain	Liĥtenŝtejno
Dágháilchįįh	Adolf Hitler
Naaltsoos biniiʼ	Facebook
Naaki góneʼ yéigo daʼahijoogą́ą́ʼ	Dua mondmilito
Ałhíʼayiiltááh	Matematiko
Aooméénii Bikéyah	Armenio
Ooljééʼ	Luno
Nahatʼeʼiitsoh Bikéyah	Aŭstralio
Béésh Łigaii Bikéyah	Argentino
Kolíya Bikéyah Náhookǫsjí Siʼánígíí	Nord-Koreio
Naayééʼ	Dinosaŭro
Bilasáana bitseeʼ nineezígíí	Pirarbo
Encyclopædia Britannica	Encyclopaedia Britannica
Tó yaʼnidaʼaazgééd	Akvedukto
Chʼil łitsooí díkʼǫ́zhígíí	Citrono
Hashkʼaan (łitsooígíí)	Banano
Sǫʼ	Stelo
Jóhonaaʼéí	Suno
Háájiʼjin	Hidrogeno
Níłchʼi Ászólí	Heliumo
Haʼaʼaahjí Tíímow	Orienta Timoro
Séwes	Cereso
Haʼooméya	Haŭmeo
Maakiimaakii	Makemako (nanoplanedo)
Ééwis	Eriso
Káábin	Karbono
Níłchʼi Yáʼátʼéehii	Oksigeno
Hadoh dóó hakʼaz neiłkidígíí	Termometro
Níłchʼi Łitsxooí	Neono
Chihuahua Hahoodzo	Chihuahua
Soodin	Natrio
Béésh Łikoní	Magnezio
Béésh Ászólí	Aluminio
Tó Wónaanídę́ę́ʼ Bitsįʼ Yishtłizhii Bikéyah	Barato
Tʼoobááloo	Tuvalo
Béésh (Fe)	Fero
Tʼónga	Tongo
Łeetsoii	Sulfuro
Samóa	Samoo
Sólomon Tó Bináhaazyínígíí	Salomonoj
Banoʼáátʼoo	Vanuatuo
Páápowa Bigíní Ániidí	Papuo-Nov-Gvineo
Níłchʼi Dootłʼizhí	Argono
Eʼeʼaahjí Tónteel bikáaʼgi Kéyah Yázhí dah Ndaaʼeełgo Ałhidadiidzooígíí	Federacio de Mikronezio
Káálsiiyin	Kalcio
Dilyį́hí	Plumbo
Kílíbas	Kiribato
Chʼah Diʼilii Bikéyah	Mongolio
Fííjii	Fiĝioj
Béésh doo Ńdiniichxíihii	Titano (elemento)
Táłkááʼ Bighan Dineʼé Bikéyah	Venezuelo
Méíin Hahoodzo	Majno
Łį́į́ʼ	Ĉevalo
Naaldeehii	Bestoj
Sówinam	Surinamo
Kéyah Nahasdzáán Ałníiʼgi Siʼánígíí	Ekvadoro
Kolámbiya	Kolombio
Béésh Łibáhí	Kobalto
Bolíbiya	Bolivio
Béésh Łichíiʼii	Kupro
Niihémpshoo Hahoodzo	Nov-Hampŝiro
Chʼosh doo yitʼíinii dláádí dóó Ábishjaaʼ	Fungoj
Jaméíkʼa	Jamajko
Méésíchóoshish Hahoodzo	Masaĉuseco
Kanédikiʼ Hahoodzo	Konektikuto
Naaʼahóóhai	Koko
Antíígwa dóó Hashkʼaan Bikéyah Yázhí	Antigvo-Barbudo
Kéyah Ałkéé Nitį́įgo Dah Ndaaʼeełí	Havajo
Damóo Bikéyah	Dominiko
Domingo Bikéyah	Domingo
Bisóodi	Porko
Héítii	Haitio
Iiwą́ą́	Irano
Iiwááʼ	Irako
Hakʼaz Dineʼé Bikéyah Hahoodzo	Alasko
Ízrel Bikéyah	Israelo
Shádiʼááhjí Ásáí Bikéyah	Jemeno
Jóoʼdan	Jordanio
Gah Bikeeʼ Taahíʼahí	Florido
Kíígiz Bikéyah	Kirgizio
Hoozdo Hahoodzo	Arizono
Kóóweiʼ	Kuvajto
Lááʼos	Laoso
Łíbanoo	Libano
Óogin Hahoodzo	Oregono
Naakaii Dootłʼizhí Bikéyah Yázhí (Tó Bináhaazyínígíí)	Maldivoj
Kéyah dah siʼánígíí	Ameriko
Áshįįh Biiʼtó Hahoodzo	Utaho
Béégashii	Bovo
Maléízha	Malajzio
Dziłgaiitsoh Honeezkʼazii Bikéyah	Nepalo
Omą́ą́	Omano
Eʼeʼaahjí Naakaii Dootłʼizhí Bikéyah	Pakistano
Kʼatár	Kataro
Ásáí Bikéyah Saʼoodí	Sauda Arabio
Swii Lankʼa	Sri-Lanko
Sííwiya	Sirio
Tʼajiʼ Bikéyah	Taĝikio
Tʼáí Bikéyah	Tajlando
Kǫʼ naʼałbąąsii diné bee nágéhéʼ	Trajno
Tʼóokmen Bikéyah	Turkmenio
Ásáí Bikéyah Yázhí Ałhidadiidzooígíí	Unuiĝintaj Arabaj Emirlandoj
Biʼednam	Vjetnamio
Kolíya Bikéyah Shádiʼááhjí Siʼánígíí	Sud-Koreio
Óola	Oro
Naʼałkaahí	Sciencisto
Bangla Bikéyah	Bangladeŝo
Angóola	Angolo
Iiʼniʼ Tłʼiishtsoh Bikéyah	Butano
Bwoonéí	Brunejo
Tʼanzanííya	Tanzanio
Béésh Tózháanii	Hidrargo
Kéyah Dańlíinii	Filipinoj
Naakaii Łizhinii Bikéyah Beʼałnííʼ	Centr-Afrika Respubliko
Hastiin Albert Einstein	Albert Einstein
Tʼóogo	Togolando
Hooghan Tsé Bee Ádaalyaaí Bikéyah	Zimbabvo
Shádiʼááhjí Soodą́ą	Sud-Sudano
Tswana Dineʼé Bikéyah	Bocvano
Wóndii Dineʼé Bikéyah	Burundo
Ooljééʼ Bikéyah Yázhí	Komoroj
Kéyah Káango Náhookǫsjí Siʼánígíí	Respubliko Kongo
Kéyah Káango Shádiʼááhjí Siʼánígíí	Demokratia Respubliko Kongo
Jibótii	Ĝibutio
Gíní Nahasdzáán Ałníiʼgi Siʼánígíí	Ekvatora Gvineo
Gabǫ́ǫ́ (Kéyah)	Gabono
Géémbiya	Gambio
Gíní	Gvineo
Gíní Bisó	Gvineo Bisaŭa
Chį́į́h Yee Adilohii Bideeʼ Tónteel Bibąąh	Ebur-Bordo
Táłtłʼááh Chʼosh Daadánígíí Bitooh (Łizhinii Bikéyahdi)	Kameruno
Tónteel Bibąąh Dootłʼizhí	Kaboverdo
Sotho Dineʼé Bikéyah	Lesoto
Łíbya	Libio
Madaʼgéésgáá	Madagaskaro
Malááwii	Malavio
Moowitéínya	Maŭritanio
Moroko	Maroko
Namííbya	Namibio
Yogénda	Ugando
Wánda Dineʼé Bikéyah	Ruando
Seishel	Sejŝeloj
Náshdóítsoh Bitsiijįʼ Daditłʼooʼígíí Bidził	Siera-Leono
Soomáálii Bikéyah	Somalio
Soodą́ą	Sudano
Swáazi Dineʼé Bikéyah	Svazilando
Nahasdzáán Bikáaʼgi Kéyah Naaznilgo Ałhidadiidzooígíí	Unuiĝintaj Nacioj
Nidaashchʼąąʼígíí	Koloro
Béésh Łigaii	Arĝento
Béésh Dildǫʼí	Stano
Łéétsoh	Uranio
Hastiin alą́ąjįʼ dahsidáhígíí Bill Clinton	William J. Clinton
Míshigin Hahoodzo	Miĉigano
Tó Nitsaa Nílį́bąąh Hahoodzo	Ilinojso
Náhookǫsjí Dzígaii	Norda Dakoto
Ałnííʼjí Dzígaii	Suda Dakoto
Ayání Naakaii Hahoodzo	Montano
Tóʼííbézhí	Vajomingo
Nímasii Kʼidadilyéhé	Idaho
Ahééhałtį́į́h Hahoodzo	Vaŝingtonio
Naʼazhǫǫsh Hahoodzo	Nevado
Kayíbíyinsíí (tónteel)	Kariba Maro
Dibé Nitsaa Hahoodzo	Koloradio
Naakaii bizaad	Hispana lingvo
Naʼashjéʼii	Araneuloj
Chʼosh bijáád tseebíhígíí	Araneedoj
Chʼosh bideeʼ ádaadinígíí	Chelicerata
Chʼosh bijáád dahólónígíí	Artropodoj
Béeso	Mono
Bijíniyah Hahoodzo	Virginio (ŝtato)
Eʼeʼaahjí Bijiniyah Hahoodzo	Okcidenta Virginio
Kin Yótʼááh Deezʼá Hahoodzo	Nov-Jorkio
Wóód Áalin Hahoodzo	Rod-Insulo
Chʼosh bijáád hastání	Insekto
Méelin Hahoodzo	Marilando
Déláwee Hahoodzo	Delavaro
Oohááyoo Hahoodzo	Ohio
Pénsówéíniyah Hahoodzo	Pensilvanio
Niijéízii Hahoodzo	Nov-Ĵerzejo
Índíʼyéenah Hahoodzo	Indianio
Chidí	Aŭtomobilo
Jóojah Hahoodzo	Georgio
Akałii Bikéyah	Teksaso
Náhookǫsjí Kééláanah Hahoodzo	Norda Karolino
Shádiʼááhjí Kééláanah Hahoodzo	Suda Karolino
Méhigoʼ sídii	Meksik-urbo
Bilasáana diwozhí	Ananaso
Mísísípii Hahoodzo	Misisipio
Ténésii Hahoodzo	Tenesio
Yootó Hahoodzo	Nov-Meksiko
Mínisóodah Hahoodzo	Minesoto
Wiskaansin Hahoodzo	Viskonsino
Haʼaʼaahjí Dzígaii	Iovao
Nabeeskah Hahoodzo	Nebrasko
Shádiʼááhjí Dzígaii	Kansaso
Tó Dzígaii Nílį́	Misurio
Tónteel Chʼínílį́	Luiziano
Kentákii Hahoodzo	Kentukio
Dził Biiʼ Dzígaii	Arkansaso
Halgai Hóteel Hahoodzo	Oklahomo
Ho Chi Min Sídii	Ho-Ĉi-Min-urbo
Bilagáana bizaad	Angla lingvo
Náhookǫsjí Hakʼaz Dineʼé Bikéyah	Nunavuto
1901 – 1950	1902
Tłʼiish	Serpento
1951 – 2000	1979
Pope Benedict XVI	Benedikto la 16-a
Maʼii Ashkii	Geronimo
Tsin naaʼeeł táłtłʼááh naagháhígíí	Submarŝipo
Tahoniigááh	Gripo
Tłʼízí	Hejma kapro
Kǫʼ	Fajro
Tʼááłáhági átʼéego:Templates	Kategorio:Vikipedio:Ŝablonoj
Dloziłchííʼ	Rufa sciuro
Tʼááłáhági átʼéego:Bideeʼtsʼinígíí	Kategorio:Bovedoj
Tʼááłáhági átʼéego:Ndaaʼnaʼii	Kategorio:Skvamuloj
Tiníléítsoh	Komoda varano
Aymara bizaad	Ajmara lingvo
Łeeyiʼ chʼoshtsoh binááʼ hólónígíí	Senkruraj amfibioj
Tʼááłáhági átʼéego:Dééł dóó Tóidoozohii	Kategorio:Gruoformaj
Médíwííyin Sii	Mediteraneo
Alóós	Rizo
Tsídii	Birdoj
Kéchwa bizaad	Keĉua lingvaro
Ínsadoobíídiiya	Enciklopedio
Íiyisíí Naaltsoos	Vikipedio:Ĉefpaĝo
Dziłgaiitsoh Honeezkʼazii	Himalajo
Tʼááłáhági átʼéego:Candidates for speedy deletion	Kategorio:Tujforigendaj artikoloj
Chʼil ahwééh	Teo
Kéyah Sahééwa Eʼeʼaahjí Siʼánígíí	Okcidenta Saharo
1801 – 1850	1815
Łį́į́ʼ Bideeʼłáaʼii	Unukornulo
Hastiin Hernán Cortés	Hernán Cortés
Tsʼíʼii daʼaneezí	Moskito
Dibé	Ŝafo
Łóóʼ hashkéhé	Ŝarko
Ghą́ą́ʼaskʼidii	Kamelo
Bidił Daazdoígíí dóó Daʼałtʼoʼígíí	Mamuloj
Bíchį́į́h yee adilohii	Elefanto
Mágí dóó Mágí Ndahalinígíí	Primatoj
(*wálá-)	Formiko
Tsísʼná	Abelo
Naayízítsʼósí	Legomkukurbo
Sęęschʼil	Florbrasiko
Ayęęzhii yiltʼąąʼí	Melongeno
Naalʼeełí	Anasedoj
Yas	Neĝo
Jádí dághaaʼígíí	Gnuo
1851 – 1900	1865
Biʼééʼ Łichííʼí bizaad	Rusa lingvo
1751 – 1800	1784
Bááh	Pano
Bee Hazʼą́ą Ił Chʼétʼaah	Universala Deklaracio de Homaj Rajtoj
Kéyah haʼdéísná	Tertremo
Tó nitéél nitságoʼ atságáá	Cunamo
Níyoltsoh	Tornado (ŝtormo)
Saad bee alʼį́į́hni	Skribsistemo
Tʼááłáhági átʼéego:Dáághahii	Kategorio:Francio
Mąʼii łitsooí	Ruĝa vulpo
Naaltéʼ	Sklaveco
Ahwééh	Kafo
Abeʼ	Lakto
Dził	Monto
Doo Nidahałtingóó	Dezerto
Cryptographic	Kriptologio
Guadalajara	Gvadalaharo
Tsídii naʼałkʼaiʼí	Pingveno
Kolíya Dineʼé bizaad	Korea lingvo
Gah	Kuniklo
Tó niteel	Oceano
Hodíłchʼil Níłtsánígíí	Pluvarbaro
HiTSʼezh	IPod
Hazéí	Sciuredoj
Hazéí naatʼáʼii	Flugsciuro
Ééʼ néíshoodí	Katolika Eklezio
Kwį́į́n Elizabeth II	Elizabeto la 2-a (Britio)
Hastiin alą́ąjįʼ dahsidáhígíí Ronald Reagan	Ronald Reagan
Hastiin Emperor Yongle	Jongle
Naaldlooshii dadichʼízhii	Reptilioj
Tsin Deigházhígíí	Ronĝuloj
Hasbídí	Kolombedoj
Tééh hóyáanii	Porkocetoj
Biyáázh Tsʼǫʼasánígíí (Táyiʼ dóó Niʼkáágóó Ndaakaaígíí)	Amfibioj
Géeso	Fromaĝo
Chʼil naʼatłʼoʼii (chʼiyáán)	Vinbero
Tsísʼná bitłʼizh	Mielo
Atsįʼ	Viando
Nímasii	Terpomo
Áshįįh łikan	Sukero
Haʼałtsédii	Nukso
Wááshindoon bisiláołtsooí	Usona armeo
Naʼiiniʼ bá Hooghantsoh	World Trade Center
Áshįįh	Salo
Wááshindoondi bee hazʼáanii ádeiłʼíní	Usona Kongreso
Tsin naaʼeeł	Ŝipo
Nidaʼąnyéézh	Irigacio
Naadą́ą́ʼ	Maizo
Naʼashchʼąąʼ	Pentrado
Wótáahgoo ałnaaʼáłtʼahiʼ	Kosmonaŭto
Azhish	Danco
Kéyah Daʼnaaznilígíí	Listo de sendependaj ŝtatoj
Shash	Urso
Hastiin alą́ąjįʼ dahsidáhígíí John Adams	John Adams
Hastiin alą́ąjįʼ dahsidáhígíí Thomas Jefferson	Thomas Jefferson
Hastiin alą́ąjįʼ dahsidáhígíí Andrew Jackson	Andrew Jackson
Ńdíshchííʼ	Pino
Tłʼoh naadą́ą́ʼ	Tritiko
Naałniih yichʼą́ą́h naabaahígíí bąąh dahooʼaahgo	Aidoso
Abeʼ bee neezmasí	Patkuko
Jéíʼádįįh	Tuberkulozo
Łóódtsoh	Variolo
Zelda bahaneʼ	The Legend of Zelda
Naakáí dinéʼiʼ biempire Méhigodi	Aztekoj
Łéétsoh bee atsiniltłʼish álʼį́	Nuklea energio
Łéétsoh beeʼeldǫǫhtsoh beeʼalį́į́h	Atombombo
Chidí naaʼnaʼí beeʼeldǫǫh bikááʼ dah naaznilígíí	Tanko
Jalisco Hahoodzo	Jalisco
Dzidzé łikaní dinilchííʼígíí	Frambo
Mágí bichʼiyąʼ	Kokoso
Dzidzétsoh	Persiko
Chʼil łitsxooí	Oranĝo (frukto)
Chʼil dishooí	Kivifrukto
Chʼil dootłʼizhí díkʼǫ́zhígíí	Limeo
Abeʼ yistiní	Glaciaĵo
Méhigo bizaad	Naŭatla lingvo
Diné bizaad	Navaha lingvo
Jeeʼiighááh	Forfikuloj
Tenochtitlan	Tenoĉtitlano
Ásáí Bizaad	Araba lingvo
Honeezílígi	Subtropiko
Atʼaʼ yiltʼąąʼí	Arekacoj
Niłchiis	Gulo
Tsin yilátah ayání	Ĝirafo (specio)
Naalʼeełídaaʼí	Ornitorinko
Naʼashǫ́ʼii	Lacertuloj
Béésh bee akʼeʼelchí áłtsisígíí	Persona komputilo
Wikiibíídiiya:Naaltsoos nizhónígo ádaalyaaígíí	Vikipedio:Elstaraj artikoloj
Bee álnééhí:Link FA	Ŝablono:LigoElstara
Bimááʼ Hahoodzo	Vermonto
Hoozdoh	Fenikso (Arizono)
Tʼáyaałchííʼ	Brustornama pego
Táłkááʼ tsʼin bíchį́į́hnézí	Gavialo
Tsin naaʼeeł chidí naatʼaʼí bee nágéhéʼ	Aviadila ŝipo
Tsídiitsoh	Struto
Kolíya bikéyah (Ałtsʼáʼáztiin)	Koreio
Mąʼiitsoh	Lupo
Chʼídeeldlóohiitsoh	Ŝubekulo
Hodíłchʼilgi dlǫ́ʼiitsoh	Azia palm-civeto
Tóidoozohii bidaaʼ łichííʼígíí	Verdkrura galinolo
Táłtłʼááh yilcháazhii	Spongulo
Tónteel naʼashjéʼii	Mar-araneo
Séigoʼ	Skorpio
Zahalchíʼii	Kamelaraneo
Yaaʼ doo yitʼíinii	Akaro
Hodíłchʼilgi naaʼahóóhai	Tinamo
Tłʼiishkʼosí (tsídii)	Anhingedoj
Télii	Azeno
Náshdóítsoh noodǫ́zígíí	Tigro
Kʼíneeshbízhiinééz	Spagetoj
Tábąąhgi łeeyiʼ chʼosh	Sablovermo
Táłkáaʼgi Tsídii	Anseroformaj birdoj
Tązhii dóó Naaʼahóóhai Ndahalinígíí	Kokoformaj birdoj
Naalʼeełii keelóól	Greboj
Tsídii Deílʼésígíí	Cikonioformaj birdoj
Daʼałtʼoʼígíí Biyęęzhii Deiłchíhígíí	Monotremoj
Adijiłii bíchį́į́hnézí	Ekidno
Biyázhí neiyéhé	Didelfedoj
Hazéítsʼósii	Tamiaso
Chidí bikʼah	Nafto
Chéłchaaʼ	Koleopteroj
Łį́į́ʼ ałchiní	Prĵevalski-ĉevalo
Shash naʼazísí	Vombato
Bįįh Danilínígíí	Cervedoj
Tin	Glacio
Tłʼohchin díchʼííʼí	Ajlo
Taʼneeskʼání áłtsʼóózígíí	Kukumo
Tłʼohchin (chʼil daadánígíí)	Cepo
Chʼil łichxíʼí	Tomato
Béésh Łichíiʼii Bikéyah Náhookǫsjígo Siʼanígíí	Turka Respubliko Norda Kipro
Naʼazhǫǫsh Hátsoh	Lasvegaso
Náshdóí dilwoʼí	Gepardo
Tsékǫʼ	Terkarbo
Néʼéshjaaʼ	Strigoformaj birdoj
Bíígháán Dahólónígíí	Vertebruloj
Kʼishchííʼ	Betulo
Ǫǫbǫʼii	Upupedoj
Náshdóí Ndahalinígíí	Felisedoj
Yádiłhił yiiyídíʼ nahosdzáán yináádáłiʼ	Internacia Kosmostacio
Tó wónaanídę́ę́ʼ toohjįʼ noołnahii	Griza ardeo
Hashkʼaan dijéʼé	Daktilopalmo
Wááshindoon (Ałtsʼáʼáztiin)	Washington
Bidił Daazdoígíí dóó Daʼalghałígíí	Karnomanĝuloj
Chʼoshtsoh	Blato
Dlǫ́ʼii yázhí	Vizelo
Tsʼíʼii dóó Tséʼédǫ́ʼii	Dipteroj
Biniiʼłigaii (néʼéshjaaʼ)	Turstrigo
Mąʼii Ndahalinígíí	Kanisedoj
Bijáád Ádaadinígíí	Moluskoj
Chʼosh łitsxooí dóó Chʼosh łichííʼí	Kokcinelo
Táłkááʼ naalzheehí	Fiŝaglo
Bizaʼazis Dahólónígíí	Marsupiulo
Dlǫ́ʼiiłgaii	Ermeno
Naalʼeełí bitsiiʼ dootłʼizhí	Platbeka anaso
Sǫʼ łóóʼ	Marstelo
Giníłbáhí	Akcipitro
Tʼádootłʼizhii	Eŭropazia garolo
Zhį́ʼii	Korako
Táłkááʼ tsʼin Danilínígíí	Krokodilulo
Chʼosh bikágí dantłʼizí	Krustacoj
Dééł	Gruo (birdo)
Chʼosh bitsʼaʼígíí	Duvalvulo
Atsá dóó Giní Ndahalinígíí	Falkoformaj birdoj
Łóóʼ ooshgę́ęzhii	Kartilagaj fiŝoj
Tániilʼáí	Libelo
Wóláchííʼ yildeełí bikágí ntłʼizí	Maniso
Gah Danilínígíí	Leporuloj
Tsísʼnátsoh	Burdo
Zéédzísgaii	Komuna fazano
Dlǫ́ʼii Ndahalinígíí	Musteledoj
Tsin yiłkaałii	Pegedoj
Bideeʼtsʼinígíí	Bovedoj
Dééł dóó Tóidoozohii Ndahalinígíí	Gruoformaj
Gáagii dóó Joogii Ndahalinígíí	Korvedoj
Chʼiltaatʼagii	Blua cirkuo
Tsin naaʼeeł diné bee nágéhéʼ	Pramo
Gad	Junipero
Jááłánii	Miriapodo
Biishchʼid Dahólónígíí	Placentuloj
Chʼosh Deildeełii	Insektomanĝuloj
Tó wónaanídę́ę́ʼ naalʼeełítsoh łibáhígíí	Griza ansero
Tónteel dóó Tábąąhgi Tsídii	Ĥaradrioformaj birdoj
Biyaatsʼiin Dahólónígíí	Makzelulo
Tooh łéʼétsoh	Ondatro
Chaatʼíní	Okzalo
Wóʼatsʼǫǫsii Ádaatʼéhígíí	Hemipteroj
Atsáłgaii	Vilkrura buteo
Béégashiiʼilí	Gruntbovo
Tó wónaanídę́ę́ʼ dlǫ́ʼii	Putoro
Tsxį́į́łnaalkʼįhii	Apusedoj
Hakʼaz naalʼeełí	Molanaso
Naalʼeełítsoh bitsiiʼ halzhinígíí	Kanada ansero
Chʼó	Piceo
Łóóʼtsoh łizhin dóó łigaígíí	Granda orcino
Jáádtsʼósí	Rekurbrostruledoj
Téél dzítsooii dóó Tsétah chʼosh	Grundoskarabo
Naalʼeełítsoh diłhiłígíí	Berniklo
Tábąąh dlǫ́ʼii	Vizono
Dlǫ́ʼii bitéél halgaií	Foino
Diné Nááhódlóonii bizaad	Atabaska lingvaro
Tónteel tsídii	Mevo
Ałtį́į́ jikʼáshí (chʼil)	Ekvizeto
Hazaʼaleehtsoh (dííshjį́ ááłjiní)	Vera celerio
Kʼaalógii dóó Iichʼąhii	Lepidoptera
Díłdánii yił aheełtʼéhii	Ordinara koturno
Chʼałdą́ą́ʼ / Jádí nátʼoh (chʼil daadánígíí)	Asparago
Jaaʼabaní Danilínígíí	Kiropteroj
Wóónałchídii	Elateredoj
Tsídii bidaanézí	Cikoniedoj
Dlǫ́ʼii	Musteloj
Lókʼaaʼ	Phragmites australis
Tsídiiłbáhí	Paseredoj
Biłʼeʼeliníʼ	Bakpulvoro
Táłtłʼááh chʼoshchilí	Krilo
Tsiiʼyiishbizhí Dinéʼiʼ Bikéyah	Ĉinio
Naalʼeełí binááʼ łitsooígíí	Orokula klangulo
Tábąąstíín	Lutra lutra
Jélii łóóʼ	Meduzo
Náshdóíłgaii łikizhígíí	Neĝleopardo
Tábąąstííntsoh Danilínígíí	Fokuloj
Náshdóí bijaałizhiní	Karakalo (besto)
Chʼóhojilyééh	Ordinara daturo
Chʼah Diʼilii Bikéyahdę́ę́ʼ naalʼeełítsoh	Cigna ansero
Tsídii yáłtiʼí	Papagoformaj
Tééh łį́į́ʼ	Zebro
Náshdóí łikizhígíí	Oceloto
Dííłdzid jeeshóóʼ	Kadavrogrifo
Tʼáadoo leʼé danílʼį́ bił hazʼą́	Muzeo
Shash łizhin dóó łigaígíí	Granda pando
Shash łigaígíí	Blanka urso
Hastiin alą́ąjįʼ dahsidáhígíí Theodore Roosevelt	Theodore Roosevelt
Neeshchʼííłgai	Akaĵuo
Beeʼódleehí	Bestkaptilo
Dilní bee Nidaʼanéhígíí	Muzika instrumento
Dééłgai	Cigno
Bikááʼ náʼoobałí	Helikoptero
Dziʼizítsoh	Motorciklo
Tééhoołtsódii	Amfibia hipopotamo
Séí	Sablo
Naakaii Łizhiní Bikéyahdę́ę́ʼ náshdóítsoh łikizhígíí	Leopardo
Déélgééd	Rinoceredoj
Beeʼeldííl Dahsinil	Albuquerque (Nov-Meksiko)
Hashkʼaan dootłʼizhí (babáayah)	Papajo
Chʼil łigaii (atʼééké bijish)	Blanka brasiko
Náshdóítsoh	Pumo
Ásáí dinéʼiʼ	Araboj
Deeteel	Alko
Shádiʼááhdę́ę́ʼ náshdóítsoh łikizhígíí	Jaguaro
Lókʼaatsoh	Bambuo
Káango (Ałtsʼáʼáztiin)	Kongo
Kʼaiʼ	Saliko
Shash bizaʼazis hólóní	Koalo
Náshdóí kʼos bee naashchʼąąʼígíí	Nebula neofeliso
Shashtsoh	Bruna urso
Łéʼétsoh	Rato
Akʼáán	Faruno
Mágítsoh	Gorilo
Bitsįʼ yishtłizhii	Indianoj
Chʼil akʼahí	Avokado
Neeshchʼííłbáhí	Ternukso
Dzidzétsoh díkʼǫ́ǫzhii	Abrikotarbo
Naʼashǫ́ʼii łahgo ánééhé	Ĥameleono
Yootó	Santa Fe (Nov-Meksiko)
Łééchąąłgaii	Angla leporhundo
Nahatʼeʼiitsoh Bikéyahdę́ę́ʼ łééchąąʼí ałchiní	Dingo
Chʼééhjiyáán	Akvomelono
Teide	Tejdo
Naʼastsʼǫǫsí	Muso (besto)
Hakʼaz bįįh	Boaco
Chʼosh doo yitʼínii	Mikroorganismo
Táshchozhii	Hirundo
Neeshchʼííʼ hááheeshchiiʼí	Migdalujo
Łóóʼ bigaan tseebíí	Polpo
Chʼosh bikágí ntłʼizí	Krabo
Tábąąstííntsoh bideeʼ hólónígíí	Rosmaro
Mágí diʼilí	Orangutano
Atsátsoh	Reĝa aglo
Chʼil łitsxooí ntsxaaígíí	Grapfrukto
Kʼíníjíłʼahí (dííshjį́ ááłjiní)	Groso
Naʼastsʼǫǫsí binááʼ áłtsʼíísígíí	Soriko
Dzaanééz	Mulo
Tsinlátah shash łichíʼígíí	Malgranda pando
Tsídii jáádnézí	Flamengo
Tééh łééchąąʼí	Hienedoj
Łóóʼtsoh dootłʼizhígíí	Blua baleno
Sóól	Acero
Aghaaʼ	Lano
Deesdoigi	Tropikoj
Shádiʼááhdę́ę́ʼ tłʼízí	Lamo
Mósíʼilí	Persa kato
Lókʼaatah mósí ałchiní	Ĝangala kato
Náshdóítʼą́ʼí łikizhígíí	Servalo
Tábąąh béégashii	Akvobubalo
Béégashiitsoh naʼałkǫ́ǫ́ʼígíí	Manato
Hastiin Leiw Éíwiksson	Leifr Eiríksson
Akágí yitsʼǫǫsii	Hirudo
Anáʼálwoʼ:TʼAN (FAQ)	Helpo:Oftaj demandoj
Chidítsoh	Kamiono
Gáagii	Korvo
Tó wónaanídę́ę́ʼ náshdóí	Eŭrazia linko
Jááłánii (bitsiitsʼiin nteelígíí)	Centpieduloj
Giní	Falko
Dahiitį́hii	Kolibro
Tsídii biyęęzhtsohígíí	Kivio
Tązhii	Meleagro
Chʼosh (Bíígháán Ádaadinígíí)	Senvertebruloj
Gáagii naashchʼąąʼígíí	Koraciedoj
Mąʼii	Kojoto
Dah Naatʼaʼí Sǫʼ bił Sinil	The Star-Spangled Banner
Akʼah sisíʼí tsin	Eŭkalipto
Gahtsoh	Leporo
Bisóodi bíchį́į́h nineezí	Orikteropo
Sonora Hahoodzo	Sonora
Nahakʼízii	Grilo
Chaaʼ	Kastoro
Chʼilzooł	Brokolo
Kááʼtsʼiní	Dazipo
Atsʼiis naałdzid	Pulma kancero
Yágháhoníkáángóó ałánátʼahí	Kosmopramo
Béésh náábałí atsiniltłʼish ííłʼínígíí	Ventoturbino
Méhigo tééh	Valo de Meksiko
Shą́ą́ʼnahalghałí (naaldeehii)	Prokaviuloj
Nahatʼeʼiitsoh łichíiʼii	Ruĝa kanguruo
Azeeniłchin	Lamiacoj
Chʼał	Anuro
Tsxilghááh	Salamandro
Shádiʼááhdę́ę́ʼ atsátsoh	Amerika harpio
Shádiʼááhdę́ę́ʼ chʼał kʼaasdáhígíí	Dendrobatedoj
Tónteel tsídiitsoh	Albatrosoj
Chidí nadlééh	Kabrioleto
Bisóodi ałchiní	Apro
Sǫʼ łóóʼ bigaanézí	Ofiuredoj
Dághaałóóʼ	Katfiŝo
Łóóʼtʼą́hí	Pleŭronektoformaj
Toohjįʼ ndiigaii	Blanka egreto
Díłdánii	Amerikaj koturnoj
Táłtłʼááh łį́į́ʼ	Hipokampo
Łóóʼ bíígháántsiighąąʼ ádaadinígíí	Mukofiŝoj
Tó wónaanídę́ę́ʼ dzeeh	Ruĝa cervo
Kinłání (Hoozdoh Hahoodzo)	Flagstaff (Arizono)
Michoacán Hahoodzo	Michoacán
Táłtłʼááh chʼosh daadánígíí	Salikoko
Mágíshzhin	Ĉimpanza genro
Łóóʼntsxaaí łikizhígíí	Balenŝarko
Dlǫ́ʼii yił Aheedaałtʼéhígíí	Mungotedoj
Béésh Bichʼahníí Bikéyahdę́ę́ʼ ayání	Eŭropa bizono
Łóóʼtsoh bitsiiʼ dikʼání	Kaĉaloto
Waaʼ (dííshjį́ ááłjiní)	Legoma spinaco
Néʼéshjaatsoh	Granda kornostrigo
Shádiʼááhdę́ę́ʼ tłʼízíʼilí	Alpako
Chʼosh ditłʼooí	Raŭpo
Łóóʼ bigaan neeznání	Kalmaroj
Bijáád noodǫ́ǫzii	Okapio
Méhigo Hahoodzo	Estado de México
Ayání	Amerika bizono
Mąʼiiłgaii	Arkta vulpo
Gólízhii Danilínígíí	Mefito
Táłtłʼááh adijiłii	Eĥino
Nahachagii	Lokusto
Wóóneeshchʼįįdii (nahachaʼígíí)	Saltulo
Tsídiitsoh ditsʼozígíí	Emuo
Ałhaʼdeetʼaah	Kontrakto
Naayééʼ tsídii	Arkeopterigo
Tsísʼná (bitłʼizh ííłʼínígíí)	Mielabelo
Chééwokii dinéʼiʼ	Ĉerokoj
Tsin naaʼeeł hééł bee nágéhéʼ	Ŝarĝoŝipo
Yéigo ałhoshii	Gliredoj
Naʼashjéʼii bijéí dah łichíiʼii	Nigra vidvino
Didzéłchííʼ	Ilekso
Oozéí / Ayahkinii	Hopioj
Toohjįʼ noołnahiitsoh	Goliata ardeo
Bidááʼ Haʼaztʼiʼ Tsékooh	Granda Kanjono
Táłtłʼááh tsisteełtsoh	Leddorsa martestudo
Tábąąh mąʼii	Lav-urso
Hołchʼíʼí	Urtiko
Dáághahii dinéʼiʼ	Francoj
Shash łizhinígíí	Amerika nigra urso
Náshdóí bizaʼazis hólóní	Tilacino
Łeeyiʼ chʼosh	Tervermo
Shash bitéélgaígíí	Azia nigra urso
Chʼoshtʼą́hí	Platvermo
Hashtłʼish jeeshóóʼ	Ŝafgrifo
Jádí bíchį́į́htsohígíí	Altnaza antilopo
Táłtłʼááh chʼoshtsoh chʼééh digháhii	Markukumo
Chidí naatʼaʼí dilwoʼí	Ĉasaviadilo
Bíchį́į́h naatsʼǫǫdí	Tapiro
Łóóʼ Bigaan Dahólónígíí	Kapopieduloj
Dahbaʼ (tsin)	Frakseno
Neeshchʼííłchííʼ	Kaŝtanarbo
Chį́į́hnézí nahatʼeʼígíí	Makrosceliduloj
Táłtłʼááh ayání	Dugongo
Dibé Diníí Bikéyahdę́ę́ʼ náshdóí	Iberia linko
Toohjįʼ ndiigaiitsoh	Granda egretardeo
Wóóneeshchʼįįdii	Cikadedoj
Dééshzhiin	Nigra cigno
Dlǫ́ǫ́ʼ ntsxaaígíí	Kapibaro
Mąʼii bijaaʼtsohí	Feneko
Dilchaʼ	Marmoto
Náshdóí łibáhígíí	Rufa linko
Chʼilhaatʼaʼii	Kolombfalko
Tééh hóyáaniitsoh	Belugo
Jádí bideeʼ yisdizígíí	Impalo
Náátsʼózídę́ę́ʼ mąʼiiłchííʼ	Montara kuono
Łóóʼtsoh bighą́ą́ʼ yílkʼidígíí	Ĝiba baleno
Ghą́ą́ʼnaakiskʼidii	Baktria kamelo
Tábąąh mąʼiiniiʼí	Niktereŭto
Naʼazhǫǫsh (ndajiné dóó adazhdikaʼgi)	Kazino
Dlǫ́tʼą́ʼí	Surikato
Azeeʼ hókániitsoh (chʼil daadánígíí)	Artiŝoko
Kéchwa dinéʼiʼ	Keĉuoj
Mąʼii bizaʼazis hólóní	Tasmana diablo
Shash bítááʼłgaígíí	Okulvitra urso
Jádítsoh	Granda kuduo
Naatʼáanii Moctezuma II	Moktezumo la 2-a
Ásáí dinéʼiʼ bikéyah	Araba mondo
Shash yázhí	Malaja urso
Shash ndilnaʼii	Longlipa urso
Teeł	Tifao
Łéʼétsoh yiljaaʼí	Ranunkolo
Hakʼaz náshdóí	Kanada linko
Mąʼii yił Ałhidanoolinígíí Yázhí	Procionedoj
Béésh Bichʼahii beʼakétłʼóól dijoolí	Tigobrasiko
Nahooyéí (chʼil naʼatłʼoʼii)	Konvolvulo
Atʼééké bijish yázhí	Burĝonbrasiko
Tsékooh	Kanjono
Noodah	Agavo
Łeeʼdoolʼeezí	Orobankacoj
Aniłtʼánii	Neŭroptero
Kʼaalógii bijáád dį́įʼii	Nimfalisedoj
Nímasii yiyání	Terpoma skarabo
Taʼaghálii	Astragalo (planto)
Naaʼołí yiltʼąąʼí	Latiro
Hastóí tsiiyéélí	Klematido
Chʼilátah atsʼos	Epilobio
Shį́náldzidí (chʼil bilátah hózhóón)	Leonfaŭko
Kʼįįʼ	Sumako
Naaztání	Kristodorna glediĉio
Táłkááʼbéésh	Sagitario (planto)
Tsinyaa tłʼoh	Poo
Tłʼééʼ yiigáhii	Enotero
Díkʼǫ́ǫ́zhí (chʼil)	Atriplex
Zééʼiilwoʼii	Alopecurus
Chéchʼil ntłʼizí yiltʼąąʼí	Oregona mahonio
Tséyaa hataałí	Napo
Tłʼohtsʼózí	Junko
Tłʼoh dichʼíízh	Karekso
Bįįh yildeeʼí	Fizalido
Hosh niteelí	Opuntio
Teeł bitʼąąʼłánígíí	Skirpo
Chʼał nineezí	Taŭra rano
Tééh hóyáanii bíchį́į́htsahí	Narvalo
Mágí bíchį́į́htsohígíí	Paviano
Bįįh łikizhígíí (Béésh Bichʼahníí Bikéyahdę́ę́ʼígíí)	Damao
Tábąąh ayání	Afrika bubalo
Nátʼostsoh	Tapso
Dibé diníí dinéʼiʼ	Hispanoj
Binaʼadaałtzózí	Japanoj
Yéʼiibeʼetsʼos	Tegmentbromuso
Gad yił aheełtʼéhígíí	Tamariko
Łóóʼ bíchį́į́h nineezí	Spadofiŝo
Łį́į́ʼ Ndahalinígíí	Ekvedoj
Binááʼ Ádaałtsʼózí bichʼil łigaií	Pekina brasiko
Azeedíchʼííʼ	Kapsiketo
Kolíya Tááʼ Bikéyahą́ą	Tri Antikvaj Regnoj de Koreio
Łeehdoolʼeez łichííʼí	Ruĝa beto
Iiʼnótʼį́į́	Infekto
Chʼah Diʼilii Bikéyahdę́ę́ʼ mósí ałchinígíí	Palasa kato
Jááłánii (bikágí ntłʼizígíí)	Milpieduloj
Łóóʼ ńdídzihígíí	Pulmofiŝoj
Chʼíshiibeezhii	Paruedoj
Giní jáádnézí	Sekretaribirdo
Hakʼaz néʼéshjaaʼ	Neĝostrigo
Shádiʼááhdę́ę́ʼ jeeshóóʼ	Anda kondoro
Chidí naatʼaʼítsoh beeʼeldǫǫh bikǫʼ neiyéhé	Bombaviadilo
Shash bighą́ąʼgi hadzíbáhí	Griza urso
Kǫʼ naʼałbąąsii	Vaporlokomotivo
Ndíyíliitsoh	Sunfloro
Naaʼahóóhaiłkizhígíí	Numidedoj
Naakaii Łizhiní Bikéyahdę́ę́ʼ łééchąąʼí ałchiní	Makul-likaono
Aniłtʼánii (tʼááłaʼajínígoʼígíí)	Efemeroj
Ayánítsoh bighą́ą́ʼaskʼidígíí	Gaŭro
Máaz yikááʼ nandahí Spirit	Spirit
Hakʼaz giníłgaii	Ĉasfalko
Tsétah jeeshóóʼ łibáhí	Ansergrifo
Tłʼízí ałchiní	Natura kapro
Yaaʼ dóó chʼosh bíchį́į́h dadichʼízhí	Acanthocephala
Beeʼeldǫǫh	Muskedo
Tʼąąʼdoolghasí (daadánígíí)	Endivio
Dlǫ́ʼii (bílaʼashdlaʼii bilį́į́ʼ)	Furo
Łóóʼtsoh łibáhígíí	Griza baleno
Chʼah Diʼilii Bikéyahdę́ę́ʼ atsátsoh	Stepaglo
Yiisnááh	Militkaptito
Dzeeh	Kanada cervo
Tsinlátahgi tsídii nahatʼeʼígíí	Kolioformaj birdoj
Tsin naaʼeeł bee daʼahijighánígíí	Batalŝipo
Tsísʼná yiyání	Meropedoj
Bisóodi bizęęs dį́įʼii	Verukapro
Dlǫ́ʼiitsoh naalzheehígíí	Foso
Nahachagii biyázhí	Afido
Naalkʼįhiitsoh	Dermopteroj
Łóóʼ naatʼaʼí	Flugofiŝoj
Mąʼiitsoh bikʼos bineʼdę́ę́ʼ łizhinígíí	Kolhara lupo
Iichʼąhiitsʼósí	Triĥopteroj
Kéyah Dańlínídę́ę́ʼ atsátsoh	Filipina aglo
Tábąąstííntsoh bíchį́į́htsohígíí	Marelefanto
Chʼosh yighání	Protelo
Tó naagoʼ	Guto
Mágí bigaanézí	Gibonoj
Bílaneezii	Fingrobesto
Séí mąʼii	Korsako
Naalʼeełítsoh bitéél halchíʼí	Ruĝbrusta ansero
Tłʼízí bideeʼ yisdizígíí	Markoro
Jádí	Antilokapro
Wónikǫsí	Fantominsektoj
Tééh łééchąąʼí noodǫ́zígíí	Hieno
Tsídiiłchxoní	Hoacino
Mąʼii bighą́ąʼgi hadzíjiní	Nigradorsa ŝakalo
Naakaii Łizhiní Bikéyahdę́ę́ʼ mąʼiiłchííʼ	Etiopia lupo
Tsétah dibé	Kanada ŝafo
Dibé dóó Tłʼízí Ndahalinígíí	Kaprenoj
Mágí bíchį́į́h dootłʼizhígíí	Mandrilo
Tsiighájíłchí	Kuskuto
Dzeeh łikizhígíí	Makula cervo
Tábąąh mósí ałchiní	Fiŝa kato
Chį́į́h yee achʼiishíhii	Segilorajo
Shádiʼááhdę́ę́ʼ hodíłchʼil mąʼii	Mustelvulpo
Hakʼaz mágí	Japana makako
Tsé Biiʼ Ndzisgaii	Monument Valley
Mágí bíchį́į́h niilyoolígíí	Nazulo
Shádiʼááhdę́ę́ʼ tsídiitsoh	Amerika reao
Náátsʼózídę́ę́ʼ mósíłtsxooí ałchinígíí	Azia ora kato
Łóóʼnteeltsoh	Molao
Tábąąh bįįh	Rivera cervo
Hodíłchʼil jeeshóóʼ	Reĝa katarto
Dlǫ́ǫ́ʼ bitseetłʼooígíí	Ĉinĉilo
Néʼéshjaaʼ bíńdáhii	Nizostrigo
Bitseeʼ yee adiłhałii	Misisipa aligatoro
Níyolgi naatʼaʼígíí (tónteel tsídii)	Hidrobatedoj
Tádídíín yiyání	Foliskaraboj
Tsídiidaashiyishí	Ibisoj
Shádiʼááhdę́ę́ʼ łéʼétsoh bitseeʼ ádinígíí	Agutio
Naʼashǫ́ʼii łóóʼ hashkéhé	Koluma ŝarko
Jeeshóóʼ	Kalifornia kondoro
Chʼosh doo yitʼíinii bee nílʼíní	Mikroskopo
Tsin ditʼinii	Zizelo
Joogii	Blua garolo
Łeeyiʼ nahakʼízii	Talpogrilo
Náátsʼózídę́ę́ʼ naalʼeełí	Mandarenanaso
Tsídiitsoh bikʼos dootłʼizhí	Kazuaro
Dįʼ	Tetraonedoj
Tééhoołtsódiichilí	Nana hipopotamo
Tłʼohtahgi díłdánii yił aheełtʼéhii	Turnicedoj
Łóóʼyiniʼįįhí (tónteel tsídii)	Sterkorariedoj
Tsin yąąh dzootʼihí	Sitedoj
Tiníléí	Gila monstro
Dijádídlǫ́ʼí	Montalaŭdo
Tłʼoh	Herbotapiŝo
Dinas	Ursbera arktostafilo
Yadiizį́įgo ayání	Ĝirafa gazelo
Télii bijáád noodǫ́zí	Afrika sovaĝa azeno
Dááʼadeeʼii	Kulerbekuloj
Taahilnoodii	Suledoj
Łééh yidi tóʼígíí	Grundakvejo
Naʼashǫ́ʼiitsoh naʼałkǫ́ʼígíí	Marigvano
Tsídiisháshii	Bombiciledoj
Naakétłʼáhí	Pimoj
Yaaʼ bitsʼaʼígíí	Koĉo
Daateel	Ŝipbekulo
Kénézí	Jakanaedoj
Neeshchʼííʼ	Pinsemo
Naalʼeełítsoh yił aheełtʼéhii łizhin dóó łigaiígíí	Piga ansero
Mąʼii chʼil	Solidago
Yaadaaʼnézí (tónteel tsídii)	Tondilbekulo
Tsídii disxǫsígíí	Galbuledoj
Tsinlátahgi dlǫ́ʼiitsoh	Binturongo
Jeeshóóʼ łizhinígíí	Nigra katarto
Naałʼashí	Tarantulo
Dééłdą́ą́ʼ	Agla pteridio
Hashkʼaan yildeełígíí (tsídii)	Musofagedoj
Daakʼį́į́ʼ	Kurlo
Bįįh bitseełgaiígíí	Blankavosta cervo
Wónitłʼizí	Oniscidea
Dark Ages	Malluma Epoko
Dlóóʼ binaalniih	Bubona pesto
Ááhooshtʼįįh	Kapitulaco
Tééh tsisteeł	Martestudoj
Bichʼah Dootłʼizhii	Pactrupoj de Unuiĝintaj Nacioj
Łeʼesoołii (bitseeʼ naakiígíí)	Dipluro
Dlǫ́ʼátsoh	Arbara marmoto
Chʼééh digháhii dóó Tsisteeł	Testuduloj
Tááʼyaʼniiltʼóshii	Kardinaledoj
Łóóʼ bigaanłánígo bitsʼaʼígíí	Naŭtilo
Tániilʼáítsʼóóz	Zigopteroj
Tó wónaanídę́ę́ʼ hazéí bíchį́į́hnézí	Tupajuloj
Hakʼaz gah	Arkta leporo
Nahashchʼidí (naaldeehii)	Taksideo
Bisóodi bideeʼ názhahígíí	Babiruso
Tsídii bichʼahtsooígíí	Granda bunta bucero
Bilagáana	Blankulo
Shash nátʼoh	Tera tribuluso
Jádítsoh diłhiłígíí	Njalo
Dlǫ́ʼiitsoh łikizhígíí	Afrika civeto
Tsétah tłʼízí	Oreamno
Tsiishgaii	Pigmea sito
Tsį́į́łkaałiichilí	Pikumnoj
Dééłgai bitsiiʼ halzhinígíí	Nigrakola cigno
Naalʼeełí bidaatsʼózí	Merĝoj
Chį́į́shłigaií (bílaʼashdlaʼii bilį́į́ʼ)	Bredansero
Naalʼeełí łizhinígíí	Maranasoj
Nahatʼeʼiitsoh Bikéyahdę́ę́ʼ naalʼeełítsoh łibáhígíí	Cindrogriza ansero
Tsétah nahatʼeʼiitsoh	Rokaj kanguruoj
Táłkááʼ dilwoʼí	Geriso
Ąąʼąʼii	Pigo
Mósí ałchiní bitsiiʼtʼąhígíí	Platkapa kato
Naakaii Łizhiní Bikéyahdę́ę́ʼ naalʼeełítsoh dibéłchíʼígíí	Egipta ansero
Hosh aditsahiitsoh	Saguaro
Tʼáá łichíʼígo náʼagéédí	Heterocefalo
Tééh jeeshóóʼ	Afrika gipo
Łéʼétsoh beeniʼíhoniitaahígíí	Kavio
Sahdii Bisí (Tsé Nástánii)	Nacia parko Petrified Forest
Tsé Bighánílíní	Antilopa Kanjono
Tsídii naʼałkǫ́ʼígíí	Fraterkulo
Tónteel bibąąh hóyáanii	Nigra foceno
Náhookǫsdę́ę́ʼ dlǫ́ʼii	Amerika marteso
Naalʼeełí naashchʼąąʼígíí	Arbanaso
Tsin naaʼeeł łóó beeʼháʼhaalʼééłiʼ	Fiŝkapta ŝipo
Táłtłʼááh álééh	Blucindra ardeo
Tsísʼnáłtsooítsoh	Vespo (genro)
Náátsʼózídę́ę́ʼ tsiiłtsooí	Ora fazano
Bisóodi Danilínígíí	Neremaĉuloj
Tsʼání	Pinsemgarolo
Chʼééh digháhii bitsʼaʼ yilzhólí	Molkarapacaj testudoj
Chį́į́shghą́ʼiiłgaii	Karolina sito
Hastiin Diego de Landa	Diego de Landa
Tsįyaalzhahí	Striakcipitro
Yaaʼ nahachagiígíí	Pulo
Kéʼ łizhiní	Nigrapieduloj
Tábąąsdísí áłtsʼíísí	Makula tringo
Náátsʼózídę́ę́ʼ toohjįʼ ndiigaii	Ĉina egreto
Wóláchííʼ yildeełí łizhin dóó łigaígíí	Tamanduo
Hodíłchʼil tłʼízí	Sumatra serovo
Naayééʼ tsídiitsoh	Dinornito
Atseełtsoii	Jamajka buteo
Tóniłhę́ęshii (dééł)	Amerika gruo
Naaltsoos Mormon Wolyéhígíí	Libro de Mormon
Téél halchíʼí	Migra turdo
Dlǫ́ʼátah néʼéshjaaʼ	Kuniklostrigo
Tʼiisbáí	Ŝajntremola poplo
Yáhashjool yázhí	Eta botaŭro
Tłʼéeʼgo mágí	Noktosimio
Tsʼíʼii jáádnézí	Tipoledoj
Chʼil ditsʼozíłchííʼ	Rambutano
Taʼneeskʼání	Kantalupo
Tsídiiłtsooí bitʼaʼ łizhinígíí	Amerika kardelo
Anaasází	Anasazi-kulturo
Chʼééh digháhiitsoh	Galapaga testudo
Tsineeshbízhii	Amerika certio
Toohjįʼ noołnahii yázhí	Verda ardeo
Déłí	Kanada gruo
Ąąʼąʼiiłbáhí	Blua pigo
Naalʼeełí dootłʼizhí	Bluflugila anaso
Béíyózhin	Pajuteoj
Jádídlǫ́ʼii	Domtroglodito
Yaayááhalzhiin	Strigorĝa amfispizo
Chʼagiitsoh	Flavkapa trupialo
Níyolgi naʼałkǫ́ʼígíí (tónteel tsídii)	Pelekanoidedoj
Tłʼízíʼilí	Angura kapro
Tsinaʼayąʼii	Termito
Náʼagéédí bíchį́į́h sǫʼ nahalinígíí	Stelnaza talpo
Naaʼahóóhai disxǫsígíí	Lofoforoj
Neeshchʼíínímazí	Avelo
Tʼáyaałtso	Brustomakula pego
Nákʼeʼnáʼijiní	Kanada sito
Yáhashjool yił aheełtʼéhii	Sunbirdo
Zééjíjinii	Kresta kriulo
Chį́į́shłigaií dóó Naalʼeełítsoh	Ansero
Jádí biniiʼtsʼózí	Stepa alcelafo
Tábąąh jádí	Akvantilopo
Nahatʼeʼiitsoh Bikéyahdę́ę́ʼ tązhii	Lathama alekturo
Mąʼii dootłʼizhí	Ringovosta basarisko
Tóidoozohii bidaaʼ łigaiígíí	Fuliko
Tsisteeł hashkéhé	Ĥelidredoj
Wóniłchxoní	Pentatomedoj
Tsiikʼánii (tsídii)	Martelbirdo
Náátsʼózídę́ę́ʼ tsiidootłʼizhii	Argusfazano
Ábishjaaʼ (daadánígíí)	Manĝeblaj fungoj
Kéyah Dańlínídę́ę́ʼ naalʼeełí	Filipina anaso
Tiníléítsoh naʼałkǫ́ʼígíí	Akva varano
Tʼiis	Nigra poplo
Dééłtsoh	Koria otido
Tsé Bíyah Aniiʼáhí	Nacia Historia Parko de la Ĉako-kulturo
Nahatʼeʼiitsoh Bikéyahdę́ę́ʼ biyázhí neiyéhé	Vulpoposumo
Naaʼahóóhaiłbáhí	Perdix
Jeeshóóʼ ałchozhígíí	Palmogipo
Dlǫ́ʼii yił aheełtʼéhii łitsxooígíí	Vulpa cinikto
Chʼał ntsxaaígíí	Goljata rano
Tééh naaʼahóóhaitʼą́ʼí	Frankolino
Naalʼeełí (bílaʼashdlaʼii bilį́į́ʼ)	Hejmanaso
Yáhashjool	Nord-amerika botaŭro
Dlǫ́ʼii yił aheełtʼéhii yázhí	Nana helogalo
Tłʼohtahilzhahí	Kariamo
Dibé dághaaʼígíí	Japana serovo
Tsídiiłtsooí	Ora parulio
Chʼagii	Ruĝaflugila agelajo
Jeeshóóʼ bitsiiłgaiígíí	Blankakapa vulturo
Tábąądijádí	Kripluvio
Shádiʼááhdę́ę́ʼ niłchiis	Grizono (sudamerika gulo)
Naakaii Dootłʼizhí Dabikéyah	Suda Azio
Sháńdíín bitsʼą́ą́dę́ę́ʼ atsiniltłʼish álʼį́	Sunpanelo
Tsé noolchʼóshii	Katerpo
Naaʼahóóhai bikeetsohígíí	Megapodius
Naʼashǫ́ʼii kááʼtsʼinígíí	Dazipa lacerto
Diltʼóshii	Baeolophus
Atsá diłhiłígíí	Nigra aglo (birdo)
Ąąʼąʼii dootłʼizhígíí	Verda pigo
Dólii	Monta blubirdo
Biniiʼdootłʼizh	Nanaj strigoj
Tłʼoh azihii	Ephedra
Tsídii bizééʼ naashchʼąąʼí	Tragopano
Tábąąsdísíłbáí	Galinaga tringo
Dilzhę́ʼii	Stelera garolo
Łeeyiʼ bitiiní	Arvikolenoj
Atsáłbáí	Meksika falko
Tsʼánídílzhiʼí	Okcidenta makisgarolo
Iichʼąh	Konvulsio
Kiisʼáanii	Pueblo-indianoj
Ghą́ą́ʼdiʼilii (tsin yigházhígíí)	Longhara rato
Tsídii bitʼaʼ dah adadootłʼizhígíí	Pavofazanoj
Dilchʼóshii	Junkuloj
Hazéíntsxaaígíí	Ratufo
Dzílí	Kupera akcipitro
Dah Naatʼaʼí Bééhoʼdílzin	Ĵuro pri fideleco
Tónteel táshchozhii	Ŝterno
Dóliiłchííʼ	Okcidenta blubirdo
Anáʼálwoʼ:Bee hadítʼéhígíí	Helpo:Enhavo
Táłtłʼááh chʼoshtsoh bideeneezí	Palinuro
Tiníléítsoh łikizhígíí	Giganta varano
Tsé noolchʼóshiiłbáhí	Salpinkto
Halchíítah	Pentrita Dezerto
Wóósitsʼílí	Cimo (insekto)
Biizhii	Amerika kaprimulgo
Niłchʼiʼ bee naalkaahiʼ	Geostationary Operational Environmental Satellite
Tó Sido Háálį́	Pagosa Springs
Chʼoshtsoh bíláshgaantsohí (tónteelgiʼígíí)	Omaro
Tábąąstííntsoh bighaaʼ díłchʼilígíí	Felfoko
Kʼaiʼbisii	Salikoturdo
Táshchozhii dootłʼizhí	Purpura hirundo
Chíshii Kʼíneeshbizhii	Lucia vermivoro
Nááʼnoodǫ́ǫzii	Thlaspi
Tóidoozohii dootłʼizhígíí	Porfirio
Chʼagiiłbáhí	Molotro
Bitsiichįįshgahí	Kolumbia nucifrago
Naaldlooshii Bikéshgaan Dahólónígíí	Hufuloj
Néʼézhiin	Ruĝnuka sevsuĉulo
Ginítsoh diłhiłí	Nigra buteogalo
Tsídii bidaatsoh naashchʼąąʼí	Tukano (birdo)
Dahtooʼ yinooghałii	Marĉotroglodito
Tʼááłáhági átʼéego:Bééshbichʼahí	Kategorio:Germanio
Tʼááłáhági átʼéego:Wááshindoon bikéyah ałhidadiidzooígíí	Kategorio:Usono
Tʼááłáhági átʼéego:Dibé diníí bikéyah	Kategorio:Hispanio
Tʼááłáhági átʼéego:Naakaii Bikéyah	Kategorio:Meksiko
Wóódeʼełchíhii	Koreedoj
Choozhghalii	Ikteroj
Tsiiyah wozhii	Sturneloj
Naatsédlózii	Vojkuruloj
Tʼááłáhági átʼéego:Bidił daazdoígíí dóó daʼałtʼoʼígíí	Kategorio:Mamuloj
Tʼááłáhági átʼéego:Naaldlooshii dadichʼízhii	Kategorio:Reptilioj
Tʼááłáhági átʼéego:Biyáázh Tsʼǫʼasánígíí	Kategorio:Amfibioj
Tʼááłáhági átʼéego:Tsídii	Kategorio:Birdoj
Tʼááłáhági átʼéego:Chʼosh doo yitʼíinii dláádí dóó Ábishjaaʼ	Kategorio:Fungoj
Tʼááłáhági átʼéego:Chʼil	Kategorio:Plantoj
Tʼááłáhági átʼéego:Nátʼą́ą́ʼ náháneʼ	Kategorio:Historio
Tʼááłáhági átʼéego:Naʼalkaah	Kategorio:Scienco
Béégashii bideetsohí	Grandkorna bovo
Łóóʼtsoh bizábąąh shiyishí	Veraj balenoj
Kiisʼáanii Naakáí yikʼéʼ daʼdéísdlį́į́h	Ribelo de Puebloj
Dah yiskʼid	Holmo
Táshchozhii ndiilkʼísii	Klifhirundo
Tsídiiłtsooiiłkizhígíí	Bairda ammodramo
Iichʼąhii	Noktopapilio
Roman dinéʼiʼ	Romio
Naadą́ą́ʼ bichʼosh	Diabrotiko maizdamaĝiga
Tábąąh béégashii ałchiní	Azia bubalo
Bitátʼahkin	Navaha Nacia Monumento
Tʼááłáhági átʼéego:Ałtsʼáʼáztiin	Kategorio:Apartigiloj
Atsá	Aglo
Dą́ʼáchaan	Ustilago
Jááłánii bitsiitsʼiin łichííʼígíí	Arizona dezerta centpiedulo
Tʼááłáhági átʼéego:Stubs	Kategorio:Ĝermo
Tʼááłáhági átʼéego:Chidí naatʼaʼí	Kategorio:Aviadiloj
Bee álnééhí:User uk-2	Ŝablono:Vikipediisto uk-2
Tʼiistsoh	Alamo (Nov-Meksiko)
Tábąąsdísí	Galinago
Náyaasęęsí	Joseph City (Arizono)
Tʼááłáhági átʼéego:Wikipedia bots	Kategorio:Vikipedio:Robotoj
Áłtsínítsoh	Mortkamasio
Áshįįh (Beʼekʼid)	Zuni
Niłtsínii bikétłʼóól dijoolí (daadánígíí)	Rapo
Tsídii bitseeʼ naashchʼąąʼí	Pavo
Bee álnééhí:Tl	Ŝablono:Ŝ
Tʼááłáhági átʼéego:Bee Hazʼáanii	Kategorio:Juro
Tʼááłáhági átʼéego:Kéyah daʼnaaznilígíí dóó kéyah biłhaʼdaʼhaasdzoígíí	Kategorio:Landoj
Wikiibíídiiya:Dahwéetʼaahígíí	Vikipedio:Administrantoj
Wikiibíídiiya:Botígíí beehazʼą́ąnii	Vikipedio:Roboto
Ííjip	Egiptujo
Bee álnééhí:Bot	Ŝablono:Bot
Deeteel Bikéyah	Kanado
Tʼááłáhági átʼéego:Béésh bichʼahníí bikéyah	Kategorio:Eŭropaj landoj
Tʼááłáhági átʼéego:Choyoołʼįįhí Bizaad	Kategorio:Vikipediistoj laŭ lingvo
Anáʼálwoʼ:Wikiibíídiiya beehazʼą́ąnii	Vikipedio:Regularo
Bee álnééhí:Softredirect	Ŝablono:Intervikia plusendilo
Chʼosh chʼééh digháhii	Gastropodoj
Tʼááłáhági átʼéego:Saad	Kategorio:Lingvoj
Wikiibíídiiya:General disclaimer	Vikipedio:Malgarantio
Tʼááłáhági átʼéego:Noindexed pages	Kategorio:Neindeksitaj paĝoj
Wikiibíídiiya:Statistics	Vikipedio:Statistiko
Nahatʼeʼiitsoh	Kanguruo
Tʼááłáhági átʼéego:Living people	Kategorio:Vivantaj homoj
Tʼááłáhági átʼéego:Béésh bee akʼeʼelchíhí tʼáá bí nitsékeesígíí	Kategorio:Aplikata komputiko
Bee álnééhí:!	Ŝablono:!
Bee álnééhí:Bots	Ŝablono:Bots
Tʼááłáhági átʼéego:Naaltsoos	Kategorio:Libroj
Bee álnééhí:Wikisource	Ŝablono:Vikifontaro
Bee álnééhí:Babel	Ŝablono:Babelejo
Bee álnééhí:Commons	Ŝablono:Commons
Bee álnééhí:Reflist	Ŝablono:Referencoj
Bee álnééhí:Stub	Ŝablono:Ĝermo
Bee álnééhí:User af-1	Ŝablono:Vikipediisto af-1
Bee álnééhí:User ar-1	Ŝablono:Vikipediisto ar-1
Bee álnééhí:User bar-1	Ŝablono:Vikipediisto bar-1
Bee álnééhí:User eo-1	Ŝablono:Vikipediisto eo-1
Bee álnééhí:See also	Ŝablono:Vidu ankaŭ
Bee álnééhí:User da-2	Ŝablono:Vikipediisto da-2
Bee álnééhí:User da	Ŝablono:Vikipediisto da
Bee álnééhí:User ca-1	Ŝablono:Vikipediisto ca-1
Bee álnééhí:User ca-4	Ŝablono:Vikipediisto ca-4
Bee álnééhí:User be-2	Ŝablono:Vikipediisto be-2
Bee álnééhí:User da-1	Ŝablono:Vikipediisto da-1
Bee álnééhí:User cs-1	Ŝablono:Vikipediisto cs-1
Bee álnééhí:User bg-1	Ŝablono:Vikipediisto bg-1
Bee álnééhí:User eo-3	Ŝablono:Vikipediisto eo-3
Bee álnééhí:User de	Ŝablono:Vikipediisto de
Bee álnééhí:User de-1	Ŝablono:Vikipediisto de-1
Bee álnééhí:User eu-4	Ŝablono:Vikipediisto eu-4
Bee álnééhí:User el	Ŝablono:Vikipediisto el
Bee álnééhí:User es	Ŝablono:Vikipediisto es
Bee álnééhí:User de-3	Ŝablono:Vikipediisto de-3
Bee álnééhí:User en-3	Ŝablono:Vikipediisto en-3
Bee álnééhí:User el-1	Ŝablono:Vikipediisto el-1
Bee álnééhí:User en-1	Ŝablono:Vikipediisto en-1
Bee álnééhí:User en-2	Ŝablono:Vikipediisto en-2
Bee álnééhí:User fa-1	Ŝablono:Vikipediisto fa-1
Bee álnééhí:User eo-2	Ŝablono:Vikipediisto eo-2
Bee álnééhí:User en-4	Ŝablono:Vikipediisto en-4
Bee álnééhí:User fi	Ŝablono:Vikipediisto fi-D
Bee álnééhí:User en-0	Ŝablono:Vikipediisto en-0
Bee álnééhí:User es-4	Ŝablono:Vikipediisto es-4
Bee álnééhí:User en	Ŝablono:Vikipediisto en
Bee álnééhí:User de-2	Ŝablono:Vikipediisto de-2
Bee álnééhí:User es-1	Ŝablono:Vikipediisto es-1
Bee álnééhí:User fa	Ŝablono:Vikipediisto fa
Bee álnééhí:User fi-1	Ŝablono:Vikipediisto fi-1
Bee álnééhí:User fr-1	Ŝablono:Vikipediisto fr-1
Bee álnééhí:User ia-2	Ŝablono:Vikipediisto ia-2
Bee álnééhí:User hr	Ŝablono:Vikipediisto hr
Bee álnééhí:User he-2	Ŝablono:Vikipediisto he-2
Bee álnééhí:User he-1	Ŝablono:Vikipediisto he-1
Bee álnééhí:User id-3	Ŝablono:Vikipediisto id-3
Bee álnééhí:User io-3	Ŝablono:Vikipediisto io-3
Bee álnééhí:User it-3	Ŝablono:Vikipediisto it-3
Bee álnééhí:User grc-1	Ŝablono:Vikipediisto grc-1
Bee álnééhí:User ja-4	Ŝablono:Vikipediisto ja-4
Bee álnééhí:User sk	Ŝablono:Vikipediisto sk
Bee álnééhí:User tr-2	Ŝablono:Vikipediisto tr-2
Bee álnééhí:User ja	Ŝablono:Vikipediisto ja
Bee álnééhí:User ja-1	Ŝablono:Vikipediisto ja-1
Bee álnééhí:User it-1	Ŝablono:Vikipediisto it-1
Bee álnééhí:User hr-1	Ŝablono:Vikipediisto hr-1
Bee álnééhí:User fr	Ŝablono:Vikipediisto fr
Bee álnééhí:User gsw-1	Ŝablono:Vikipediisto gsw-1
Bee álnééhí:User he	Ŝablono:Vikipediisto he
Tʼááłáhági átʼéego:Chʼosh bijáád hastánígíí	Kategorio:Insektoj
Tʼááłáhági átʼéego:Choyoołʼįįhí uk	Kategorio:Vikipediisto uk
Tʼááłáhági átʼéego:Choyoołʼįįhí uk-N	Kategorio:Vikipediisto uk-D
Tʼááłáhági átʼéego:Chʼiyáán	Kategorio:Manĝaĵoj
Bee álnééhí:SIL	Ŝablono:ISO639-3 ligilo
Bee álnééhí:User it	Ŝablono:Vikipediisto it
Bee álnééhí:User uk	Ŝablono:Vikipediisto uk
Bee álnééhí:User es-2	Ŝablono:Vikipediisto es-2
Tʼááłáhági átʼéego:Choyoołʼįįhí fr-1	Kategorio:Vikipediisto fr-1
Bee álnééhí:Image label	Ŝablono:Marko sur bildo
Tʼááłáhági átʼéego:Atsá dóó Giní Ndahalinígíí	Kategorio:Falkoformaj
Tʼááłáhági átʼéego:Choyoołʼįįhí en-4	Kategorio:Vikipediisto en-4
Tʼááłáhági átʼéego:Choyoołʼįįhí en	Kategorio:Vikipediisto en
Tʼááłáhági átʼéego:Choyoołʼįįhí zh	Kategorio:Vikipediisto zh
Tʼááłáhági átʼéego:Choyoołʼįįhí zh-N	Kategorio:Vikipediisto zh-D
Tʼááłáhági átʼéego:Choyoołʼįįhí en-2	Kategorio:Vikipediisto en-2
Bee álnééhí:User eo	Ŝablono:Vikipediisto eo
Bee álnééhí:User zh	Ŝablono:Vikipediisto zh
Bee álnééhí:User ru-4	Ŝablono:Vikipediisto ru-4
Bee álnééhí:User sr	Ŝablono:Vikipediisto sr
Bee álnééhí:GeoTemplate	Ŝablono:GeoTemplate
Bee álnééhí:User nl-1	Ŝablono:Vikipediisto nl-1
Bee álnééhí:User nl-2	Ŝablono:Vikipediisto nl-2
Tʼááłáhági átʼéego:Dził	Kategorio:Montoj
Bee álnééhí:User ru	Ŝablono:Vikipediisto ru
Tʼááłáhági átʼéego:Kéyah yádiłhił biiʼ dahólónígíí	Kategorio:Sunsistemaj planedoj
Tʼááłáhági átʼéego:Kéyah dah siʼánígíí	Kategorio:Ameriko
Tʼááłáhági átʼéego:Choyoołʼįįhí bizaad-Templates	Kategorio:Babelaj ŝablonoj
Bee álnééhí:Archive	Ŝablono:Arkivo
Bee álnééhí:User eo-4	Ŝablono:Vikipediisto eo-4
Bee álnééhí:PD-US-gov	Ŝablono:PD-Usono-registaro
Tʼááłáhági átʼéego:Siláołtsooí	Kategorio:Armitaj fortoj
Tʼááłáhági átʼéego:Naʼashǫ́ʼii	Kategorio:Lacertuloj
Bee álnééhí:User pt-1	Ŝablono:Vikipediisto pt-1
Bee álnééhí:Tb	Ŝablono:Respondo
Bee álnééhí:User oc-4	Ŝablono:Vikipediisto oc-4
Bee álnééhí:User pl	Ŝablono:Vikipediisto pl
Bee álnééhí:User nl	Ŝablono:Vikipediisto nl
Bee álnééhí:User no-2	Ŝablono:Vikipediisto no-2
Bee álnééhí:Image label end	Ŝablono:Marko sur bildo fino
Bee álnééhí:Userpage	Ŝablono:Uzula paĝo
Bee álnééhí:Emergency-bot-shutoff	Ŝablono:Butono por forbari robotojn
Bee álnééhí:User pl-1	Ŝablono:Vikipediisto pl-1
Bee álnééhí:Image label small	Ŝablono:Marko sur bildo malgranda
Bee álnééhí:User fr-3	Ŝablono:Vikipediisto fr-3
Tʼááłáhági átʼéego:Choyoołʼįįhí gsw-4	Kategorio:Vikipediisto gsw-4
Bee álnééhí:User lt	Ŝablono:Vikipediisto lt
Bee álnééhí:User nds-1	Ŝablono:Vikipediisto nds-1
Tʼááłáhági átʼéego:Hosh	Kategorio:Kaktoj
Díłdánii (Ałtsʼáʼáztiin)	Koturno
Bee álnééhí:User tr-4	Ŝablono:Vikipediisto tr-4
Bee álnééhí:User is-1	Ŝablono:Vikipediisto is-1
Bee álnééhí:User is-2	Ŝablono:Vikipediisto is-2
Bee álnééhí:User ce	Ŝablono:Vikipediisto ce
Bee álnééhí:User ar-2	Ŝablono:Vikipediisto ar-2
Bee álnééhí:User ar-3	Ŝablono:Vikipediisto ar-3
Bee álnééhí:User is	Ŝablono:Vikipediisto is
Bee álnééhí:User en-5	Ŝablono:Vikipediisto en-5
Tʼááłáhági átʼéego:Choyoołʼįįhí ja-N	Kategorio:Vikipediisto ja-D
Tʼááłáhági átʼéego:Tłʼoh	Kategorio:Poacoj
Bee álnééhí:Ałtsʼáʼáztiin	Ŝablono:Apartigilo
Bee álnééhí:User no-3	Ŝablono:Vikipediisto no-3
Bee álnééhí:User ksh	Ŝablono:Vikipediisto ksh
Bee álnééhí:User no	Ŝablono:Vikipediisto no
Bee álnééhí:Chʼiyáánbiiʼ	Ŝablono:Nutravaloro
Bee álnééhí:Naʼalkaah	Ŝablono:Scienco
Bee álnééhí:User sv-2	Ŝablono:Vikipediisto sv-2
Tʼááłáhági átʼéego:Choyoołʼįįhí gsw-1	Kategorio:Vikipediisto gsw-1
Bee álnééhí:User it-2	Ŝablono:Vikipediisto it-2
Tʼááłáhági átʼéego:Ásáí Bikéyah	Kategorio:Membroj de la Ligo de Arabaj Ŝtatoj
Tʼááłáhági átʼéego:Kǫʼ naʼałbąąsii	Kategorio:Fervojo
Tʼááłáhági átʼéego:Choyoołʼįįhí gsw-2	Kategorio:Vikipediisto gsw-2
Bee álnééhí:User pt-3	Ŝablono:Vikipediisto pt-3
Bee álnééhí:User pt-2	Ŝablono:Vikipediisto pt-2
Bee álnééhí:User lb-1	Ŝablono:Vikipediisto lb-1
Bee álnééhí:User ro-4	Ŝablono:Vikipediisto ro-4
Bee álnééhí:User fr-4	Ŝablono:Vikipediisto fr-4
Bee álnééhí:User bg	Ŝablono:Vikipediisto bg
Bee álnééhí:User la-1	Ŝablono:Vikipediisto la-1
Tʼááłáhági átʼéego:Templates/doc	Kategorio:Ŝablono:Dokumentado
Tʼááłáhági átʼéego:Choyoołʼįįhí yue	Kategorio:Vikipediisto zh-yue
Tʼááłáhági átʼéego:Choyoołʼįįhí az	Kategorio:Vikipediisto az
Tʼááłáhági átʼéego:Choyoołʼįįhí be	Kategorio:Vikipediisto be
Tʼááłáhági átʼéego:Choyoołʼįįhí ce	Kategorio:Vikipediisto ce
Tʼááłáhági átʼéego:Choyoołʼįįhí hr	Kategorio:Vikipediisto hr
Tʼááłáhági átʼéego:Choyoołʼįįhí sk	Kategorio:Vikipediisto sk
Tʼááłáhági átʼéego:Choyoołʼįįhí sl	Kategorio:Vikipediisto sl
Tʼááłáhági átʼéego:Choyoołʼįįhí eo	Kategorio:Vikipediisto eo
Tʼááłáhági átʼéego:Choyoołʼįįhí et	Kategorio:Vikipediisto et
Tʼááłáhági átʼéego:Choyoołʼįįhí fr	Kategorio:Vikipediisto fr
Tʼááłáhági átʼéego:Choyoołʼįįhí gl	Kategorio:Vikipediisto gl
Tʼááłáhági átʼéego:Choyoołʼįįhí cy	Kategorio:Vikipediisto cy
Tʼááłáhági átʼéego:Choyoołʼįįhí gn	Kategorio:Vikipediisto gn
Tʼááłáhági átʼéego:Choyoołʼįįhí hu-N	Kategorio:Vikipediisto hu-D
Tʼááłáhági átʼéego:Choyoołʼįįhí id	Kategorio:Vikipediisto id
Tʼááłáhági átʼéego:Choyoołʼįįhí ia	Kategorio:Vikipediisto ia
Tʼááłáhági átʼéego:Choyoołʼįįhí ga	Kategorio:Vikipediisto ga
Tʼááłáhági átʼéego:Choyoołʼįįhí ja	Kategorio:Vikipediisto ja
Tʼááłáhági átʼéego:Choyoołʼįįhí la	Kategorio:Vikipediisto la
Tʼááłáhági átʼéego:Choyoołʼįįhí li	Kategorio:Vikipediisto li
Tʼááłáhági átʼéego:Choyoołʼįįhí lt	Kategorio:Vikipediisto lt
Tʼááłáhági átʼéego:Choyoołʼįįhí mk	Kategorio:Vikipediisto mk
Tʼááłáhági átʼéego:Choyoołʼįįhí mg	Kategorio:Vikipediisto mg
Tʼááłáhági átʼéego:Choyoołʼįįhí mn	Kategorio:Vikipediisto mn
Tʼááłáhági átʼéego:Choyoołʼįįhí nn	Kategorio:Vikipediisto nn
Tʼááłáhági átʼéego:Choyoołʼįįhí oc	Kategorio:Vikipediisto oc
Tʼááłáhági átʼéego:Choyoołʼįįhí pt	Kategorio:Vikipediisto pt
Tʼááłáhági átʼéego:Choyoołʼįįhí ro	Kategorio:Vikipediisto ro
Tʼááłáhági átʼéego:Choyoołʼįįhí sc	Kategorio:Vikipediisto sc
Tʼááłáhági átʼéego:Choyoołʼįįhí sh	Kategorio:Vikipediisto sh
Tʼááłáhági átʼéego:Choyoołʼįįhí sv	Kategorio:Vikipediisto sv
Tʼááłáhági átʼéego:Choyoołʼįįhí sw	Kategorio:Vikipediisto sw
Tʼááłáhági átʼéego:Choyoołʼįįhí th	Kategorio:Vikipediisto th
Tʼááłáhági átʼéego:Choyoołʼįįhí vo	Kategorio:Vikipediisto vo
Tʼááłáhági átʼéego:Choyoołʼįįhí be-3	Kategorio:Vikipediisto be-3
Tʼááłáhági átʼéego:Choyoołʼįįhí cs-3	Kategorio:Vikipediisto cs-3
Tʼááłáhági átʼéego:Choyoołʼįįhí sl-3	Kategorio:Vikipediisto sl-3
Tʼááłáhági átʼéego:Choyoołʼįįhí et-3	Kategorio:Vikipediisto et-3
Tʼááłáhági átʼéego:Choyoołʼįįhí fr-3	Kategorio:Vikipediisto fr-3
Tʼááłáhági átʼéego:Choyoołʼįįhí ia-3	Kategorio:Vikipediisto ia-3
Tʼááłáhági átʼéego:Choyoołʼįįhí it-3	Kategorio:Vikipediisto it-3
Tʼááłáhági átʼéego:Choyoołʼįįhí ja-3	Kategorio:Vikipediisto ja-3
Tʼááłáhági átʼéego:Choyoołʼįįhí lt-3	Kategorio:Vikipediisto lt-3
Tʼááłáhági átʼéego:Choyoołʼįįhí nl-3	Kategorio:Vikipediisto nl-3
Tʼááłáhági átʼéego:Choyoołʼįįhí no-3	Kategorio:Vikipediisto no-3
Tʼááłáhági átʼéego:Choyoołʼįįhí oc-3	Kategorio:Vikipediisto oc-3
Tʼááłáhági átʼéego:Choyoołʼįįhí pl-3	Kategorio:Vikipediisto pl-3
Tʼááłáhági átʼéego:Choyoołʼįįhí sw-3	Kategorio:Vikipediisto sw-3
Tʼááłáhági átʼéego:Choyoołʼįįhí tr-3	Kategorio:Vikipediisto tr-3
Tʼááłáhági átʼéego:Choyoołʼįįhí ar-3	Kategorio:Vikipediisto ar-3
Tʼááłáhági átʼéego:Choyoołʼįįhí an-1	Kategorio:Vikipediisto an-1
Tʼááłáhági átʼéego:Choyoołʼįįhí be-1	Kategorio:Vikipediisto be-1
Tʼááłáhági átʼéego:Choyoołʼįįhí cs-1	Kategorio:Vikipediisto cs-1
Tʼááłáhági átʼéego:Choyoołʼįįhí da-1	Kategorio:Vikipediisto da-1
Tʼááłáhági átʼéego:Choyoołʼįįhí sl-1	Kategorio:Vikipediisto sl-1
Tʼááłáhági átʼéego:Choyoołʼįįhí et-1	Kategorio:Vikipediisto et-1
Tʼááłáhági átʼéego:Choyoołʼįįhí fi-1	Kategorio:Vikipediisto fi-1
Tʼááłáhági átʼéego:Choyoołʼįįhí cy-1	Kategorio:Vikipediisto cy-1
Tʼááłáhági átʼéego:Choyoołʼįįhí ia-1	Kategorio:Vikipediisto ia-1
Tʼááłáhági átʼéego:Choyoołʼįįhí ga-1	Kategorio:Vikipediisto ga-1
Tʼááłáhági átʼéego:Choyoołʼįįhí lt-1	Kategorio:Vikipediisto lt-1
Tʼááłáhági átʼéego:Choyoołʼįįhí mk-1	Kategorio:Vikipediisto mk-1
Tʼááłáhági átʼéego:Choyoołʼįįhí nl-1	Kategorio:Vikipediisto nl-1
Tʼááłáhági átʼéego:Choyoołʼįįhí oc-1	Kategorio:Vikipediisto oc-1
Tʼááłáhági átʼéego:Choyoołʼįįhí pl-1	Kategorio:Vikipediisto pl-1
Tʼááłáhági átʼéego:Choyoołʼįįhí ro-1	Kategorio:Vikipediisto ro-1
Tʼááłáhági átʼéego:Choyoołʼįįhí sc-1	Kategorio:Vikipediisto sc-1
Tʼááłáhági átʼéego:Choyoołʼįįhí sh-1	Kategorio:Vikipediisto sh-1
Tʼááłáhági átʼéego:Choyoołʼįįhí sw-1	Kategorio:Vikipediisto sw-1
Tʼááłáhági átʼéego:Choyoołʼįįhí tr-1	Kategorio:Vikipediisto tr-1
Tʼááłáhági átʼéego:Choyoołʼįįhí vo-1	Kategorio:Vikipediisto vo-1
Tʼááłáhági átʼéego:Choyoołʼįįhí ar-1	Kategorio:Vikipediisto ar-1
Tʼááłáhági átʼéego:Choyoołʼįįhí ko-4	Kategorio:Vikipediisto ko-4
Tʼááłáhági átʼéego:Choyoołʼįįhí sl-4	Kategorio:Vikipediisto sl-4
Tʼááłáhági átʼéego:Choyoołʼįįhí et-4	Kategorio:Vikipediisto et-4
Tʼááłáhági átʼéego:Choyoołʼįįhí fr-4	Kategorio:Vikipediisto fr-4
Tʼááłáhági átʼéego:Choyoołʼįįhí hu-4	Kategorio:Vikipediisto hu-4
Tʼááłáhági átʼéego:Choyoołʼįįhí id-4	Kategorio:Vikipediisto id-4
Tʼááłáhági átʼéego:Choyoołʼįįhí ia-4	Kategorio:Vikipediisto ia-4
Tʼááłáhági átʼéego:Choyoołʼįįhí it-4	Kategorio:Vikipediisto it-4
Tʼááłáhági átʼéego:Choyoołʼįįhí lt-4	Kategorio:Vikipediisto lt-4
Tʼááłáhági átʼéego:Choyoołʼįįhí oc-4	Kategorio:Vikipediisto oc-4
Tʼááłáhági átʼéego:Choyoołʼįįhí pl-4	Kategorio:Vikipediisto pl-4
Tʼááłáhági átʼéego:Choyoołʼįįhí sh-4	Kategorio:Vikipediisto sh-4
Tʼááłáhági átʼéego:Choyoołʼįįhí ar-4	Kategorio:Vikipediisto ar-4
Tʼááłáhági átʼéego:Choyoołʼįįhí be-2	Kategorio:Vikipediisto be-2
Tʼááłáhági átʼéego:Choyoołʼįįhí ce-2	Kategorio:Vikipediisto ce-2
Tʼááłáhági átʼéego:Choyoołʼįįhí cs-2	Kategorio:Vikipediisto cs-2
Tʼááłáhági átʼéego:Choyoołʼįįhí da-2	Kategorio:Vikipediisto da-2
Tʼááłáhági átʼéego:Choyoołʼįįhí sk-2	Kategorio:Vikipediisto sk-2
Tʼááłáhági átʼéego:Choyoołʼįįhí sl-2	Kategorio:Vikipediisto sl-2
Tʼááłáhági átʼéego:Choyoołʼįįhí et-2	Kategorio:Vikipediisto et-2
Tʼááłáhági átʼéego:Choyoołʼįįhí fr-2	Kategorio:Vikipediisto fr-2
Tʼááłáhági átʼéego:Choyoołʼįįhí gn-2	Kategorio:Vikipediisto gn-2
Tʼááłáhági átʼéego:Choyoołʼįįhí hu-2	Kategorio:Vikipediisto hu-2
Tʼááłáhági átʼéego:Choyoołʼįįhí ia-2	Kategorio:Vikipediisto ia-2
Tʼááłáhági átʼéego:Choyoołʼįįhí it-2	Kategorio:Vikipediisto it-2
Tʼááłáhági átʼéego:Choyoołʼįįhí ja-2	Kategorio:Vikipediisto ja-2
Tʼááłáhági átʼéego:Choyoołʼįįhí la-2	Kategorio:Vikipediisto la-2
Tʼááłáhági átʼéego:Choyoołʼįįhí lt-2	Kategorio:Vikipediisto lt-2
Tʼááłáhági átʼéego:Choyoołʼįįhí mk-2	Kategorio:Vikipediisto mk-2
Tʼááłáhági átʼéego:Choyoołʼįįhí nl-2	Kategorio:Vikipediisto nl-2
Tʼááłáhági átʼéego:Choyoołʼįįhí oc-2	Kategorio:Vikipediisto oc-2
Tʼááłáhági átʼéego:Choyoołʼįįhí pl-2	Kategorio:Vikipediisto pl-2
Tʼááłáhági átʼéego:Choyoołʼįįhí sh-2	Kategorio:Vikipediisto sh-2
Tʼááłáhági átʼéego:Choyoołʼįįhí sv-2	Kategorio:Vikipediisto sv-2
Tʼááłáhági átʼéego:Choyoołʼįįhí sw-2	Kategorio:Vikipediisto sw-2
Tʼááłáhági átʼéego:Choyoołʼįįhí tr-2	Kategorio:Vikipediisto tr-2
Tʼááłáhági átʼéego:Choyoołʼįįhí vo-2	Kategorio:Vikipediisto vo-2
Tʼááłáhági átʼéego:Choyoołʼįįhí ar-2	Kategorio:Vikipediisto ar-2
Tʼááłáhági átʼéego:Choyoołʼįįhí ast-N	Kategorio:Vikipediisto ast-D
Tʼááłáhági átʼéego:Choyoołʼįįhí cs-N	Kategorio:Vikipediisto cs-D
Tʼááłáhági átʼéego:Choyoołʼįįhí ko-N	Kategorio:Vikipediisto ko-D
Tʼááłáhági átʼéego:Choyoołʼįįhí sl-N	Kategorio:Vikipediisto sl-D
Tʼááłáhági átʼéego:Choyoołʼįįhí et-N	Kategorio:Vikipediisto et-D
Tʼááłáhági átʼéego:Choyoołʼįįhí fr-N	Kategorio:Vikipediisto fr-D
Tʼááłáhági átʼéego:Choyoołʼįįhí id-N	Kategorio:Vikipediisto id-D
Tʼááłáhági átʼéego:Choyoołʼįįhí ia-N	Kategorio:Vikipediisto ia-D
Tʼááłáhági átʼéego:Choyoołʼįįhí it-N	Kategorio:Vikipediisto it-D
Tʼááłáhági átʼéego:Choyoołʼįįhí lv-N	Kategorio:Vikipediisto lv-D
Tʼááłáhági átʼéego:Choyoołʼįįhí lt-N	Kategorio:Vikipediisto lt-D
Tʼááłáhági átʼéego:Choyoołʼįįhí mg-N	Kategorio:Vikipediisto mg-D
Tʼááłáhági átʼéego:Choyoołʼįįhí nl-N	Kategorio:Vikipediisto nl-D
Tʼááłáhági átʼéego:Choyoołʼįįhí no-N	Kategorio:Vikipediisto no-D
Tʼááłáhági átʼéego:Choyoołʼįįhí nn-N	Kategorio:Vikipediisto nn-D
Tʼááłáhági átʼéego:Choyoołʼįįhí ru-N	Kategorio:Vikipediisto ru-D
Tʼááłáhági átʼéego:Choyoołʼįįhí sh-N	Kategorio:Vikipediisto sh-D
Tʼááłáhági átʼéego:Choyoołʼįįhí ar-N	Kategorio:Vikipediisto ar-D
Tʼááłáhági átʼéego:Choyoołʼįįhí eu-N	Kategorio:Vikipediisto eu-D
Tʼááłáhági átʼéego:Choyoołʼįįhí af	Kategorio:Vikipediisto af
Tʼááłáhági átʼéego:Choyoołʼįįhí af-1	Kategorio:Vikipediisto af-1
Tʼááłáhági átʼéego:Choyoołʼįįhí af-N	Kategorio:Vikipediisto af-D
Tʼááłáhági átʼéego:Choyoołʼįįhí an	Kategorio:Vikipediisto an
Tʼááłáhági átʼéego:Choyoołʼįįhí ar	Kategorio:Vikipediisto ar
Tʼááłáhági átʼéego:Choyoołʼįįhí ast	Kategorio:Vikipediisto ast
Tʼááłáhági átʼéego:Choyoołʼįįhí ba	Kategorio:Vikipediisto ba
Tʼááłáhági átʼéego:Choyoołʼįįhí bar	Kategorio:Vikipediisto bar
Tʼááłáhági átʼéego:Choyoołʼįįhí bar-N	Kategorio:Vikipediisto bar-D
Tʼááłáhági átʼéego:Choyoołʼįįhí bg	Kategorio:Vikipediisto bg
Tʼááłáhági átʼéego:Choyoołʼįįhí bg-1	Kategorio:Vikipediisto bg-1
Tʼááłáhági átʼéego:Choyoołʼįįhí bg-2	Kategorio:Vikipediisto bg-2
Tʼááłáhági átʼéego:Choyoołʼįįhí bg-3	Kategorio:Vikipediisto bg-3
Tʼááłáhági átʼéego:Choyoołʼįįhí bg-4	Kategorio:Vikipediisto bg-4
Tʼááłáhági átʼéego:Choyoołʼįįhí bg-N	Kategorio:Vikipediisto bg-D
Tʼááłáhági átʼéego:Choyoołʼįįhí ca	Kategorio:Vikipediisto ca
Tʼááłáhági átʼéego:Choyoołʼįįhí ca-1	Kategorio:Vikipediisto ca-1
Tʼááłáhági átʼéego:Choyoołʼįįhí ca-2	Kategorio:Vikipediisto ca-2
Tʼááłáhági átʼéego:Tádídíín deiyání	Kategorio:Foliskaraboj
Tʼááłáhági átʼéego:Choyoołʼįįhí ca-3	Kategorio:Vikipediisto ca-3
Tʼááłáhági átʼéego:Choyoołʼįįhí ca-4	Kategorio:Vikipediisto ca-4
Tʼááłáhági átʼéego:Choyoołʼįįhí ca-N	Kategorio:Vikipediisto ca-D
Tʼááłáhági átʼéego:Choyoołʼįįhí ce-N	Kategorio:Vikipediisto ce-D
Tʼááłáhági átʼéego:Choyoołʼįįhí cs	Kategorio:Vikipediisto cs
Tʼááłáhági átʼéego:Choyoołʼįįhí csb	Kategorio:Vikipediisto csb
Tʼááłáhági átʼéego:Choyoołʼįįhí csb-1	Kategorio:Vikipediisto csb-1
Tʼááłáhági átʼéego:Choyoołʼįįhí da	Kategorio:Vikipediisto da
Tʼááłáhági átʼéego:Choyoołʼįįhí sk-N	Kategorio:Vikipediisto sk-D
Tʼááłáhági átʼéego:Choyoołʼįįhí da-3	Kategorio:Vikipediisto da-3
Tʼááłáhági átʼéego:Choyoołʼįįhí da-4	Kategorio:Vikipediisto da-4
Tʼááłáhági átʼéego:Choyoołʼįįhí de	Kategorio:Vikipediisto de
Tʼááłáhági átʼéego:Choyoołʼįįhí de-2	Kategorio:Vikipediisto de-2
Tʼááłáhági átʼéego:Choyoołʼįįhí de-3	Kategorio:Vikipediisto de-3
Tʼááłáhági átʼéego:Choyoołʼįįhí de-4	Kategorio:Vikipediisto de-4
Tʼááłáhági átʼéego:Choyoołʼįįhí de-N	Kategorio:Vikipediisto de-D
Tʼááłáhági átʼéego:Choyoołʼįįhí dsb	Kategorio:Vikipediisto dsb
Tʼááłáhági átʼéego:Choyoołʼįįhí dsb-1	Kategorio:Vikipediisto dsb-1
Tʼááłáhági átʼéego:Choyoołʼįįhí dsb-2	Kategorio:Vikipediisto dsb-2
Tʼááłáhági átʼéego:Choyoołʼįįhí dsb-N	Kategorio:Vikipediisto dsb-D
Tʼááłáhági átʼéego:Choyoołʼįįhí el	Kategorio:Vikipediisto el
Tʼááłáhági átʼéego:Choyoołʼįįhí el-1	Kategorio:Vikipediisto el-1
Tʼááłáhági átʼéego:Choyoołʼįįhí el-2	Kategorio:Vikipediisto el-2
Tʼááłáhági átʼéego:Choyoołʼįįhí el-3	Kategorio:Vikipediisto el-3
Tʼááłáhági átʼéego:Choyoołʼįįhí el-N	Kategorio:Vikipediisto el-D
Tʼááłáhági átʼéego:Choyoołʼįįhí en-0	Kategorio:Vikipediisto en-0
Tʼááłáhági átʼéego:Choyoołʼįįhí en-3	Kategorio:Vikipediisto en-3
Tʼááłáhági átʼéego:Choyoołʼįįhí en-5	Kategorio:Vikipediisto en-5
Tʼááłáhági átʼéego:Choyoołʼįįhí en-N	Kategorio:Vikipediisto en-D
Tʼááłáhági átʼéego:Choyoołʼįįhí eo-1	Kategorio:Vikipediisto eo-1
Tʼááłáhági átʼéego:Choyoołʼįįhí eo-2	Kategorio:Vikipediisto eo-2
Tʼááłáhági átʼéego:Choyoołʼįįhí eo-3	Kategorio:Vikipediisto eo-3
Tʼááłáhági átʼéego:Choyoołʼįįhí eo-4	Kategorio:Vikipediisto eo-4
Tʼááłáhági átʼéego:Choyoołʼįįhí eo-N	Kategorio:Vikipediisto eo-D
Tʼááłáhági átʼéego:Choyoołʼįįhí es	Kategorio:Vikipediisto es
Tʼááłáhági átʼéego:Choyoołʼįįhí es-1	Kategorio:Vikipediisto es-1
Tʼááłáhági átʼéego:Choyoołʼįįhí es-2	Kategorio:Vikipediisto es-2
Tʼááłáhági átʼéego:Choyoołʼįįhí es-3	Kategorio:Vikipediisto es-3
Tʼááłáhági átʼéego:Choyoołʼįįhí es-4	Kategorio:Vikipediisto es-4
Tʼááłáhági átʼéego:Choyoołʼįįhí es-N	Kategorio:Vikipediisto es-D
Tʼááłáhági átʼéego:Choyoołʼįįhí eu	Kategorio:Vikipediisto eu
Tʼááłáhági átʼéego:Choyoołʼįįhí eu-1	Kategorio:Vikipediisto eu-1
Tʼááłáhági átʼéego:Choyoołʼįįhí fa	Kategorio:Vikipediisto fa
Tʼááłáhági átʼéego:Choyoołʼįįhí fa-1	Kategorio:Vikipediisto fa-1
Tʼááłáhági átʼéego:Choyoołʼįįhí fa-2	Kategorio:Vikipediisto fa-2
Tʼááłáhági átʼéego:Choyoołʼįįhí fa-3	Kategorio:Vikipediisto fa-3
Tʼááłáhági átʼéego:Choyoołʼįįhí fa-N	Kategorio:Vikipediisto fa-D
Tʼááłáhági átʼéego:Choyoołʼįįhí fi	Kategorio:Vikipediisto fi
Tʼááłáhági átʼéego:Choyoołʼįįhí fi-2	Kategorio:Vikipediisto fi-2
Tʼááłáhági átʼéego:Choyoołʼįįhí fi-3	Kategorio:Vikipediisto fi-3
Tʼááłáhági átʼéego:Choyoołʼįįhí fi-4	Kategorio:Vikipediisto fi-4
Tʼááłáhági átʼéego:Choyoołʼįįhí fi-N	Kategorio:Vikipediisto fi-D
Tʼááłáhági átʼéego:Choyoołʼįįhí fy	Kategorio:Vikipediisto fy
Tʼááłáhági átʼéego:Choyoołʼįįhí fy-1	Kategorio:Vikipediisto fy-1
Tʼááłáhági átʼéego:Choyoołʼįįhí grc	Kategorio:Vikipediisto grc
Tʼááłáhági átʼéego:Choyoołʼįįhí grc-1	Kategorio:Vikipediisto grc-1
Tʼááłáhági átʼéego:Choyoołʼįįhí gsw	Kategorio:Vikipediisto gsw
Tʼááłáhági átʼéego:Choyoołʼįįhí gsw-3	Kategorio:Vikipediisto gsw-3
Tʼááłáhági átʼéego:Choyoołʼįįhí gsw-N	Kategorio:Vikipediisto gsw-D
Tʼááłáhági átʼéego:Choyoołʼįįhí he	Kategorio:Vikipediisto he
Tʼááłáhági átʼéego:Choyoołʼįįhí he-1	Kategorio:Vikipediisto he-1
Tʼááłáhági átʼéego:Choyoołʼįįhí he-2	Kategorio:Vikipediisto he-2
Tʼááłáhági átʼéego:Choyoołʼįįhí he-3	Kategorio:Vikipediisto he-3
Tʼááłáhági átʼéego:Choyoołʼįįhí he-4	Kategorio:Vikipediisto he-4
Tʼááłáhági átʼéego:Choyoołʼįįhí he-N	Kategorio:Vikipediisto he-D
Tʼááłáhági átʼéego:Choyoołʼįįhí hr-1	Kategorio:Vikipediisto hr-1
Tʼááłáhági átʼéego:Choyoołʼįįhí hsb	Kategorio:Vikipediisto hsb
Tʼááłáhági átʼéego:Choyoołʼįįhí hsb-1	Kategorio:Vikipediisto hsb-1
Tʼááłáhági átʼéego:Choyoołʼįįhí hsb-2	Kategorio:Vikipediisto hsb-2
Tʼááłáhági átʼéego:Choyoołʼįįhí hsb-3	Kategorio:Vikipediisto hsb-3
Tʼááłáhági átʼéego:Choyoołʼįįhí hu	Kategorio:Vikipediisto hu
Tʼááłáhági átʼéego:Choyoołʼįįhí hu-1	Kategorio:Vikipediisto hu-1
Tʼááłáhági átʼéego:Choyoołʼįįhí hu-3	Kategorio:Vikipediisto hu-3
Tʼááłáhági átʼéego:Choyoołʼįįhí id-1	Kategorio:Vikipediisto id-1
Tʼááłáhági átʼéego:Choyoołʼįįhí id-2	Kategorio:Vikipediisto id-2
Tʼááłáhági átʼéego:Choyoołʼįįhí id-3	Kategorio:Vikipediisto id-3
Tʼááłáhági átʼéego:Choyoołʼįįhí io	Kategorio:Vikipediisto io
Tʼááłáhági átʼéego:Choyoołʼįįhí io-1	Kategorio:Vikipediisto io-1
Tʼááłáhági átʼéego:Choyoołʼįįhí io-2	Kategorio:Vikipediisto io-2
Tʼááłáhági átʼéego:Choyoołʼįįhí is	Kategorio:Vikipediisto is
Tʼááłáhági átʼéego:Choyoołʼįįhí is-1	Kategorio:Vikipediisto is-1
Bee álnééhí:User la-3	Ŝablono:Vikipediisto la-3
Bee álnééhí:User swg-1	Ŝablono:Vikipediisto swg-1
Tʼááłáhági átʼéego:Choyoołʼįįhí pt-3	Kategorio:Vikipediisto pt-3
Tʼááłáhági átʼéego:Choyoołʼįįhí pl-N	Kategorio:Vikipediisto pl-D
Tʼááłáhági átʼéego:Choyoołʼįįhí pt-1	Kategorio:Vikipediisto pt-1
Tʼááłáhági átʼéego:Choyoołʼįįhí ka-1	Kategorio:Vikipediisto ka-1
Bee álnééhí:Hooʼááłígíí	Ŝablono:Uzanto Vikiadministranto
Tʼááłáhági átʼéego:Choyoołʼįįhí it	Kategorio:Vikipediisto it
Tʼááłáhági átʼéego:Choyoołʼįįhí it-1	Kategorio:Vikipediisto it-1
Tʼááłáhági átʼéego:Choyoołʼįįhí ja-1	Kategorio:Vikipediisto ja-1
Tʼááłáhági átʼéego:Choyoołʼįįhí ka	Kategorio:Vikipediisto ka
Tʼááłáhági átʼéego:Choyoołʼįįhí ka-N	Kategorio:Vikipediisto ka-D
Tʼááłáhági átʼéego:Choyoołʼįįhí ko	Kategorio:Vikipediisto ko
Tʼááłáhági átʼéego:Wááshindoon bikéyah bił haʼdaʼhaasdzoígíí	Kategorio:Usonaj ŝtatoj
Tʼááłáhági átʼéego:Choyoołʼįįhí ko-1	Kategorio:Vikipediisto ko-1
Tʼááłáhági átʼéego:Choyoołʼįįhí ko-2	Kategorio:Vikipediisto ko-2
Tʼááłáhági átʼéego:Choyoołʼįįhí ko-3	Kategorio:Vikipediisto ko-3
Tʼááłáhági átʼéego:Choyoołʼįįhí ksh	Kategorio:Vikipediisto ksh
Tʼááłáhági átʼéego:Choyoołʼįįhí ksh-N	Kategorio:Vikipediisto ksh-D
Tʼááłáhági átʼéego:Choyoołʼįįhí la-1	Kategorio:Vikipediisto la-1
Tʼááłáhági átʼéego:Choyoołʼįįhí la-3	Kategorio:Vikipediisto la-3
Tʼááłáhági átʼéego:Choyoołʼįįhí nn-2	Kategorio:Vikipediisto nn-2
Tʼááłáhági átʼéego:Choyoołʼįįhí ru-1	Kategorio:Vikipediisto ru-1
Yaaʼ bijáád hastánígíí	Laŭso
Bee álnééhí:User sv-1	Ŝablono:Vikipediisto sv-1
Tʼááłáhági átʼéego:Choyoołʼįįhí lv	Kategorio:Vikipediisto lv
Tsiiʼyiishbizhí dinéʼiʼ	Ĉinoj
Bee álnééhí:User jv	Ŝablono:Vikipediisto jv
Bee álnééhí:User id	Ŝablono:Vikipediisto id
Tʼááłáhági átʼéego:Choyoołʼįįhí nds	Kategorio:Vikipediisto nds
Tʼááłáhági átʼéego:Choyoołʼįįhí nds-1	Kategorio:Vikipediisto nds-1
Tʼááłáhági átʼéego:Choyoołʼįįhí nds-2	Kategorio:Vikipediisto nds-2
Tʼááłáhági átʼéego:Choyoołʼįįhí nds-nl	Kategorio:Vikipediisto nds-NL
Bee álnééhí:User oc-1	Ŝablono:Vikipediisto oc-1
Tʼááłáhági átʼéego:Choyoołʼįįhí es-5	Kategorio:Vikipediisto es-5
Tʼááłáhági átʼéego:Kéyah Ałhidadiidzooígíí dóó Ahiih Yikaígíí	Kategorio:Internaciaj organizaĵoj
Tʼááłáhági átʼéego:Chʼosh bijáád dahólónígíí	Kategorio:Artropodoj
Tʼááłáhági átʼéego:Tó	Kategorio:Akvo
Tʼááłáhági átʼéego:Bidił daazdoígíí dóó daʼalghałígíí	Kategorio:Karnomanĝuloj
Tʼááłáhági átʼéego:Choyoołʼįįhí nn-1	Kategorio:Vikipediisto nn-1
Bee álnééhí:User sw-1	Ŝablono:Vikipediisto sw-1
Bee álnééhí:User ka-1	Ŝablono:Vikipediisto ka-1
Bee álnééhí:User af	Ŝablono:Vikipediisto af
Tʼááłáhági átʼéego:Naakaii Łizhiní Bikéyah	Kategorio:Afrikaj landoj
Bee álnééhí:User ka-3	Ŝablono:Vikipediisto ka-3
Bee álnééhí:User da-3	Ŝablono:Vikipediisto da-3
Bee álnééhí:User pt-4	Ŝablono:Vikipediisto pt-4
Bee álnééhí:User ka-4	Ŝablono:Vikipediisto ka-4
Bee álnééhí:User ja-2	Ŝablono:Vikipediisto ja-2
Bee álnééhí:User ko-1	Ŝablono:Vikipediisto ko-1
Bee álnééhí:User ru-2	Ŝablono:Vikipediisto ru-2
Bee álnééhí:User es-3	Ŝablono:Vikipediisto es-3
Bee álnééhí:User ja-3	Ŝablono:Vikipediisto ja-3
Bee álnééhí:User eu-1	Ŝablono:Vikipediisto eu-1
Bee álnééhí:User ko-3	Ŝablono:Vikipediisto ko-3
Tʼááłáhági átʼéego:Tsin bineestʼąʼ dadíkʼǫ́zhígíí	Kategorio:Citruso
Tʼááłáhági átʼéego:Choyoołʼįįhí pt-2	Kategorio:Vikipediisto pt-2
Tʼááłáhági átʼéego:Choyoołʼįįhí pt-4	Kategorio:Vikipediisto pt-4
Tʼááłáhági átʼéego:Choyoołʼįįhí pt-N	Kategorio:Vikipediisto pt-D
Tʼááłáhági átʼéego:Choyoołʼįįhí ro-2	Kategorio:Vikipediisto ro-2
Tʼááłáhági átʼéego:Choyoołʼįįhí ro-3	Kategorio:Vikipediisto ro-3
Tʼááłáhági átʼéego:Choyoołʼįįhí ro-N	Kategorio:Vikipediisto ro-D
Tʼááłáhági átʼéego:Choyoołʼįįhí ru	Kategorio:Vikipediisto ru
Tʼááłáhági átʼéego:Choyoołʼįįhí ru-2	Kategorio:Vikipediisto ru-2
Tʼááłáhági átʼéego:Choyoołʼįįhí ru-3	Kategorio:Vikipediisto ru-3
Tʼááłáhági átʼéego:Choyoołʼįįhí ru-4	Kategorio:Vikipediisto ru-4
Tʼááłáhági átʼéego:Choyoołʼįįhí sk-1	Kategorio:Vikipediisto sk-1
Tʼááłáhági átʼéego:Choyoołʼįįhí sk-3	Kategorio:Vikipediisto sk-3
Tʼááłáhági átʼéego:Choyoołʼįįhí sk-4	Kategorio:Vikipediisto sk-4
Tʼááłáhági átʼéego:Choyoołʼįįhí sr	Kategorio:Vikipediisto sr
Tʼááłáhági átʼéego:Choyoołʼįįhí sr-1	Kategorio:Vikipediisto sr-1
Tʼááłáhági átʼéego:Choyoołʼįįhí sr-2	Kategorio:Vikipediisto sr-2
Tʼááłáhági átʼéego:Choyoołʼįįhí sr-3	Kategorio:Vikipediisto sr-3
Tʼááłáhági átʼéego:Choyoołʼįįhí sr-4	Kategorio:Vikipediisto sr-4
Tʼááłáhági átʼéego:Choyoołʼįįhí sr-N	Kategorio:Vikipediisto sr-D
Tʼááłáhági átʼéego:Choyoołʼįįhí sv-1	Kategorio:Vikipediisto sv-1
Tʼááłáhági átʼéego:Choyoołʼįįhí sv-3	Kategorio:Vikipediisto sv-3
Tʼááłáhági átʼéego:Choyoołʼįįhí sv-4	Kategorio:Vikipediisto sv-4
Tʼááłáhági átʼéego:Choyoołʼįįhí sv-N	Kategorio:Vikipediisto sv-D
Tʼááłáhági átʼéego:Choyoołʼįįhí th-N	Kategorio:Vikipediisto th-D
Tʼááłáhági átʼéego:Choyoołʼįįhí tr	Kategorio:Vikipediisto tr
Tʼááłáhági átʼéego:Choyoołʼįįhí tr-N	Kategorio:Vikipediisto tr-D
Tʼááłáhági átʼéego:Choyoołʼįįhí tt	Kategorio:Vikipediisto tt
Tʼááłáhági átʼéego:Choyoołʼįįhí tt-3	Kategorio:Vikipediisto tt-3
Tʼááłáhági átʼéego:Choyoołʼįįhí uk-1	Kategorio:Vikipediisto uk-1
Tʼááłáhági átʼéego:Choyoołʼįįhí uk-2	Kategorio:Vikipediisto uk-2
Tʼááłáhági átʼéego:Choyoołʼįįhí uk-3	Kategorio:Vikipediisto uk-3
Tʼááłáhági átʼéego:Choyoołʼįįhí uk-4	Kategorio:Vikipediisto uk-4
Tʼááłáhági átʼéego:Choyoołʼįįhí vi	Kategorio:Vikipediisto vi
Tʼááłáhági átʼéego:Choyoołʼįįhí vi-N	Kategorio:Vikipediisto vi-D
Bee álnééhí:User ro-1	Ŝablono:Vikipediisto ro-1
Tʼááłáhági átʼéego:Tsin ííʼáhígíí	Kategorio:Arboj
Bee álnééhí:User ca	Ŝablono:Vikipediisto ca
Tʼááłáhági átʼéego:Mágí: Diné Ndahalinígíí	Kategorio:Homoideoj
Tʼááłáhági átʼéego:Mágí	Kategorio:Primatoj
Bee álnééhí:User sv-3	Ŝablono:Vikipediisto sv-3
Bee álnééhí:User hy-1	Ŝablono:Vikipediisto hy-1
Bee álnééhí:User hsb-1	Ŝablono:Vikipediisto hsb-1
Bee álnééhí:User hsb	Ŝablono:Vikipediisto hsb
Tʼááłáhági átʼéego:Naʼiiniʼ	Kategorio:Komerco
Bee álnééhí:User hsb-2	Ŝablono:Vikipediisto hsb-2
Bee álnééhí:User af-3	Ŝablono:Vikipediisto af-3
Tʼááłáhági átʼéego:Naaki góneʼ yéigo daʼahijoogą́ą́ʼ	Kategorio:Dua mondmilito
Tʼááłáhági átʼéego:Mósí dóó Náshdóí	Kategorio:Felisedoj
Bee álnééhí:User ar-4	Ŝablono:Vikipediisto ar-4
Bee álnééhí:User be	Ŝablono:Vikipediisto be
Bee álnééhí:User ca-2	Ŝablono:Vikipediisto ca-2
Bee álnééhí:User ca-3	Ŝablono:Vikipediisto ca-3
Bee álnééhí:User cs-3	Ŝablono:Vikipediisto cs-3
Bee álnééhí:User da-4	Ŝablono:Vikipediisto da-4
Bee álnééhí:User el-2	Ŝablono:Vikipediisto el-2
Bee álnééhí:User et-3	Ŝablono:Vikipediisto et-3
Bee álnééhí:User fa-2	Ŝablono:Vikipediisto fa-2
Bee álnééhí:User fa-3	Ŝablono:Vikipediisto fa-3
Bee álnééhí:User fa-4	Ŝablono:Vikipediisto fa-4
Bee álnééhí:User fi-2	Ŝablono:Vikipediisto fi-2
Bee álnééhí:User fi-3	Ŝablono:Vikipediisto fi-3
Bee álnééhí:User he-3	Ŝablono:Vikipediisto he-3
Bee álnééhí:User he-4	Ŝablono:Vikipediisto he-4
Bee álnééhí:User ka	Ŝablono:Vikipediisto ka
Bee álnééhí:User ko	Ŝablono:Vikipediisto ko-D
Bee álnééhí:User li-1	Ŝablono:Vikipediisto li-1
Bee álnééhí:User li-3	Ŝablono:Vikipediisto li-3
Bee álnééhí:User mk-1	Ŝablono:Vikipediisto mk-1
Bee álnééhí:User nn-2	Ŝablono:Vikipediisto nn-2
Bee álnééhí:User no-1	Ŝablono:Vikipediisto no-1
Bee álnééhí:User pl-2	Ŝablono:Vikipediisto pl-2
Bee álnééhí:User pt	Ŝablono:Vikipediisto pt
Bee álnééhí:User ro-2	Ŝablono:Vikipediisto ro-2
Bee álnééhí:User ru-1	Ŝablono:Vikipediisto ru-1
Bee álnééhí:User sk-1	Ŝablono:Vikipediisto sk-1
Bee álnééhí:User sk-2	Ŝablono:Vikipediisto sk-2
Bee álnééhí:User sr-1	Ŝablono:Vikipediisto sr-1
Bee álnééhí:User tr-1	Ŝablono:Vikipediisto tr-1
Bee álnééhí:User tr-3	Ŝablono:Vikipediisto tr-3
Bee álnééhí:User uk-1	Ŝablono:Vikipediisto uk-1
Bee álnééhí:User uk-4	Ŝablono:Vikipediisto uk-4
Bee álnééhí:User zh-1	Ŝablono:Vikipediisto zh-1
Bee álnééhí:User zh-2	Ŝablono:Vikipediisto zh-2
Bee álnééhí:User zh-3	Ŝablono:Vikipediisto zh-3
Bee álnééhí:User zh-4	Ŝablono:Vikipediisto zh-4
Tʼááłáhági átʼéego:Naakaii Łizhiní Bikéyahdę́ę́ʼ Ndaaldeehii	Kategorio:Faŭno de Afriko
Tʼááłáhági átʼéego:Choyoołʼįįhí nl	Kategorio:Vikipediisto nl
Tʼááłáhági átʼéego:Choyoołʼįįhí nn-3	Kategorio:Vikipediisto nn-3
Tʼááłáhági átʼéego:Choyoołʼįįhí no-1	Kategorio:Vikipediisto no-1
Tʼááłáhági átʼéego:Choyoołʼįįhí no-2	Kategorio:Vikipediisto no-2
Tʼááłáhági átʼéego:Choyoołʼįįhí no	Kategorio:Vikipediisto no
Tʼááłáhági átʼéego:Choyoołʼįįhí nds-nl-1	Kategorio:Vikipediisto nds-NL-1
Tʼááłáhági átʼéego:Choyoołʼįįhí zh-1	Kategorio:Vikipediisto zh-1
Tʼááłáhági átʼéego:Choyoołʼįįhí zh-4	Kategorio:Vikipediisto zh-4
Tʼááłáhági átʼéego:Choyoołʼįįhí zh-3	Kategorio:Vikipediisto zh-3
Tʼááłáhági átʼéego:Choyoołʼįįhí zh-2	Kategorio:Vikipediisto zh-2
Tʼááłáhági átʼéego:Chʼał	Kategorio:Anuroj
Tʼááłáhági átʼéego:Mąʼii yił Ałhidanoolinígíí Yázhí	Kategorio:Procionedoj
Tʼááłáhági átʼéego:Dlǫ́ʼiitsoh Danilínígíí	Kategorio:Viveredoj
Tʼááłáhági átʼéego:Chéłchaaʼ	Kategorio:Skaraboj
Tʼááłáhági átʼéego:Naakáí dootłʼizhí dóó Bééshbichʼahii dabizaad ndahalinígíí	Kategorio:Hindeŭropa lingvaro
Tʼááłáhági átʼéego:Hazéí	Kategorio:Sciuredoj
Tʼááłáhági átʼéego:Chidí naatʼaʼí ńdinibįįhígi	Kategorio:Flughavenoj
Tʼááłáhági átʼéego:Áʼádaatʼéhígíí	Kategorio:Kemiaj elementoj
Bee álnééhí:User pfl-1	Ŝablono:Vikipediisto pfl-1
Bee álnééhí:User gsw-3	Ŝablono:Vikipediisto gsw-3
Bee álnééhí:User de-4	Ŝablono:Vikipediisto de-4
Tʼááłáhági átʼéego:Abeʼ bitsʼą́ą́dóó ádaalyaaígíí	Kategorio:Laktaĵoj
Tʼááłáhági átʼéego:Tsin dóó chʼil bineestʼąʼ	Kategorio:Fruktoj
Tʼááłáhági átʼéego:Kʼaalógii dóó Iichʼąhii	Kategorio:Papilioj
Tʼááłáhági átʼéego:Chʼosh bijáád ádaadinígíí	Kategorio:Moluskoj
Tʼááłáhági átʼéego:Deeteel Bikéyah bił haʼdaʼhaasdzoígíí	Kategorio:Kanadaj provincoj
Tʼááłáhági átʼéego:Gáagii dóó Joogii Ndahalinígíí	Kategorio:Korvedoj
Tʼááłáhági átʼéego:Mąʼii dóó Łééchąąʼí	Kategorio:Kanisedoj
Tʼááłáhági átʼéego:Ayání dóó Béégashii	Kategorio:Bovenoj
Tʼááłáhági átʼéego:Tó Wónaanídę́ę́ʼ Mágí	Kategorio:Cerkopitekedoj
Tʼááłáhági átʼéego:Naayízí dóó taʼneeskʼání	Kategorio:Kukurbacoj
Tʼááłáhági átʼéego:Dlǫ́ʼii Ndahalinígíí	Kategorio:Musteledoj
Tʼááłáhági átʼéego:Naaldeehii	Kategorio:Bestoj
Tʼááłáhági átʼéego:Shádiʼááhdę́ę́ʼ Ndaaldeehii	Kategorio:Faŭno de Sudameriko
Tʼááłáhági átʼéego:Bizaʼazis Dahólónígíí	Kategorio:Marsupiuloj
Tʼááłáhági átʼéego:Chʼosh chʼééh diikáhii	Kategorio:Gastropodoj
Tʼááłáhági átʼéego:Gah	Kategorio:Leporuloj
Tʼááłáhági átʼéego:Łóóʼtsoh dóó Tééh hóyáanii	Kategorio:Cetacoj
Bee álnééhí:User fy-1	Ŝablono:Vikipediisto fy-1
Bee álnééhí:User id-4	Ŝablono:Vikipediisto id-4
Bee álnééhí:User uk-3	Ŝablono:Vikipediisto uk-3
Tʼááłáhági átʼéego:Eʼeʼaahjí Tónteel bikáaʼgi Kéyah dah Ndaaʼeełígíí	Kategorio:Insuloj en la Pacifika Oceano
Tʼááłáhági átʼéego:Łóóʼ Bigaan Dahólónígíí	Kategorio:Kapopieduloj
Tʼááłáhági átʼéego:Chʼééh digháhii dóó Tsisteeł	Kategorio:Testudoj
Tʼááłáhági átʼéego:Béésh	Kategorio:Metaloj
Tʼááłáhági átʼéego:Naayééʼ	Kategorio:Dinosaŭroj
Tʼááłáhági átʼéego:Choyoołʼįįhí pl	Kategorio:Vikipediisto pl
Tʼááłáhági átʼéego:Jaaʼabaní	Kategorio:Kiropteroj
Tʼááłáhági átʼéego:Tłʼiish	Kategorio:Serpentoj
Tʼááłáhági átʼéego:Shádiʼááhjí kéyah yistinígíí	Kategorio:Antarkto
Tʼááłáhági átʼéego:Beʼekʼid	Kategorio:Lagoj
Tʼááłáhági átʼéego:Bįįh	Kategorio:Cervedoj
Bee álnééhí:User sw-3	Ŝablono:Vikipediisto sw-3
Tʼááłáhági átʼéego:Łóóʼ hashkéhé	Kategorio:Ŝarkoj
Tʼááłáhági átʼéego:Łóóʼ ooshgę́ęzhii	Kategorio:Kartilagaj fiŝoj
Bee álnééhí:User hsb-3	Ŝablono:Vikipediisto hsb-3
Tʼááłáhági átʼéego:Chidí	Kategorio:Aŭtomobiloj
Bee álnééhí:User ga-1	Ŝablono:Vikipediisto ga-1
Bee álnééhí:User af-2	Ŝablono:Vikipediisto af-2
Chąąshtʼezhiitsoh	Karoto
Tʼááłáhági átʼéego:Kéyah bił haʼdaʼhaasdzoígíí	Kategorio:Subnaciaj unuoj
Tséyooʼáałii	Kurkulio
Tʼááłáhági átʼéego:Łį́į́ʼ Ndahalinígíí	Kategorio:Ekvedoj
Tʼááłáhági átʼéego:Wóʼatsʼǫǫsii Ádaatʼéhígíí	Kategorio:Hemipteroj
Tʼááłáhági átʼéego:Tsin Deigházhígíí	Kategorio:Ronĝuloj
Bee álnééhí:User sl-1	Ŝablono:Vikipediisto sl-1
Bee álnééhí:User pl-3	Ŝablono:Vikipediisto pl-3
Bee álnééhí:User pl-4	Ŝablono:Vikipediisto pl-4
Bee álnééhí:User an-1	Ŝablono:Vikipediisto an-1
Bee álnééhí:User yue-2	Ŝablono:Vikipediisto zh-yue-2
Bee álnééhí:User wep-1	Ŝablono:Vikipediisto wep-1
Bee álnééhí:User vo-2	Ŝablono:Vikipediisto vo-2
Bee álnééhí:User vi-2	Ŝablono:Vikipediisto vi-2
Bee álnééhí:User stq-1	Ŝablono:Vikipediisto stq-1
Bee álnééhí:User sr-3	Ŝablono:Vikipediisto sr-3
Bee álnééhí:User sh-4	Ŝablono:Vikipediisto sh-4
Bee álnééhí:User sa-3	Ŝablono:Vikipediisto sa-3
Bee álnééhí:User oc-3	Ŝablono:Vikipediisto oc-3
Bee álnééhí:User oc-2	Ŝablono:Vikipediisto oc-2
Bee álnééhí:User nah-2	Ŝablono:Vikipediisto nah-2
Bee álnééhí:User mk-3	Ŝablono:Vikipediisto mk-3
Bee álnééhí:User mk-2	Ŝablono:Vikipediisto mk-2
Bee álnééhí:User mg	Ŝablono:Vikipediisto mg
Bee álnééhí:User lv-1	Ŝablono:Vikipediisto lv-1
Bee álnééhí:User lt-4	Ŝablono:Vikipediisto lt-4
Bee álnééhí:User lt-3	Ŝablono:Vikipediisto lt-3
Bee álnééhí:User lt-1	Ŝablono:Vikipediisto lt-1
Bee álnééhí:User li-2	Ŝablono:Vikipediisto li-2
Bee álnééhí:User la-4	Ŝablono:Vikipediisto la-4
Bee álnééhí:User ka-2	Ŝablono:Vikipediisto ka-2
Bee álnééhí:User it-4	Ŝablono:Vikipediisto it-4
Bee álnééhí:User is-4	Ŝablono:Vikipediisto is-4
Bee álnééhí:User is-3	Ŝablono:Vikipediisto is-3
Bee álnééhí:User io-2	Ŝablono:Vikipediisto io-2
Bee álnééhí:User io-1	Ŝablono:Vikipediisto io-1
Bee álnééhí:User id-2	Ŝablono:Vikipediisto id-2
Bee álnééhí:User ia-4	Ŝablono:Vikipediisto ia-4
Bee álnééhí:User ia-3	Ŝablono:Vikipediisto ia-3
Bee álnééhí:User ia-1	Ŝablono:Vikipediisto ia-1
Bee álnééhí:User ia	Ŝablono:Vikipediisto ia
Bee álnééhí:User et	Ŝablono:Vikipediisto et
Bee álnééhí:User el-4	Ŝablono:Vikipediisto el-4
Bee álnééhí:User el-3	Ŝablono:Vikipediisto el-3
Bee álnééhí:User dsb-2	Ŝablono:Vikipediisto dsb-2
Bee álnééhí:User dsb	Ŝablono:Vikipediisto dsb
Bee álnééhí:User cy-1	Ŝablono:Vikipediisto cy-1
Bee álnééhí:User cs-4	Ŝablono:Vikipediisto cs-4
Bee álnééhí:User bg-4	Ŝablono:Vikipediisto bg-4
Bee álnééhí:User bg-3	Ŝablono:Vikipediisto bg-3
Bee álnééhí:User bg-2	Ŝablono:Vikipediisto bg-2
Bee álnééhí:User be-1	Ŝablono:Vikipediisto be-1
Bee álnééhí:User mg-4	Ŝablono:Vikipediisto mg-4
Bee álnééhí:User ast	Ŝablono:Vikipediisto ast
Bee álnééhí:User ro-3	Ŝablono:Vikipediisto ro-3
Bee álnééhí:User sli-1	Ŝablono:Vikipediisto sli-1
Tʼááłáhági átʼéego:Chʼosh Deildeełii	Kategorio:Insektomanĝuloj
Tʼááłáhági átʼéego:Tábąąstííntsoh	Kategorio:Fokuloj
Tʼááłáhági átʼéego:Táłkáaʼgi Tsídii	Kategorio:Anseroformaj
Tʼááłáhági átʼéego:Chʼosh bijáád tseebíhígíí	Kategorio:Araneedoj
Tʼááłáhági átʼéego:Yágháhonikáánji biłnaaztʼiʼígíí	Kategorio:Kosmoesploro
Tʼááłáhági átʼéego:Shash	Kategorio:Ursedoj
Tʼááłáhági átʼéego:Tsin deiłkaałii	Kategorio:Pegedoj
Tʼááłáhági átʼéego:Chʼosh bijáád neeznánígíí	Kategorio:Decapoda
Tʼááłáhági átʼéego:Bílaʼashdlaʼii bilį́į́ʼ danilínígíí	Kategorio:Dombestoj
Tʼááłáhági átʼéego:Dziil / Atsiniltłʼish álʼį́	Kategorio:Energio
Tʼááłáhági átʼéego:Shádiʼááh biyaadi dóó Kéyah Yistinígíí bikáaʼgi Ndaaldeehii	Kategorio:Faŭno de Antarkto
Tʼááłáhági átʼéego:Nahatʼeʼiitsoh Bikéyahdę́ę́ʼ Ndaaldeehii	Kategorio:Faŭno de Aŭstralio
Tʼááłáhági átʼéego:Tsʼíʼii dóó Tséʼédǫ́ʼii	Kategorio:Dipteroj
Tʼááłáhági átʼéego:Tązhii dóó Naaʼahóóhai Ndahalinígíí	Kategorio:Kokoformaj
Tʼááłáhági átʼéego:Tééh łééchąąʼí	Kategorio:Hienedoj
Tʼááłáhági átʼéego:Kǫʼ naʼałbąąsii ninádaaltłiʼígi	Kategorio:Fervojaj stacioj
Tʼááłáhági átʼéego:Daʼałtʼoʼígíí biyęęzhii deiłchíhígíí	Kategorio:Monotremoj
Tʼááłáhági átʼéego:Nahachagii dóó Nahakʼízii	Kategorio:Ortopteroj
Tʼááłáhági átʼéego:Chéłchaaʼ bigaantéłígíí	Kategorio:Skarabedoj
Tʼááłáhági átʼéego:Tábąąsdísí	Kategorio:Skolopedoj
Tʼááłáhági átʼéego:Séigoʼ	Kategorio:Skorpioj
Tʼááłáhági átʼéego:Tsin naaʼeeł	Kategorio:Ŝipoj
Tʼááłáhági átʼéego:Naʼashjéʼii	Kategorio:Araneoj
Tʼááłáhági átʼéego:Jááłánii	Kategorio:Miriapodoj
Tʼááłáhági átʼéego:Bisóodi	Kategorio:Suedoj
Tʼááłáhági átʼéego:Choyoołʼįįhí ba-N	Kategorio:Vikipediisto ba-D
Tʼááłáhági átʼéego:Choyoołʼįįhí dsb-3	Kategorio:Vikipediisto dsb-3
Tʼááłáhági átʼéego:Choyoołʼįįhí dsb-4	Kategorio:Vikipediisto dsb-4
Tʼááłáhági átʼéego:Choyoołʼįįhí hsb-4	Kategorio:Vikipediisto hsb-4
Tʼááłáhági átʼéego:Choyoołʼįįhí nn-4	Kategorio:Vikipediisto nn-4
Tʼááłáhági átʼéego:Choyoołʼįįhí no-4	Kategorio:Vikipediisto no-4
Tʼááłáhági átʼéego:Azeeʼ	Kategorio:Kuracplantoj
Tʼááłáhági átʼéego:Choyoołʼįįhí nl-4	Kategorio:Vikipediisto nl-4
Tʼááłáhági átʼéego:Naʼastsʼǫǫsí dóó Łéʼétsoh	Kategorio:Musedoj
Bee álnééhí:User cs-2	Ŝablono:Vikipediisto cs-2
Bee álnééhí:Image label begin	Ŝablono:Marko sur bildo komenco
Tʼááłáhági átʼéego:Yootó Hahoodzodi kin naaznilígíí	Kategorio:Urboj de Nov-Meksiko
Tʼááłáhági átʼéego:Choyoołʼįįhí hsb-N	Kategorio:Vikipediisto hsb-D
Tʼááłáhági átʼéego:Choyoołʼįįhí fa-4	Kategorio:Vikipediisto fa-4
Tʼááłáhági átʼéego:Choyoołʼįįhí mg-1	Kategorio:Vikipediisto mg-1
Tʼááłáhági átʼéego:Choyoołʼįįhí mg-2	Kategorio:Vikipediisto mg-2
Tʼááłáhági átʼéego:Choyoołʼįįhí mg-3	Kategorio:Vikipediisto mg-3
Tʼááłáhági átʼéego:Choyoołʼįįhí mg-4	Kategorio:Vikipediisto mg-4
Tʼááłáhági átʼéego:Biishchʼid Dahólónígíí	Kategorio:Placentuloj
Bee álnééhí:User nn-3	Ŝablono:Vikipediisto nn-3
Bee álnééhí:User vi	Ŝablono:User vi
Tʼááłáhági átʼéego:Choyoołʼįįhí en-1	Kategorio:Vikipediisto en-1
Tʼááłáhági átʼéego:Choyoołʼįįhí de-1	Kategorio:Vikipediisto de-1
Tʼááłáhági átʼéego:Choyoołʼįįhí da-N	Kategorio:Vikipediisto da-D
Tʼááłáhági átʼéego:Choyoołʼįįhí or	Kategorio:Vikipediisto or
Yaaʼ bijáád tseebíhígíí	Iksodo
Bee álnééhí:User vls-1	Ŝablono:Vikipediisto vls-1
Bee álnééhí:User nl-4	Ŝablono:Vikipediisto nl-4
Bee álnééhí:User no-4	Ŝablono:Vikipediisto no-4
Bee álnééhí:User nn-1	Ŝablono:Vikipediisto nn-1
Bee álnééhí:User lt-2	Ŝablono:Vikipediisto lt-2
Bee álnééhí:User ru-3	Ŝablono:Vikipediisto ru-3
Bee álnééhí:User nl-3	Ŝablono:Vikipediisto nl-3
Bee álnééhí:User nn	Ŝablono:Vikipediisto nn
Bee álnééhí:User hsb-4	Ŝablono:Vikipediisto hsb-4
Bee álnééhí:User dsb-1	Ŝablono:Vikipediisto dsb-1
Bee álnééhí:User sv-4	Ŝablono:Vikipediisto sv-4
Bee álnééhí:User dsb-3	Ŝablono:Vikipediisto dsb-3
Bee álnééhí:User nds-nl-1	Ŝablono:Vikipediisto nds-NL-1
Bee álnééhí:User ba	Ŝablono:Vikipediisto ba
Bee álnééhí:User sh-2	Ŝablono:Vikipediisto sh-2
Bee álnééhí:User mg-3	Ŝablono:Vikipediisto mg-3
Bee álnééhí:User dsb-4	Ŝablono:Vikipediisto dsb-4
Bee álnééhí:User mg-2	Ŝablono:Vikipediisto mg-2
Bee álnééhí:User gsw-4	Ŝablono:Vikipediisto gsw-4
Bee álnééhí:User mg-1	Ŝablono:Vikipediisto mg-1
Bee álnééhí:User id-1	Ŝablono:Vikipediisto id-1
Kʼaalógii	Rhopalocera
Akétłʼóól łichxííʼí yázhí	Kultiva rafano
Bee álnééhí:User gsw-2	Ŝablono:Vikipediisto gsw-2
Special:RecentChanges	Specialaĵo:Lastaj ŝanĝoj
Tʼááłáhági átʼéego:Choyoołʼįįhí ja-4	Kategorio:Vikipediisto ja-4
