阿非利加洲	Afriko
日本	Japanio
挪威	Norvegio
英格蘭	Anglio
蘇格蘭	Skotlando
愛爾蘭共和國	Irlando
匈牙利	Hungario
西班牙	Hispanio
美國	Usono
比利時	Belgio
盧森堡	Luksemburgo (lando)
宇宙	Universo
坤輿	Tero
死	Morto
人	Homo
華盛頓	George Washington
芬蘭	Finnlando
瑞典	Svedio
丹麥	Danio
波蘭	Pollando
立陶宛	Litovio
義大利	Italio
瑞士	Svislando
奧地利	Aŭstrio
希臘共和國	Grekio
土耳其	Turkio
啤酒	Biero
葡萄牙	Portugalio
歐羅巴洲	Eŭropo
亞細亞洲	Azio
南極洲	Antarkto
維基大典	Vikipedio
荷蘭	Nederlando
紐約市	Novjorko
華盛頓哥倫比亞特區	Vaŝingtono
柏林	Berlino
電腦	Komputilo
共筆臺	MediaVikio
倫敦	Londono
巴黎	Parizo
安卓	Android
谷歌	Google
墨西哥	Meksiko
太平洋	Pacifika Oceano
熒惑	Marso
衣索比亞	Etiopio
迦納	Ganao
法國	Francio
世界語	Esperanto
犬	Hundo
英國	Unuiĝinta Reĝlando
貓	Hejma kato
中華人民共和國	Ĉina Popola Respubliko
法蘭西語	Franca lingvo
維基爾雅	Vikivortaro
乙醇	Etanolo
巴西	Brazilo
醇	Alkoholo
俄羅斯	Rusio
光導纖維	Optika fibro
正方形	Kvadrato (geometrio)
圓周率	Pi (nombro)
共筆	Vikio
魁北克	Kebekio
維基媒體基金會	Fondaĵo Vikimedio
威霽彌	Jimmy Wales
德國	Germanio
白俄羅斯	Belorusio
德語	Germana lingvo
冰島	Islando
愛沙尼亞	Estonio
鎮星	Saturno (planedo)
飛機	Aviadilo
一	1 (nombro)
二	2 (nombro)
三	3 (nombro)
〇	Nulo
無限	Senfineco
拉脫維亞	Latvio
烏克蘭	Ukrainio
捷克	Ĉeĥio
斯洛伐克	Slovakio
羅馬尼亞	Rumanio
保加利亞	Bulgario
羅馬	Romo
馬其頓	Respubliko Makedonio
格陵蘭	Gronlando
哈薩克	Kazaĥio
古巴	Kubo
印度尼西亞	Indonezio
莫扎特	Wolfgang Amadeus Mozart
貝多芬	Ludwig van Beethoven
南非	Sud-Afriko
商博良	Jean-François Champollion
阿爾及利亞	Alĝerio
水	Akvo
電視	Televido
智利	Ĉilio
耶穌	Jesuo Kristo
伽利略	Galilejo
辰星	Merkuro (planedo)
史	Historio
蘋果公司	Apple
太白	Venuso (planedo)
語言	Lingvo
愛	Amo
歲星	Jupitero (planedo)
銀河	Lakta vojo
大霹靂	Praeksplodo
天王星	Urano (planedo)
英文維基大典	Anglalingva Vikipedio
海王星	Neptuno (planedo)
新加坡	Singapuro
格致	Scienco
冥王星	Plutono
列支敦士登	Liĥtenŝtejno
希特勒	Adolf Hitler
臉書	Facebook
第一次世界大戰	Unua mondmilito
第二次世界大戰	Dua mondmilito
烏邦土	Ubuntu (linukso)
數學	Matematiko
拉丁語	Latina lingvo
巴林	Barejno
塞爾維亞	Serbio
月	Luno
澳大利亞	Aŭstralio
物理	Fiziko
阿根廷	Argentino
秘魯	Peruo
生物學	Biologio
朝鮮民主主義人民共和國	Nord-Koreio
柬埔寨	Kamboĝo
古蘭經	Korano
恐龍	Dinosaŭro
回教	Islamo
大英百科	Encyclopaedia Britannica
歐羅巴聯盟	Eŭropa Unio
朋友	Amikeco
馬里亞納海溝	Mariana Fosego
珠穆朗瑪峰	Ĉomolungmo
拿破崙一世	Napoleono Bonaparte
恆星	Stelo
日	Suno
巴斯特	Louis Pasteur
光年	Lumjaro
大洋洲	Oceanio
太陽系	Sunsistemo
氫	Hidrogeno
氦	Heliumo
維基共享	Vikimedia Komunejo
鋰	Litio
鈹	Berilio
日（曆法）	Tago
東帝汶	Orienta Timoro
夜	Nokto
黑洞	Nigra truo
穀神星	Cereso
妊神星	Haŭmeo
鳥神星	Makemako (nanoplanedo)
鬩神星	Eriso
硼	Boro
碳	Karbono
氮	Nitrogeno
氧	Oksigeno
行星	Planedo
威尼斯	Venecio
火影忍者	Naruto (mangao)
莫斯科	Moskvo
氟	Fluoro
義大利語	Itala lingvo
氖	Neono
鈉	Natrio
鎂	Magnezio
鋁	Aluminio
紐西蘭	Nov-Zelando
印度	Barato
硅	Silicio
磷	Fosforo
鐵	Fero
硫	Sulfuro
東	Oriento
氯	Kloro
巴布亞新幾內亞	Papuo-Nov-Gvineo
莎士比亞	William Shakespeare
氬	Argono
鉀	Kalio
鈣	Kalcio
鉛	Plumbo
蒙古國	Mongolio
鈧	Skandio
鈦	Titano (elemento)
委內瑞拉	Venezuelo
成吉思汗	Ĝingis-Ĥano
釩	Vanado
鉻	Kromo
阿姆斯特丹	Amsterdamo
動物	Bestoj
錳	Mangano
哥倫比亞	Kolombio
鈷	Kobalto
鎢	Volframo
鎳	Nikelo
佛教	Budhismo
玻利維亞	Bolivio
銅	Kupro
千里達及托巴哥	Trinidado kaj Tobago
植物	Plantoj
鋅	Zinko
真菌	Fungoj
牙買加	Jamajko
夏威夷	Havajo
海地	Haitio
伊朗	Irano
伊拉克	Irako
哥斯大黎加	Kostariko
以色列	Israelo
巴拿馬	Panamo
科威特	Kuvajto
老撾	Laoso
馬爾地夫	Maldivoj
亞美利加洲	Ameriko
馬來西亞	Malajzio
緬甸	Birmo
尼泊爾	Nepalo
阿曼	Omano
巴基斯坦	Pakistano
卡達國	Kataro
沙特阿拉伯	Sauda Arabio
斯里蘭卡	Sri-Lanko
斯大林	Josif Stalin
柏拉圖	Platono
鎵	Galiumo
神奇寶貝	Pokemono
中華民國	Respubliko Ĉinio
鍺	Germaniumo
泰國	Tajlando
砒	Arseno
硒	Seleno
溴	Bromo
鉑	Plateno
越南	Vjetnamio
大韓民國	Sud-Koreio
氪	Kriptono
阿富汗	Afganio
江南風	Gangnam Style
銣	Rubidio
金	Oro
蘇彝士運河	Sueza Kanalo
孟加拉國	Bangladeŝo
蘇格拉底	Sokrato
安哥拉	Angolo
不丹	Butano
汶萊	Brunejo
汞	Hidrargo
菲律賓	Filipinoj
中非	Centr-Afrika Respubliko
鉈	Taliumo
南極	Suda poluso
北極	Norda poluso
牛頓	Isaac Newton
鍶	Stroncio
釔	Itrio
鉍	Bismuto
尚比亞	Zambio
津巴布韋	Zimbabvo
北京市	Pekino
南蘇丹	Sud-Sudano
海參崴	Vladivostok
波札那	Bocvano
剛果民主共和國	Demokratia Respubliko Kongo
吉布提	Ĝibutio
加蓬	Gabono
甘地	Mohandas Karamchand Gandhi
利比亞	Libio
馬達加斯加	Madagaskaro
摩洛哥	Maroko
莫桑比克	Mozambiko
納米比亞	Namibio
尼日利亞	Niĝerio
烏干達	Ugando
索馬里	Somalio
凱撒	Julio Cezaro
蘇丹	Sudano
斯威士蘭	Svazilando
鍀	Teknecio
天演	Evoluismo
聯合國	Unuiĝintaj Nacioj
地理學	Geografio
腦	Cerbo
布拉格	Prago
銀	Arĝento
錫	Stano
鈾	Uranio
鈈	Plutonio
碘	Jodo
氙	Ksenono
銫	Cezio
鐳	Radiumo
氡	Radono
賈坎德邦	Ĝharkhando
耶路撒冷	Jerusalemo
印度洋	Hinda Oceano
科索沃	Kosovo
蕭邦	Frédéric Chopin
Category:類	Kategorio:Ĉio
帕斯卡	Blaise Pascal
冬	Vintro
春	Printempo
夏	Somero
秋	Aŭtuno
薩達姆·海珊	Saddam Hussein
拉登	Usama bin Laden
西班牙語	Hispana lingvo
巴赫	Johann Sebastian Bach
泉幣	Mono
奧古斯都	Aŭgusto Cezaro
諾基亞	Nokia (kompanio)
德克薩斯州	Teksaso
布宜諾斯艾利斯	Bonaero
東京都	Tokio
密西西比河	Misisipo (rivero)
錫金	Sikimo
尼爾杭思朗	Neil Armstrong
斯德哥爾摩	Stokholmo
墓誌	Epitafo
里加	Rigo
聖經	Biblio
金邊	Pnom-Peno
真耶穌教會	Vera Eklezio de Jesuo
英語	Angla lingvo
曼谷	Bankoko
臺北市	Tajpeo
鎇	Americio
康賽普西翁	Koncepciono
緬尼托巴	Manitobo
孔斯科沃拉	Końskowola
公元二千年	2000
二〇〇三年	2003
二〇〇二年	2002
二〇〇一年	2001
二〇一二年	2012
二〇一一年	2011
二〇一〇年	2010
二〇〇九年	2009
二氧化碳	Karbona dioksido
二〇一三年	2013
二〇一四年	2014
二〇一五年	2015
二〇〇八年	2008
二〇〇四年	2004
二〇〇五年	2005
二〇〇六年	2006
二〇〇七年	2007
一氧化碳	Karbona monooksido
戴高樂	Charles de Gaulle
一九九二年	1992
一九九一年	1991
一九九〇年	1990
一九九三年	1993
一九九四年	1994
一九九五年	1995
一九九六年	1996
可縮放矢量圖形	Streka Vari-skala Grafiko
萊比錫	Leipzig
一九九七年	1997
一九九八年	1998
一九九九年	1999
食物	Manĝaĵo
光速	Lumrapido
公曆一月一日	1-a de januaro
公曆一月二日	2-a de januaro
公曆一月三日	3-a de januaro
公曆一月四日	4-a de januaro
矮行星	Nanoplanedo
公曆一月五日	5-a de januaro
公曆一月六日	6-a de januaro
電子	Elektrono
公曆一月七日	7-a de januaro
公曆一月八日	8-a de januaro
公曆一月九日	9-a de januaro
公曆一月十日	10-a de januaro
公曆一月十一日	11-a de januaro
公曆一月十二日	12-a de januaro
公曆一月十三日	13-a de januaro
公曆一月十四日	14-a de januaro
公曆一月十五日	15-a de januaro
工業革命	Industria revolucio
苯	Benzeno
微軟	Microsoft
質子	Protono
庫魯夫	Kurów
公曆二月五日	5-a de februaro
公曆二月八日	8-a de februaro
化學	Kemio
中子	Neŭtrono
公曆二月廿九日	29-a de februaro
公曆三月十四日	14-a de marto
一九八九年	1989
一九八八年	1988
一九八七年	1987
一九八六年	1986
一九八五年	1985
一九八四年	1984
一九八三年	1983
一九八二年	1982
一九八一年	1981
一九八〇年	1980
一九七〇年	1970
一九七一年	1971
一九七二年	1972
一九七三年	1973
一九七四年	1974
一九七五年	1975
一九七六年	1976
一九七七年	1977
一九七八年	1978
一九七九年	1979
一九六九年	1969
公曆四月五日	5-a de aprilo
衛星	Natura satelito
公曆五月四日	4-a de majo
土衛六	Titano (luno)
一九六八年	1968
一九六七年	1967
一九六六年	1966
一九六五年	1965
一九六四年	1964
公曆六月廿日	20-a de junio
公曆七月廿三日	23-a de julio
足球	Futbalo
一九六三年	1963
一九六二年	1962
公曆九月十日	10-a de septembro
公曆十二月卅一日	31-a de decembro
公曆十月十日	10-a de oktobro
灶神星	4 Vesto
查理曼	Karolo la Granda
木衛一	Ioo (luno)
木衛四	Kalisto (luno)
木衛二	Eŭropo (luno)
木衛三	Ganimedo (luno)
火	Fajro
新南威爾士州	Novsudkimrio
土衛二	Encelado (luno)
天衛三	Titanjo (luno)
海衛一	Tritono (luno)
雅加達	Ĝakarto
一九六一年	1961
Category:模板	Kategorio:Vikipedio:Ŝablonoj
一九六〇年	1960
小行星	Asteroido
日食	Suna eklipso
二進制	Duuma sistemo
阿斯圖里亞斯	Asturio
維基大典:沙盒	Vikipedio:Provejo
卡爾梅克共和國	Kalmukio
代數學	Algebro
地圖	Mapo
阿拉貢自治區	Aragono
前卅三年	-33
硫酸	Sulfata acido
同海機場	Flughaveno Dong Hoi
Category:大韓民國紀事	Kategorio:Historio de Sud-Koreio
Category:日本史	Kategorio:Historio de Japanio
伯力	Ĥabarovsk
Category:越南史	Kategorio:Historio de Vjetnamio
孔子	Konfuceo
莎拉伯恩哈特	Sarah Bernhardt
Category:伊拉克史	Kategorio:Historio de Irako
南加州大学	Universitato de Suda Kalifornio
Category:數學	Kategorio:Matematiko
Category:蒙古史	Kategorio:Historio de Mongolio
Category:人造語言	Kategorio:Konstruitaj lingvoj
文藝復興	Renesanco
歐元	Eŭro
美金	Usona dolaro
地中海	Mediteraneo
杭州市	Hangĝoŭo
基督教	Kristanismo
Template:然也	Ŝablono:Por
柏林圍牆	Berlina muro
稻	Rizo
大陸	Kontinento
京	Ĉefurbo
Template:門	Ŝablono:Portalo
一九四八年	1948
艾爾瑪善鎮	Almazán
黃現璠	Huang Senfan
一九四五年	1945
一九五八年	1958
日語	Japana lingvo
百科全書	Enciklopedio
維基大典:卷首	Vikipedio:Ĉefpaĝo
一九五九年	1959
Template:正典	Ŝablono:Leginda
電晶體	Transistoro
棒球	Basbalo
奧林匹克運動會	Olimpiaj ludoj
長江	Jangzio
喜瑪拉雅山	Himalajo
落磯山	Roka Montaro
韃靼斯坦共和國	Tatarstano
一二六三年	1263
古斯巴達	Sparto
埃斯特雷馬杜拉	Ekstremaduro
安達盧西亞	Andaluzio
麥加	Mekko
毛澤東	Mao Zedong
西安市	Ŝjiano
拉薩市	Lasao
哲學	Filozofio
Category:速刪候	Kategorio:Tujforigendaj artikoloj
茶	Teo
馬可·波羅	Marko Polo
一三六三年	1363
共產主義	Komunismo
一三六八年	1368
迦太基	Kartago
大英博物館	Brita Muzeo
巴拉頓湖	Balatono
蒙庇利埃	Montpellier
Category:天文	Kategorio:Astronomio
吉他	Gitaro
同性戀	Samseksemo
漢堡包	Hamburgero
夸克	Kvarko
高斯	Carl Friedrich Gauss
一六四四年	1644
一六四五年	1645
Category:恒星	Kategorio:Steloj
李白	Li Bai
伽羅華	Évariste Galois
政府	Registaro
秦始皇帝	Qin Shihuangdi
中東	Mezoriento
漢	Dinastio Han
漢太祖高皇帝	Liu Bang
漢世宗孝武皇帝	Wu Di
聖女貞德	Johana de Arko
意理	Ideologio
帝國主義	Imperiismo
共和	Respubliko
國	Ŝtato
元	Dinastio Yuan
德意志第三帝國	Nazia Germanio
哥倫布	Kristoforo Kolumbo
庫克船長	James Cook
科爾蒂斯	Hernán Cortés
鄭和	Ĉeng He
大堡礁	Granda Barilrifo
巴拿馬運河	Panama kanalo
黃河	Flava Rivero
隋	Dinastio Sui
西夏	Okcidenta Xia
脫氧核酸	DNA
趙宋	Dinastio Song
宋徽宗	Huizong
歐拉	Leonhard Euler
一七七四年	1774
一七七五年	1775
一七七六年	1776
一八六六年	1866
一八六七年	1867
一八六八年	1868
晝	Mateno
拿破崙二世	Napoleono la 2-a
砒霜	Arseniko
法律	Leĝo (jura)
一七九四年	1794
世界人權宣言	Universala Deklaracio de Homaj Rajtoj
一七九五年	1795
一七九六年	1796
漢語	Ĉina lingvaro
細胞	Ĉelo (biologio)
全球暖化	Tutmonda varmiĝo
禪宗	Zeno
鼠標	Komputila muso
聖奧思定	Aŭgusteno de Hipono
精靈	Feo
朊	Proteino
理則	Logiko
龍捲風	Tornado (ŝtormo)
幾何	Geometrio
語法	Gramatiko
熱帶氣旋	Uragano
計學	Ekonomiko
語言學	Lingvoscienco
文字	Skribsistemo
阿拉伯字	Araba alfabeto
漢字	Ĉina skribo
西里爾字母	Cirila alfabeto
孫子兵法	La Militarto
Category:音樂	Kategorio:Muziko
紅樓夢	Ruĝdoma sonĝo
Category:法國史	Kategorio:Historio de Francio
哈利波特	Harry Potter
放手銃	Sinmasturbado
法文維基大典	Franclingva Vikipedio
死刑	Mortpuno
人權	Homaj rajtoj
乳	Lakto
山	Monto
沙漠	Dezerto
孫文	Sun Jatsen
薩拉丁	Saladino
阿育王	Aŝoko
阿克巴大帝	Jalaluddin Muhammad Akbar
香港	Honkongo
韓戰	Korea milito
南北戰爭	Usona Enlanda Milito
首爾特別市	Seulo
上海市	Ŝanhajo
清	Dinastio Qing
越戰	Vjetnama milito
歐几里得	Eŭklido
巴斯克語	Eŭska lingvo
星座	Konstelacio
拉脫維亞語	Latva lingvo
原子	Atomo
宗教	Religio
朝鮮語	Korea lingvo
笛卡兒	René Descartes
官話	Nordĉina dialektaro
越南語	Vjetnama lingvo
猶太教	Judismo
老子	Laozio
電鼠	Pikaĉuo
尼采	Friedrich Wilhelm Nietzsche
司馬遷	Sima Qian
斯密亞丹	Adam Smith
朱熹	Zhu Xi
廷巴克圖	Timbuktuo
洋	Oceano
阿奎那	Tomaso de Akvino
英王維多利亞	Viktoria (Britio)
釋迦牟尼	Sidarto Gotamo
馬丁·路德	Marteno Lutero
儒家	Konfuceismo
腹	Ventro
陰脈	Vejno
福克蘭群島	Insuloj Falklandoj
陽脈	Arterio
唐	Dinastio Tang
威爾斯王妃黛安娜	Diana Spencer
明	Dinastio Ming
明太祖	Ĵu Juanĵang
明成祖	Jongle
明神宗	Ŭan Li
電漿	Plasmo
金正日	Kim Ĝong-il
元素週期表	Perioda tabelo
自殺	Sinmortigo
九一一事件	Atencoj de la 11-a de septembro 2001
電話	Telefono
梵語	Sanskrito
化合物	Kemia kombinaĵo
算術	Aritmetiko
食鹽	Salo
化學元素	Kemia elemento
方程	Ekvacio
映射	Funkcio (matematiko)
角	Angulo
分子	Molekulo
加速度	Akcelo
能量	Energio
弈	Goo
金屬	Metalo (fiziko)
氣體	Gaso
液體	Likvo
固體	Solido
船舶	Ŝipo
農	Agrikulturo
速度	Vektora rapido
納米科技	Nanoteknologio
勾股定理	Teoremo de Pitagoro
證明	Matematika pruvo
數	Nombro
複數	Kompleksa nombro
公斤	Kilogramo
公尺	Metro
大麥	Ordinara hordeo
繪畫	Pentrado
華爾街	Wall Street
美國總統	Prezidanto de Usono
東南亞	Sud-Orienta Azio
瀋陽市	Ŝenjango
重慶市	Ĉongĉingo
天津市	Tjanĝino
武漢市	Vuhano
史前	Prahistorio
古埃及	Antikva Egiptio
白令海峽	Beringa Markolo
古希臘	Antikva Grekio
傑弗遜	Thomas Jefferson
希臘文維基大典	Greklingva Vikipedio
麥	Tritiko
格里曆	Gregoria kalendaro
拉丁文維基大典	Latinlingva Vikipedio
麻雀 (棋牌)	Maĝango
鹽	Salo (kemio)
牛頓（單位）	Neŭtono (mezurunuo)
度量衡	Mezuro
萬國公制	Internacia sistemo de unuoj
集論	Aroteorio
哈里發塔	Burĝ Ĥalifa
長城	Granda Ĉina Muro
整數	Entjero
球	Sfero
大憲章	Magna Carta
阿兹特克	Aztekoj
上塞納省	Hauts-de-Seine
東羅馬帝國	Bizanca imperio
奧斯曼帝國	Otomana Imperio
國內生產總值	Malneta enlanda produkto
銃	Pafarmilo
伊比利半島	Iberio
坦克	Tanko
實數	Reelo
楈枒	Kokoso
桃	Persiko
冰酪	Glaciaĵo
文胸	Mamzono
阿拉伯語	Araba lingvo
本州	Honŝu
四國	Ŝikokuo
地中海氣候	Mediteranea klimato
科西嘉	Korsiko
頂級域名	Domajno de plej alta nivelo
斯洛文尼亞語維基大典	Slovenlingva Vikipedio
百度	Baidu
澳門	Makao
土衛一	Mimaso (luno)
土衛四	Diono (luno)
土衛三	Tetiso (luno)
土衛五	Reo (luno)
廣東省	Gŭangdongo
廣西壯族自治區	Gŭangŝjio
蘇聯	Sovetunio
亡神星	90482 Orko
塞德娜	90377 Sedno
孟德斯鳩	Charles Montesquieu
維基大典:卓著	Vikipedio:Elstaraj artikoloj
Template:Link FA	Ŝablono:LigoElstara
維基大典:會館	Vikipedio:Diskutejo
釜山廣域市	Pusano
廣州市	Kantono (Ĉinio)
蔣中正	Ĉiang Kai-ŝek
南京市	Nankingo
君士坦丁堡	Konstantinopolo
首爾地鐵	Metroo de Seulo
北京大學	Pekina Universitato
烏魯木齊市	Urumĉio
江蘇省	Ĝjangsuo
浙江省	Ĝeĝjango
鄧小平	Deng Xiaoping
西藏自治區	Tibeto
圓	Cirklo
歐氏幾何	Eŭklida spaco
周恩來	Zhou Enlai
中國共產黨	Komunista Partio de Ĉinio
馮諾曼	John von Neumann
偽基大典	Neciklopedio
公理	Aksiomo
朝鮮文維基大典	Korelingva Vikipedio
檀香山	Honolulu
紋章	Heraldiko
曼徹斯特聯足球俱樂部	Manchester United
平壤直轄市	Pjongjango
模 (代數)	Modulo (matematiko)
九	9 (nombro)
蕭伯納	George Bernard Shaw
黑龍江省	Hejlongĝjango
香港島	Honkonga Insulo
鹼金屬	Alkala metalo
非金屬	Nemetalo
鹵素	Halogeno
稀有氣體	Nobla gaso
維基大典:正典	Vikipedio:Legindaj artikoloj
四川省	Siĉuano
舊約	Malnova testamento
聖誕節	Kristnasko
三角形	Triangulo
印歐語系	Hindeŭropa lingvaro
穆阿邁爾·格達費	Muamar Kadafi
獨島	Liancourt-Rokoj
大田廣域市	Deĝon
大邱廣域市	Teguo
仁川廣域市	Inĉono
自然數	Natura nombro
萬國音標字	Internacia Fonetika Alfabeto
河北省	Hebejo
革奴自由文檔許可協議	Permesilo de GNU por Liberaj Dokumentoj
臺灣	Tajvano
紐約	New York
公元元年	1
魯迅	Lu Xun
八	8 (nombro)
馬德堡半球	Magdeburgaj duongloboj
主禱文	Patro nia
蒜	Ajlo
白	Blanko
黑	Nigro
六九八年	698
巴爾幹半島	Balkana duoninsulo
七二七年	727
墨索里尼	Benito Mussolini
四方	Kompasdirektoj
十	10 (nombro)
原子序	Atomnumero
九一八年	918
公元百年	100
五七〇年	570
四時	Sezono
二二二年	222
利物浦	Liverpool
鐵達尼號	RMS Titanic
五五二年	552
同位素	Izotopo
蜚蠊	Blato
功率	Povumo
索布語	Soraba lingvo
頂點	Vertico (geometrio)
福岡市	Fukuoka
建城	Romia erao
日本海	Japana Maro
宮古列島	Mijako-insuloj
中亞	Centra Azio
琉球國	Rjukju-reĝlando
朝鮮國	Joseon-Dinastio
高句麗	Kogurjo
百濟	Baekje
新羅	Silla
奧匈帝國	Aŭstrio-Hungario
馬雅	Majaoj
印加國	Inkaa imperio
縣	County
韓非子	Han Fei
錦州市	Ĝjinĝou
導數	Derivaĵo (matematiko)
釣魚臺列嶼	Senkaku-insuloj
中國	Ĉinio
成都市	Ĉengduo
咖啡廳	Kafejo
蒲公英	Taraksako
雪豹	Neĝleopardo
白話維基大典	Ĉinlingva Vikipedio
二二一年	221
五四三年	543
五三六年	536
二三〇年	230
二〇二年	202
一九二年	192
總統	Prezidanto
五五五年	555
五七一年	571
滿洲國	Manĉukuo
二三一年	231
二二五年	225
三一一年	311
二二〇年	220
三一三年	313
五八七年	587
五四八年	548
五四九年	549
五五一年	551
五五七年	557
二二三年	223
二二四年	224
二一九年	219
大運河	Granda Kanalo de Ĉinio
五八九年	589
三〇四年	304
五五〇年	550
五八六年	586
五八八年	588
五五四年	554
二二九年	229
五八三年	583
二六五年	265
二六三年	263
五八五年	585
五八二年	582
五五六年	556
四二〇年	420
二八〇年	280
五八一年	581
五五八年	558
東干語	Dungana lingvo
客家語	Hakaa lingvo
切羅基語	Ĉeroka lingvo
羅素悖論	Rusela paradokso
五六九年	569
贛語	Gana lingvo
爪哇語	Java lingvo
滿語	Manĉura lingvo
弧度	Radiano
五五三年	553
三〇七年	307
五八四年	584
杜甫	Du Fu
人口	Loĝantaro
瓦爾帕萊索	Valparaiso
青銅	Bronzo
情報及特殊使命局	Mosado
尼亞加拉瀑布	Niagara Akvofalaro
吳語	Vua lingvo
昭和天皇	Hirohito
基地組織	Al-Kaida
穆罕默德二世	Mehmedo la 2-a
希臘神話	Helena mitologio
新疆維吾爾族自治區	Ŝinĝjango
郵局	Poŝtejo
萬國首都全覽	Listo de ĉefurboj
周	Dinastio Zhou
形而上學	Metafiziko
白宮	Blanka Domo (Vaŝingtono)
北海道	Hokajdo
科科斯（基林）群島	Kokosinsuloj
胡志明	Ho Chi Minh
蘇軾	Su Ŝi
明尼阿波利斯	Minneapolis
集	Aro (matematiko)
順化市	Hue
閩東語	Min-donga lingvo
閩南語	Minnana lingvo
離子	Jono
壯族	Ĝŭangoj
南斯拉夫	Jugoslavio
長毛象	Mamuto
四邊形	Kvarlatero
三船敏郎	Mifune Toshiro
文言	Klasika ĉina lingvo
線	Rekto
甲烷	Metano
孫武	Sun Tzu
中央情報局	CIA
語法學	Sintakso
聯合國安全理事會	Konsilio de Sekureco de Unuiĝintaj Nacioj
眼鏡	Okulvitro
火柴	Alumeto
多邊形	Plurlatero
市場	Merkato
南海	Sudĉina Maro
朝鮮世宗	Seĝong
俳句	Hajko
黃海	Flava Maro
今上天皇	Akihito
橫濱市	Jokohamo
普魯士	Prusio
前四年	-4
柳州市	Ljuĝou
皇帝	Imperiestro
索契	Soĉi
壓強	Premo
龍貓	Mia najbaro Totoro
线粒体	Mitokondrio
吠陀	Vedoj
橢圓	Elipso (matematiko)
杠杆	Levilo
蟹	Krabo
前九十年	-90
酸鹼度	PH (kemia parametro)
美國革命	Usona Milito de Sendependeco
安徽省	Anhujo
前九十一年	-91
內蒙古自治區	Interna Mongolio
金日成	Kim Il-sung
濟州特別自治道	Jeju-do
鬱陵島	Ulleungdo
巴別塔	Babela turo
蔚山廣域市	Ulsan
光州廣域市	Kŭangĵuo
李斯特	Franz Liszt
美式足球	Usona piedpilkado
前八十七年	-87
哥德爾	Kurt Gödel
摩爾	Molo
華國鋒	Hua Guofeng
烷烴	Alkano
希爾伯特	David Hilbert
前九十五年	-95
黃金分割	Ora proporcio
福建省	Fuĝjano
班夫國家公園	Nacia Parko Banff
查士丁尼一世	Justiniano la 1-a
前七十四年	-74
阿貝爾·塔斯曼	Abel Tasman
海南省	Hajnano
功	Laboro (fiziko)
漢語拼音	Hanyu Pinyin
莽原氣候	Savano
甘肅省	Gansuo
蘇州市	Suĝoŭo
溫州市	Venĝou
無錫市	Vuŝio
紹興市	Ŝaosing
寧波市	Ningbo
紙鳶	Kajto
前二〇一年	-201
前二〇二年	-202
哈爾濱市	Harbino
油	Oleo
拓撲學	Topologio
文身	Tatuo
金融學	Financoj
雲南省	Junano
多項式	Polinomo
山東省	Ŝandongo
中南半島	Hindoĉinio
天擇	Natura selektado
地質年代	Geologia temposkalo
壟斷	Monopolo
河南省	Henano
遼寧省	Ljaŭningo
席德	Cido
刳剔者傑克	Ĵakvo la Buĉisto
前一五六年	-156
前一三九年	-139
前一二二年	-122
前二〇六年	-206
西爾門·拉什迪	Salman Rushdie
前二〇三年	-203
化學鍵	Kemia ligo
槍	Lanco
前一四一年	-141
僧院	Monaĥejo
白堊紀	Kretaceo
前二〇九年	-209
皮薩羅	Francisco Pizarro
點	Punkto (matematiko)
骰子	Ĵetpluredro
吉林省	Ĝilinio
東海	Orientĉina Maro
前二三二年	-232
湖南省	Hunano
青海省	Ĉinghajo
前一九七年	-197
前二〇七年	-207
前一八八年	-188
矢	Sago
前二〇五年	-205
鮨	Suŝio
前二〇八年	-208
湖北省	Hubejo
山西省	Ŝanŝio
魔方	Kubo de Rubik
貴州省	Gŭiĝoŭo
京都議定書	Protokolo de Kioto
聯合國大會	Ĝenerala Asembleo de Unuiĝintaj Nacioj
乙酸	Acetata acido
安達曼海	Andamana Maro
前二〇四年	-204
莊子	Ĝuangzio
清孝欽顯皇后	Ciŝji
陝西省	Ŝenŝjio
Template:共享類	Ŝablono:Commonscat
三八三年	383
德文維基大典	Germanlingva Vikipedio
拋物線	Parabolo (matematiko)
尿素	Ureo
平假名	Rondaj kanaoj
波斯文維基大典	Perslingva Vikipedio
質數	Primo
五七二年	572
吾世	Minecraft
罷工	Striko
李舜臣汝諧	Ji Sun-sin
中華人民共和國地方	Administra divido de Ĉinio
日本都道府縣	Gubernioj de Japanio
氧化物	Oksido
合數	Komponita nombro
因數	Divizoro
口琴	Buŝharmoniko
Template:Taxobox	Ŝablono:Taksonomio
繩文時代	Ĵomon-epoko
太極	Tajĝio
平行	Paralelo
海鳥	Marbirdoj
江西省	Ĝjangŝio
阿卜杜拉·本·阿卜杜勒-阿齊茲·沙特	Abdulah bin Abdul-Aziz Al Saud
寧夏回族自治區	Ningŝjao
揚州市	Janĉĵou
鎮江市	Ĉĵencjan
哈薩克文維基大典	Kazaĥlingva Vikipedio
石家莊市	Ŝiĝjaĝŭango
亞當與夏娃	Adamo kaj Evo
珠海	Ĝuhaj
韶關市	Ŝaoguan
東莞市	Dongguan
俄羅斯正教會	Rusa Ortodoksa Eklezio
鯢	Ĉina giganta salamandro
空師	Aerarmeo
大名	Daimio
哈布斯堡氏	Habsburgoj
中央銀行	Centra banko
福州市	Fuĝoŭo
廈門市	Sjamen
漳州市	Ĝanĝou
西寧市	Sinino
西遊記	Pilgrimado al la Okcidento
三國演義	Tri regnoj
水滸傳	Ĉe akvorando
福島縣	Gubernio Fukuŝima
豬油	Ŝmalco
鞍山市	Anŝano
羅馬治世	Pax Romana
康托爾	Georg Cantor
戴德金	Julius Wilhelm Richard Dedekind
寒武紀	Kambrio
神聖羅馬皇帝腓特烈一世	Frederiko la 1-a (Sankta Romia Imperio)
前三八七年	-387
盲文	Brajlo
千葉縣	Gubernio Ĉiba
賽珍珠	Pearl S. Buck
聯合國秘書長	Ĝenerala Sekretario de la Unuiĝintaj Nacioj
龐加萊	Henri Poincaré
西北水道	Nordokcidenta pasejo
十進制	Dekuma sistemo
烯烴	Alkeno
皇祚	Kimi Ga Jo
氣壓	Atmosfera premo
箸	Manĝobastonetoj
標點符號	Interpunkcio
片假名	Strekaj kanaoj
民之旨	Ĝana Gana Mana
臺北一零一	Taipei 101
化學式	Kemia formulo
波斯	Persa Imperio
群 (代數)	Grupo (algebro)
波蘭球	Pollandpilko
水星領航員	ARIA
三角函數	Trigonometria funkcio
六四事件	Protestoj sur placo Tian An Men
胡耀邦	Hu Yaobang
安樂死	Eŭtanazio
姓氏	Familia nomo
醛	Aldehido
規	Cirkelo
物質之量	Materikvanto
平安北道	Nord-Pjongan
咸鏡南道	Sud-Hamgjong
島國	Landinsulo
京都府	Gubernio Kioto
絕對值	Absoluta valoro
羅賓漢	Robin Hood
表數法	Cifereca sistemo
大阪府	Gubernio Osaka
瑪瑙	Agato
愛媛縣	Gubernio Ehime
圓錐曲線	Koniko
海平面	Marnivelo
羅馬皇帝表	Listo de romiaj imperiestroj
矢量空間	Vektora spaco
距	Distanco
山口縣	Gubernio Jamaguĉi
神奈川縣	Gubernio Kanagaŭa
中國地方	Ĉugoku
長野縣	Gubernio Nagano
殷商	Dinastio Shang
色諾芬	Ksenofono
兵庫縣	Gubernio Hjogo
關係 (數學)	Duargumenta rilato
等價	Ekvivalentrilato
主格	Nominativo
泰國灣	Golfo de Tajlando
維基大典:書海	Vikipedio:Libroservoj
征夷大將軍	Ŝoguno
春節	Ĉina novjara festo
切腹	Seppuku
色盲	Kolorblindeco
阿什莫爾島與卡捷島	Aŝmora kaj Kartia Insuloj
農曆	Ĉina kalendaro
可樂	Kolao
高知縣	Gubernio Koĉi
道德經	Daŭdeĝingo
坐標幾何	Analitika geometrio
芬瑟島	Fraser-insulo
蹴鞠	Ĉina piedpilkado
臺南市	Tajnan
與格	Dativo
摩爾質量	Mola maso
滿洲族	Manĉuroj
義大利半島	Itala duoninsulo
汽水	Senalkoholaĵo
天象館	Planetario
微積分	Kalkulo
岳陽市	Juejang
東寧	Reĝlando de Tungning
碗	Bovlo
義勇軍進行曲	La Marŝo de la Volontuloj
庖人	Kuiristo
毛納洛峰	Mauna Loa
富牌國際機場	Flughaveno Phu Bai
修道院	Abatejo
符節	Pasvorto
環 (代數)	Ringo (algebro)
環球小姐	Fraŭlino Universo
香川縣	Gubernio Kagaŭa
曲線	Kurbo
白求恩	Norman Bethune
中日戰爭	Ĉina-japana milito
平面幾何	Eŭklida geometrio
基數	Povo de aro
二元運算	Operacio (matematiko)
餘弦定理	Leĝo de kosinusoj
新幹線	Ŝinkanseno
雙曲線	Hiperbolo
星際爭霸	StarCraft
反射	Reflekto
近視	Miopio
代數數	Algebra nombro
夏后氏	Dinastio Xia
連續	Kontinua funkcio
教廷諸屬國	Papa Ŝtato
濟南市	Ĝinano
十一月革命	Novembra Revolucio (Germanio)
中國抗日戰爭	Dua japana-ĉina milito
青島市	Cindao
PSP	PlayStation Portable
葛利斯五八一丙	Gliese 581 c
官能團	Funkcia grupo
世氣公會	Monda Organizaĵo pri Meteologio
見即所得	WYSIWYG
新西班牙代王領	Nova Hispanio
織田信長	Oda Nobunaga
向日葵	Sunfloro
南昌市	Nanĉano
玫瑰之名	Il nome della rosa
幾何原本	Elementoj de Eŭklido
米高·哥連斯	Michael Collins (politikisto)
金本位	Orbazo
直積	Kartezia multipliko
艾狄胥	Paŭlo Erdős
長沙市	Ĉangŝa
有機化合物	Organika kombinaĵo
蜉蝣	Efemeroj
伊藤博文	Ito Hirobumi
絞刑	Pendumo
電極	Elektrodo
阿拉伯數字	Eŭropaj ciferoj
股骨	Femurosto
子集	Subaro
海東青	Ĉasfalko
日文維基大典	Japanlingva Vikipedio
甲午戰爭	Unua japana-ĉina milito
克里希那穆提	Jiddu Krishnamurti
宦官	Eŭnuko
選擇公理	Aksiomo de elekto
行星環	Planeda ringo
青藏高原	Tibeta Altebenaĵo
拓撲空間	Topologia spaco
古文書	Paleografio
錫克金廟	Harmandir Sahib
卡奔塔利亞灣	Karpentaria Golfo
度量空間	Metrika spaco
千分比	Elmilo
交換群	Komuta grupo
高雄市	Kaoŝiung
華盛頓歐文	Washington Irving
弩	Arbalesto
渤海	Bohaj-maro
甑帶瘡	Zostero (medicino)
戰艦	Batalŝipo
海倫公式	Formulo de Herono
昆明市	Kunmingo
天氣預報	Veterprognozo
人蔘	Ginsengo
回族	Hujoj
蘭州市	Lanĝoŭo
三國	Tri reĝlandoj
戰國	Militŝtata periodo
名偵探柯南	Detektivo Konan (mangao)
區間	Intervalo (matematiko)
清宣統帝	Pu Ji
併集	Kunaĵo
簡化字	Simpligita ĉina skribo
合肥市	Hefejo
交集	Komunaĵo
常染色體	Aŭtosomo
簡歷	Kariertabelo
蝴蝶效應	Papilia efiko
豐臣秀吉	Toyotomi Hideyoshi
白鱀豚	Blanknaĝila delfeno
弦	Ĥordo (geometrio)
平昌郡	Pjonĉango
泰國國際航空	Thai Airways
北九州市	Kitakjuŝu
匈奴	Ŝiungnuoj
孟子	Menceo
桂林市	Gujlin
海口市	Hajkoŭo
無機化合物	Neorganika kombinaĵo
挪威廣播公司	NRK
道	Tao
世界語維基大典	Vikipedio en Esperanto
刺身	Saŝimo
高錳酸鉀	Kalia permanganato
魔鬼之詩篇	La satanaj versoj
有序對	Orda duopo
書面挪威語維基大典	Norveglingva Vikipedio
序數	Ordonombro
南京大屠殺	Masakro de Nankingo
吳廷琰	Ngô Đình Diệm
麵	Nudelo
化學符號	Listo de kemiaj elementoj laŭ simbolo
路易斯安那購地案	Vendo de Luiziano
扇	Ventumilo
平安時代	Epoko de Heian
旦	Sunleviĝo
韓信點兵	Ĉina restteoremo
無窮小	Senfinecono
單鏡筒反光相機	Spegula fotilo
雙城子	Ussurijsk
壯學	Ĝŭangoscienco
烏克蘭語維基大典	Ukrainlingva Vikipedio
阿拉伯文維基大典	Arablingva Vikipedio
希伯來文維基大典	Hebrelingva Vikipedio
洞里薩湖	Tonlesapo
賈姆謝德布爾	Ĝamŝedpur
越南文維基大典	Vjetnamlingva Vikipedio
中醫	Ĉina tradicia medicino
高松市	Takamacu
提格兰二世	Tigrano la Granda
珠江	Perlorivero
泰西格致史	Historio de scienco
五帝	Tri Suverenoj kaj Kvin Imperiestroj
瑪格麗特一世	Margareta la 1-a
先哥倫布	Antaŭkolumba Ameriko
彼得一世島	Insulo Petro la Unua
墓碑	Tomboŝtono
十二銅表法	Dekdu-tabula leĝo
漢魏武王	Cao Cao
斬首	Senkapigo
垂直	Perpendikularo
無窮集合	Malfinia aro
冪集	Aro de ĉiuj subaroj
魚鉤	Fiŝhoko
齊齊哈爾市	Ĉiĉiharo
俄文維基大典	Ruslingva Vikipedio
平行公理	5-a postulato
西線無戰事	En okcidento nenio nova
嘧啶	Pirimidino
冬至	Vintra solstico
中國中央電視臺	Ĉina Centra Televido
巴列維王朝	Dinastio Pahlavi
天皇	Imperiestro de Japanio
熱帶雨林氣候	Ekvatora klimato
袋鼠島	Kanguru-Insulo
君士坦丁堡普世宗主教區	Konstantinopola Ortodoksa Eklezio
辛普生沙漠	Dezerto Simpson
娜塔莎·北鼎斐	Natasha Bedingfield
開集	Malfermita aro
健陀羅	Gandhara
愛爾蘭共和國總統	Prezidanto de Irlando
金奎植	Kim Kyu-sik
江戶	Edo
金九	Kim Koo
倒數	Inverso
黃道兇賊	Zodiako (seria murdisto)
盧溝橋事變	Incidento sur ponto de Marko Polo
龜	Testuduloj
阮福晪	Bảo Đại
空集	Malplena aro
自由民主黨	Liberal-Demokrata Partio (Japanio)
原富	La Riĉo de Nacioj
哆啦A夢	Doraemon
伏羲	Fu Xi
九龍	Kaŭluno
成本	Kosto
補集	Komplemento (aroteorio)
靖國神社	Yasukuni-Sanktejo
鹽田	Salejo
新北市	Novtajpeo
臺中市	Tajĉung
牢不可破之聯盟	Nacia himno de Sovetunio
相似	Simileco (geometrio)
大韓高宗	Goĝong de Koreio
語序	Vortordo
賢哲賽義巴巴	Sai Baba de Shirdi
貴金屬	Valormetalo
懿德天皇	Itoku
論語	Analektoj de Konfuceo
尚眞王	Ŝo Ŝin
明智光秀	Akechi Mitsuhide
綏靖天皇	Suizei
阮攸	Nguyen Du
白居易	Bai Juyi
神農	Shennong
帝舜	Shun
安寧天皇	Annei
張國榮	Leslie Cheung
王維	Wang Wei
林彪	Lin Biao
鴨脷洲	Ap Lei Chau
米芾	Mi Fu
閉集	Fermita aro
閉開集	Fermito-malfermita aro
作格	Ergativo
基斯孔哈拉斯	Kiskunhalas
竭澤而漁	Troa fiŝkaptado
通格	Absolutivo
林語堂	Lin Yutang
杜牧	Du Mu
石田三成	Ishida Mitsunari
朝鮮世祖	Sejo de Joseon
福澤諭吉	Fukuzawa Yukichi
蒂邁歐篇	Timeo
魏 (釋義)	WEI
南唐後主	Li Ju
康托爾悖論	Paradokso de Russell
中秋	Luna Festo
緊集	Kompakta spaco
冒頓單于	Modu Ĉanju
高順	Gao Shun
發翔羽	Ĉefplumo
秋葉原	Akihabara
丸龜市	Marugame
潘清簡	Phan Thanh Gian
偏序	Partordo
新山一國際機場	Flughaveno Tan Son Nhat
電車	Elektrotrajno
和服	Kimono
遜尼派	Sunaismo
哥德巴赫猜想	Konjekto de Goldbach
國會議員	Parlamentano
萌	Moeo
涼宮春日系列	Suzumiya Haruhi no Yuutsu
莎阿南	Shah Alam
中國禮儀之爭	Ĉina rito-polemiko
初音未來	Hatsune Miku
嚴復	Yan Fu
泰文維基大典	Tajlingva Vikipedio
包頭市	Baŭtoŭo
板橋區	Panĉiao
小行星三千	3000 Leonardo
原口證	Haraguchi Akira
花崗岩島	Insulo Granita
呂底亞	Lidio
自焚	Sinbruligo
廬山	Luŝan
漢 (釋義)	HAN
水龍頭	Krano
車裂	Kvaronumo
算術基本定理	Fundamenta teoremo de aritmetiko
稠密	Densa aro
流亡政府	Ekzilregistaro
中文數字	Ĉinaj ciferoj
魏陳思王	Cao Zhi
恆春丙戌地震	Tertremo de Hengchuen (2006)
楊慎	Jang Ŝen
世界新七大奇蹟	Novaj sep mirindaĵoj de la mondo
屏東市	Ping Tung (Tajvano)
季羨林	Ji Xianlin
清明上河圖	Laŭ La Rivero Dum Serena Festo
延邊州	Korea Aŭtonoma Prefektujo Janbiano
日本雅樂	Gagako
清明	Qingming
印地文維基大典	Hindilingva Vikipedio
琴	Guĉino
有界	Barita aro
倫敦東隅	East End de Londono
歐羅巴	Eŭropo (apartigilo)
性	Homa naturo
結合代數	Asocieca algebro
銀魂	GinTama
沖繩縣	Gubernio Okinavo
百度大典	Baidu Baike
帝堯	Yao
二虎歌	Frat' Jakobo
南越	Nanjueo
天下通言	Internacia planlingvo
古雅典	Antikva Ateno
漢傳佛教	Ĉina budhismo
康熙字典	Kangxi-Vortaro
族 (數學)	Indeksita familio
光圈	Relativa truo de objektivo
禮記	Libro de Ritoj
雲隙光	Krepuskaj radioj
常用漢字	Jōyō-kanji
周界	Rando (topologio)
單連通	Simple koneksa spaco
藁人之謬	Pajlohomo
陸上風帆	Landa velado
雷恩島	Insulo Raine (Kvinslando)
代數 (代數)	Alĝebro
維克多港	Victor Harbor (Suda Aŭstralio)
大都	Kanbalik
倉頡輸入法	Cangjie (Eniga metodo)
元維基	Meta-Vikio
祁連山	Ĉilian
亞米利加蝲蛄	Luiziana kankro
藏學	Tibetologio
人民公社	Popola komunumo
竹島 (釋義)	Takeŝima (apartigilo)
東巴文	Hieroglifo Dongba
節氣	Suna Periodo
零零七島	Khao Phingan
維基大典:大使館	Vikipedio:Ambasadorejo
分數	Racionala nombro
翹傳	La Rakonto pri Kiều
古丁尼柏國家公園	Nacia Parko Quttinirpaaq
漢服	Hanfu
動物莊園	La Besto-Farmo
Category:德國史	Kategorio:Germanio
Category:俄羅斯聯邦書	Kategorio:Rusio
Category:大韓民國書	Kategorio:Sud-Koreio
Category:羅馬帝國書	Kategorio:Romia Imperio
Category:鳥	Kategorio:Birdoj
Category:植物	Kategorio:Plantoj
Category:物理	Kategorio:Fiziko
Category:自然科學	Kategorio:Naturscienco
Category:化學	Kategorio:Kemio
Category:史部	Kategorio:Historio
Category:群	Kategorio:Socio
Category:宗教	Kategorio:Religio
Category:運動	Kategorio:Sporto
Category:經部	Kategorio:Scienco
Category:聯合國	Kategorio:Unuiĝintaj Nacioj
Category:地球	Kategorio:Tero
古羅馬	Romio
政令指定都市	Granda Urbo kun Esceptoj
不寐	Sendormeco
Category:釋義	Kategorio:Apartigiloj
Category:哲學	Kategorio:Filozofio
Category:心理	Kategorio:Psikologio
Category:佛教	Kategorio:Budhismo
Category:基督教	Kategorio:Kristanismo
Category:回教	Kategorio:Islamo
Category:猶太教	Kategorio:Judismo
華東師範大學	Orient-Ĉina Normala Universitato
夏 (釋義)	XIA
將軍澳	Tseung Kvan O
Category:殘章	Kategorio:Ĝermo
Category:維基分類	Kategorio:Vikipedio:Kategorioj
Category:維基事	Kategorio:Vikipedio:Vikipedio
Category:行星	Kategorio:Planedoj
Category:地質	Kategorio:Geologio
Template:太陽系	Ŝablono:Sunsistemo
春運	Ĉunjun
大阪	Osaka
Category:小行星帶天體	Kategorio:Asteroidoj de la ĉefa zono
Category:美國列傳	Kategorio:Usonanoj
Template:Tl	Ŝablono:Ŝ
Template:Userbox	Ŝablono:Uzantoskatolo1
Category:網頁瀏覽器	Kategorio:TTT-legiloj
Template:世事	Ŝablono:ĈefPaĝoMondAktualaĵo
Category:律法	Kategorio:Juro
Category:計學	Kategorio:Ekonomiko
維基大典:有秩選舉	Vikipedio:Administrantoj/kandidatoj
Category:醫學	Kategorio:Medicino
Category:政治	Kategorio:Politiko
Category:教育	Kategorio:Edukado
Category:藝術	Kategorio:Arto
會計	Kontado
密思兒	Egiptujo
Category:統計	Kategorio:Statistiko
Template:Bot	Ŝablono:Bot
加拿大	Kanado
Category:卓著	Kategorio:Elstaraj artikoloj
維	Dimensio
Category:遊戲	Kategorio:Ludoj
Category:幫助文檔	Kategorio:Helpo
維基大典:世事	Vikipedio:Aktualaĵoj
Template:Documentation	Ŝablono:Dok
Category:有秩	Kategorio:Vikipedio:Administrantoj
維基大典:簿之權限	Vikipedio:Rajtoj de uzantoj
Category:維基提案	Kategorio:Vikipedio:Balotoj
維基大典:聯繫	Vikipedio:Kontaktoj
維基大典:市集	Portalo:Komunumo
Category:維基社群	Kategorio:Vikipedio:Komunumo
Category:維基人	Kategorio:Vikipediistoj laŭ lingvo
維基大典:忽略規則	Vikipedio:Ignoru regulojn
維基大典:五柱	Vikipedio:Kvin principoj
成在基	Sung Jae-gi
企業	Profitcela organizaĵo
Template:Softredirect	Ŝablono:Intervikia plusendilo
Template:刪	Ŝablono:Forigu tuj
Category:技術	Kategorio:Teknologio
Category:語言	Kategorio:Lingvoj
Category:語法	Kategorio:Gramatiko
Category:維基大典	Kategorio:Vikipedio
Category:諸語維基大典	Kategorio:Vikipedioj laŭ lingvoj
Category:未索之頁	Kategorio:Neindeksitaj paĝoj
Category:帶壞檔之頁	Kategorio:Paĝoj kun eraraj dosierligiloj
門:卷首	Portalo:Portalejo
Template:Navbox	Ŝablono:Navigilo2
Template:捷徑	Ŝablono:Mallongigo
Category:時區	Kategorio:Horzonoj
Category:維基大典維護	Kategorio:Artikoloj bezonantaj plibonigon
Template:!	Ŝablono:!
Template:Navbar	Ŝablono:Tnavbar
Template:Unicode	Ŝablono:Unicode
Category:格式模板	Kategorio:Ŝablono:Formatigo
Template:Nowrap	Ŝablono:Nrsp
維基大典:當有之文	Vikipedio:Listo de havendaj artikoloj
Category:數	Kategorio:Nombroj
Category:書籍	Kategorio:Libroj
Template:Wikisource	Ŝablono:Vikifontaro
Template:Babel	Ŝablono:Babelejo
Template:共享	Ŝablono:Commons
Template:Link GA	Ŝablono:LigoLeginda
Template:Reflist	Ŝablono:Referencoj
維基大典:掃興警示	Vikipedio:Atentigo pri intrigmalkaŝilo
Template:芻文	Ŝablono:Ĝermo
Template:See also	Ŝablono:Vidu ankaŭ
Template:User de	Ŝablono:Vikipediisto de
Template:User de-1	Ŝablono:Vikipediisto de-1
Template:User es-2	Ŝablono:Vikipediisto es
Template:User en-3	Ŝablono:Vikipediisto en-3
Template:User en-1	Ŝablono:Vikipediisto en-1
Template:User en-2	Ŝablono:Vikipediisto en-2
Template:User en-4	Ŝablono:Vikipediisto en-4
Template:User en	Ŝablono:Vikipediisto en
Template:User de-2	Ŝablono:Vikipediisto de-2
Template:User es-1	Ŝablono:Vikipediisto es-1
Template:User fr-1	Ŝablono:Vikipediisto fr-1
Template:User he-2	Ŝablono:Vikipediisto he-2
Template:User id-3	Ŝablono:Vikipediisto id-3
Template:User sk	Ŝablono:Vikipediisto sk
Template:User ja	Ŝablono:Vikipediisto ja
Template:User ja-1	Ŝablono:Vikipediisto ja-1
Template:User fr	Ŝablono:Vikipediisto fr
Category:智利	Kategorio:Ĉilio
Category:廿一世紀	Kategorio:21-a jarcento
Category:維護模板	Kategorio:Ŝablono:Zorgilo
Category:User uk	Kategorio:Vikipediisto uk
Category:User uk-N	Kategorio:Vikipediisto uk-D
Template:Esoteric	Ŝablono:Esotera
Template:Mod	Ŝablono:Mod
Template:User uk	Ŝablono:Vikipediisto uk
Category:百科全書	Kategorio:Enciklopedioj
Template:歡迎	Ŝablono:Bonvenon
Template:Click	Ŝablono:Ligo el bildo
Category:連結模板	Kategorio:Ŝablono:Lighelpo
Template:Userbox-2	Ŝablono:Uzantoskatolo-2
Category:User fr-1	Kategorio:Vikipediisto fr-1
Template:Wikiquote	Ŝablono:Vikicitaro
Template:Image label	Ŝablono:Marko sur bildo
Template:Ja	Ŝablono:Ja
Template:維基諸策	Ŝablono:Vikimedia fondaĵo
Template:醫	Ŝablono:Medicinaj temoj
Template:大修	Ŝablono:Redaktas
Template:Es	Ŝablono:Es
Template:Ambox	Ŝablono:ArtikolaMesaĝokesto
Template:Hide in print	Ŝablono:Ne presu
Category:美國史	Kategorio:Historio de Usono
Template:國	Ŝablono:Informkesto lando
Template:Infobox software	Ŝablono:Informkesto programaro
Template:Wide image	Ŝablono:Granda dosiero
Template:Military Conflict	Ŝablono:Informkesto milito
Template:Audio	Ŝablono:Aŭdio
Template:電玩訊欄	Ŝablono:Informkesto komputila kaj videoludo
Template:卓著	Ŝablono:Elstara
Category:User en-4	Kategorio:Vikipediisto en-4
Category:User en	Kategorio:Vikipediisto en
Category:User zh	Kategorio:Vikipediisto zh
Category:User zh-N	Kategorio:Vikipediisto zh-D
Category:User en-2	Kategorio:Vikipediisto en-2
Category:曲	Kategorio:Komponaĵoj
Template:Infobox	Ŝablono:Informkesto
Template:User zh	Ŝablono:Vikipediisto zh
Template:Template other	Ŝablono:Ĉu ŝablono
Template:Legend	Ŝablono:Priskribo
Template:引網	Ŝablono:Citaĵo el la reto
Category:食	Kategorio:Kuirarto
Template:未已之作	Ŝablono:Futuro
Template:Coor URL	Ŝablono:KoordinatojURL
Template:Pp-template	Ŝablono:Pp-ŝablono
Category:史書	Kategorio:Historiaj libroj
Template:維基爾雅	Ŝablono:Vikivortaro
Template:Multi-listen start	Ŝablono:Aŭskultu komenco
Template:Languageicon	Ŝablono:Ref-lang
Category:農業	Kategorio:Agrikulturo
Template:User ru	Ŝablono:Vikipediisto ru
Category:二十世紀	Kategorio:20-a jarcento
Template:IPA	Ŝablono:IFA
Template:釋義二	Ŝablono:Aliaj signifoj
Category:東羅馬史	Kategorio:Bizanca imperio
Template:LangWithName	Ŝablono:LingvoKunNomo
Template:Navbox subgroup	Ŝablono:Navigilo subgrupo
Template:Dyk	Ŝablono:ĈefPaĝo/ĈuViSciasKe
Template:Archive box	Ŝablono:Arkivo
Template:Namespace detect	Ŝablono:Determinas nomspacon
Template:Navbox with collapsible groups	Ŝablono:Navigilo kun kaŝeblaj grupoj
Template:Copyvio	Ŝablono:Neglekto de aŭtororajto
Template:天下觀	Ŝablono:Kulturdependa
Template:Image label end	Ŝablono:Marko sur bildo fino
Template:澳大利亞地方	Ŝablono:Aŭstraliaj ŝtatoj kaj teritorioj
Template:敗興	Ŝablono:Intrigo
Template:齋	Ŝablono:Uzula paĝo
Template:Math.ceil	Ŝablono:Supren
Template:Userboxbreak	Ŝablono:Uzantoskatolaro/interrompo
Template:User	Ŝablono:Uzanto2
非標準實數	Hiperreela nombro
Template:User language-4	Ŝablono:Babel kadro 4
Category:公司	Kategorio:Firmaoj
Template:User language-0	Ŝablono:Babel kadro 0
Template:User fr-3	Ŝablono:Vikipediisto fr-3
Template:Th	Ŝablono:Th
Template:Redirect	Ŝablono:Alidirekto
Category:電腦	Kategorio:Komputilo
Category:器	Kategorio:Aparataro
Template:非也	Ŝablono:Kontraŭ
Template:SUL Box	Ŝablono:Uzanto SUL
Category:複分析	Kategorio:Kompleksa analitiko
Category:User ja-N	Kategorio:Vikipediisto ja-D
Category:茶	Kategorio:Teoj
Template:釋義	Ŝablono:Apartigilo
Category:攝影	Kategorio:Fotado
Category:天皇本紀	Kategorio:Japanaj imperiestroj
Category:德意志第三帝國書	Kategorio:Nazia Germanio
Category:朝鮮史	Kategorio:Historio de Koreio
Category:礦冶	Kategorio:Minado
Template:User nan	Ŝablono:Vikipediisto zh-min-nan
Template:User nan-1	Ŝablono:Vikipediisto zh-min-nan-1
Template:User ksh	Ŝablono:Vikipediisto ksh
Template:Lang-en	Ŝablono:Lang-en
Category:建築	Kategorio:Arkitekturo
Category:生物	Kategorio:Vivaĵoj
Template:De	Ŝablono:De
Template:Infobox person	Ŝablono:Informkesto homoj
Category:鐵路	Kategorio:Fervojo
Template:洲	Ŝablono:Kontinentoj
Template:InterWiki	Ŝablono:Vikipedio
Category:金蘭之模	Kategorio:Ŝablono:Vikimedia projekto
Template:User bg	Ŝablono:Vikipediisto bg
Template:User la-1	Ŝablono:Vikipediisto la-1
Template:歐洲	Ŝablono:Ŝtatoj en Eŭropo
Category:User yue	Kategorio:Vikipediisto zh-yue
Category:User sk	Kategorio:Vikipediisto sk
Category:User fr	Kategorio:Vikipediisto fr
Category:User id	Kategorio:Vikipediisto id
Category:User ja	Kategorio:Vikipediisto ja
Category:User la	Kategorio:Vikipediisto la
Category:User th	Kategorio:Vikipediisto th
Category:User fr-3	Kategorio:Vikipediisto fr-3
Category:User fr-2	Kategorio:Vikipediisto fr-2
Category:User ja-2	Kategorio:Vikipediisto ja-2
Category:User ko-N	Kategorio:Vikipediisto ko-D
Category:User fr-N	Kategorio:Vikipediisto fr-D
Category:User ru-N	Kategorio:Vikipediisto ru-D
Category:娛樂	Kategorio:Distrado
Category:商學	Kategorio:Negoco
Category:文字	Kategorio:Skribsistemoj
Category:User bg	Kategorio:Vikipediisto bg
Category:輕小說	Kategorio:Mangailustritaj romanoj
Category:道教	Kategorio:Taoismo
Category:User bg-N	Kategorio:Vikipediisto bg-D
Category:User sk-N	Kategorio:Vikipediisto sk-D
Category:User de	Kategorio:Vikipediisto de
Category:User de-2	Kategorio:Vikipediisto de-2
Category:User de-N	Kategorio:Vikipediisto de-D
Category:User en-3	Kategorio:Vikipediisto en-3
Category:User en-N	Kategorio:Vikipediisto en-D
Category:User es	Kategorio:Vikipediisto es
Category:User es-1	Kategorio:Vikipediisto es-1
Category:User id-3	Kategorio:Vikipediisto id-3
Category:匈奴書	Kategorio:Ŝiungnuoj
Category:韓語	Kategorio:Korea lingvo
Category:幾何	Kategorio:Geometrio
Category:User ja-1	Kategorio:Vikipediisto ja-1
Category:User ko	Kategorio:Vikipediisto ko
Category:User ko-1	Kategorio:Vikipediisto ko-1
Category:User ko-2	Kategorio:Vikipediisto ko-2
Category:User ksh	Kategorio:Vikipediisto ksh
Category:User ksh-N	Kategorio:Vikipediisto ksh-D
Category:User la-3	Kategorio:Vikipediisto la-3
Template:辨	Ŝablono:Ne konfuzu
Category:User ru-1	Kategorio:Vikipediisto ru-1
維基大典:巴别	Vikipedio:Babelejo
Category:化合物	Kategorio:Kemiaj kombinaĵoj
Category:大洋洲史	Kategorio:Historio de Oceanio
長安	Ĉangan
Template:Math.floor	Ŝablono:Floor
Category:以嗜好類之維基人	Kategorio:Uzanto laŭ temo
Category:花	Kategorio:Floroj
Category:廣東省	Kategorio:Gŭangdongo
Category:四川省	Kategorio:Siĉuano
Category:遼寧省	Kategorio:Ljaŭningo
Category:陝西省	Kategorio:Ŝenŝjio
Category:安徽省	Kategorio:Anhujo
Category:江西省	Kategorio:Jianĝi
Category:江蘇省	Kategorio:Ĝjangsuo
Category:福建省	Kategorio:Fuĝjano
Category:河北省	Kategorio:Hebejo
Category:黑龍江省	Kategorio:Hejlongĝjango
Category:地理	Kategorio:Fizika geografio
Category:水	Kategorio:Akvo
Category:美洲史	Kategorio:Historio de Ameriko
Template:提案	Ŝablono:Propono
Category:User nan	Kategorio:Vikipediisto zh-min-nan
Category:地理學	Kategorio:Geografiaj studfakoj
Category:社會科學	Kategorio:Socia scienco
Template:封面	Ŝablono:Kovrilpaĝo
Template:Zh	Ŝablono:Zh
Category:奈良書	Kategorio:Nara-epoko
Template:Navigationsleiste	Ŝablono:Navigilo
Template:User ja-2	Ŝablono:Vikipediisto ja-2
Template:User ko-1	Ŝablono:Vikipediisto ko-1
Template:User ru-2	Ŝablono:Vikipediisto ru-2
Category:User ru	Kategorio:Vikipediisto ru
Category:User ru-2	Kategorio:Vikipediisto ru-2
Template:En	Ŝablono:En
Category:山東省	Kategorio:Ŝandongo
Category:雲南省	Kategorio:Junano
Category:青海省	Kategorio:Ĉinghajo
Category:河南省	Kategorio:Henano
Category:湖南省	Kategorio:Hunano
Template:Lang	Ŝablono:Lang
Category:日本文學	Kategorio:Japana literaturo
Category:群學	Kategorio:Sociologio
Template:2images	Ŝablono:Duobla bildo
域	Kampo
Category:三世紀	Kategorio:3-a jarcento
Category:十七世紀	Kategorio:17-a jarcento
Category:七世紀	Kategorio:7-a jarcento
Category:人	Kategorio:Homoj
Category:東羅馬本紀	Kategorio:Imperiestroj de la Bizanca Imperio
Category:門	Kategorio:Vikipedio:Portaloj
Template:Ko	Ŝablono:Ko
Template:Main	Ŝablono:Ĉefartikolo
Category:風	Kategorio:Ventoj
Template:PD-self	Ŝablono:PD-mem
Category:User zh-0	Kategorio:Vikipediisto zh-0
Category:希臘史	Kategorio:Historio de Grekio
Category:澳大利亞史	Kategorio:Historio de Aŭstralio
Category:加拿大史	Kategorio:Historio de Kanado
Category:東南亞史	Kategorio:Historio de Sudorienta Azio
Template:User ko	Ŝablono:Vikipediisto ko-D
Template:User ko-0	Ŝablono:Vikipediisto ko-0
Template:User ru-1	Ŝablono:Vikipediisto ru-1
Template:User zh-1	Ŝablono:Vikipediisto zh-1
Template:User zh-2	Ŝablono:Vikipediisto zh-2
Template:User zh-3	Ŝablono:Vikipediisto zh-3
Template:User zh-4	Ŝablono:Vikipediisto zh-4
Category:俄羅斯史	Kategorio:Historio de Rusio
Template:Multi-listen end	Ŝablono:Aŭskultu fino
Category:羅馬皇帝本紀	Kategorio:Romiaj imperiestroj
Category:戲劇	Kategorio:Teatro
Template:中立	Ŝablono:Sindetena
Category:中東史	Kategorio:Historio de Mezoriento
Category:User zh-1	Kategorio:Vikipediisto zh-1
Category:User zh-4	Kategorio:Vikipediisto zh-4
Category:User zh-3	Kategorio:Vikipediisto zh-3
Category:User zh-2	Kategorio:Vikipediisto zh-2
Category:刑法	Kategorio:Puna juro
Category:酸	Kategorio:Acidoj
Category:算法	Kategorio:Algoritmoj
Category:一世紀	Kategorio:1-a jarcento
Category:十四世紀	Kategorio:14-a jarcento
Category:二世紀	Kategorio:2-a jarcento
Category:四世紀	Kategorio:4-a jarcento
Category:十八世紀	Kategorio:18-a jarcento
Category:八世紀	Kategorio:8-a jarcento
Category:整數	Kategorio:Entjeroj
Category:印歐語系	Kategorio:Hindeŭropa lingvaro
Category:量子場論	Kategorio:Kvantuma kampa teorio
Category:化學元素	Kategorio:Kemiaj elementoj
Category:姓氏	Kategorio:Familiaj nomoj
Category:朝鮮民主主義人民共和國書	Kategorio:Nord-Koreio
Category:英國史	Kategorio:Historio de Britio
Category:中華史	Kategorio:Historio de Ĉinio
Category:臺灣省教育	Kategorio:Edukado en Tajvano
Category:新聞學	Kategorio:Ĵurnalistiko
Category:前二世紀	Kategorio:2-a jarcento a.K.
Category:前三世紀	Kategorio:3-a jarcento a.K.
Category:越南地理志	Kategorio:Geografio de Vjetnamio
Category:琉球志	Kategorio:Rjukju-reĝlando
Category:蘇聯書	Kategorio:Sovetunio
Category:古羅馬史	Kategorio:Romio
Category:前一世紀	Kategorio:1-a jarcento a.K.
Template:Ed	Ŝablono:Redaktu
Category:美國總統世家	Kategorio:Prezidantoj de Usono
Category:歐洲史	Kategorio:Historio de Eŭropo
Category:魚	Kategorio:Fiŝoj
Category:北京市	Kategorio:Pekino
Category:果	Kategorio:Fruktoj
Category:天候學	Kategorio:Klimatologio
Category:亞洲地理志	Kategorio:Geografio de Azio
Category:人類學	Kategorio:Antropologio
Category:作業系統	Kategorio:Operaciumoj
Category:天演	Kategorio:Evoluo
Category:動物	Kategorio:Bestoj
Category:兵器	Kategorio:Armiloj
Category:紀年	Kategorio:Kronologio
Category:弦論	Kategorio:Teorio de kordoj
Category:數學分析	Kategorio:Analitiko
Category:樂器	Kategorio:Muzikaj instrumentoj
Category:漢字	Kategorio:Ĉina skribo
Category:氣象	Kategorio:Meteologio
Category:實驗儀器	Kategorio:Laboratoriaj iloj
Category:香港	Kategorio:Honkongo
Category:PS2遊戲	Kategorio:Videoludoj ludeblaj per PlayStation 2
Category:鹽	Kategorio:Saloj
Category:衣	Kategorio:Vestoj
Category:上海市	Kategorio:Ŝanhajo
Category:龜	Kategorio:Testudoj
Category:中華節日	Kategorio:Ĉina festo
Category:節日	Kategorio:Festivaloj
Category:臺北市	Kategorio:Tajpeo
Category:書體	Kategorio:Tiparoj
Category:古希臘史	Kategorio:Antikva Grekio
Category:交通	Kategorio:Transporto
Category:刑	Kategorio:Punoj
Category:玩	Kategorio:Ludiloj
Category:群論	Kategorio:Grupa teorio
Category:數論	Kategorio:Nombroteorio
Category:拓撲學	Kategorio:Topologio
Category:疇人	Kategorio:Matematikistoj
Category:韓國維基人	Kategorio:Vikipediistoj de Sud-Koreio
Category:雕塑	Kategorio:Skulptado
Category:大韓民國大統領世家	Kategorio:Prezidantoj de Sud-Koreio
Category:漢語	Kategorio:Ĉina lingvaro
Category:澳門	Kategorio:Makao
Category:日本文	Kategorio:Japanaj skribsistemoj
Category:塔	Kategorio:Turoj
便利店	Oportuna butiko
Category:衛星	Kategorio:Lunoj
Category:數理物理	Kategorio:Matematika fiziko
Category:數學史	Kategorio:Historio de matematiko
Category:目錄學	Kategorio:Bibliografio
Template:依余之見	Ŝablono:Komento
中國 (釋義)	Ĉinio (apartigilo)
門:數學	Portalo:Matematiko
Category:美國維基人	Kategorio:Vikipediistoj de Usono
Category:臺灣維基人	Kategorio:Vikipediistoj de Tajvano
Template:User yue-2	Ŝablono:Vikipediisto zh-yue-2
Template:User nan-4	Ŝablono:Vikipediisto zh-min-nan-4
Template:User nan-2	Ŝablono:Vikipediisto zh-min-nan-2
Category:基礎之文	Kategorio:Havendaj artikoloj
Category:代數	Kategorio:Algebro
Category:雅典書	Kategorio:Antikva Ateno
Category:User ko-0	Kategorio:Vikipediisto ko-0
Category:胴體	Kategorio:Torso
Category:鹼	Kategorio:Kemiaj bazoj
Category:橋	Kategorio:Pontoj
Category:矮行星	Kategorio:Nanoplanedoj
Category:地震	Kategorio:Tertremoj
Category:東正教會	Kategorio:Ortodoksismo
Category:電極	Kategorio:Elektrodoj
Category:世界語	Kategorio:Esperanto
Category:語法格	Kategorio:Gramatikaj kazoj
Category:日本年號	Kategorio:Japanaj epokoj
Category:琉球本紀	Kategorio:Reĝoj de Rjukju
Category:律史	Kategorio:Historio de juro
門:化學	Portalo:Kemio
Category:軍事	Kategorio:Milita scienco
Category:中華民國書	Kategorio:Respubliko Ĉinio
Category:有機化學	Kategorio:Organika kemio
Category:琉球群島	Kategorio:Rjukju-insularo
Category:船舶	Kategorio:Ŝipoj
Category:衡器	Kategorio:Mezuriloj
Category:電話	Kategorio:Telefono
Category:應用科學	Kategorio:Aplikataj sciencoj
Category:中華當世諸省	Kategorio:Provincoj de Ĉinio
Category:輿圖學	Kategorio:Kartografio
Category:行星環	Kategorio:Planedaj ringoj
Template:Image label begin	Ŝablono:Marko sur bildo komenco
Category:儒家	Kategorio:Konfuceismo
Category:民法	Kategorio:Civila juro
Template:Babels	Ŝablono:Babellingva enhavo
Category:User en-1	Kategorio:Vikipediisto en-1
Category:User de-1	Kategorio:Vikipediisto de-1
Category:語言標示模	Kategorio:Ŝablono:Lingvonomo
Category:非洲史	Kategorio:Historio de Afriko
Category:羅馬共和本紀	Kategorio:Romiaj respublikaj konsuloj
Category:國憲	Kategorio:Konstitucia juro
埃博拉	Ebolo (viruso)
Template:文白相雜	Ŝablono:Esperantigu artikolon
Template:User nan-3	Ŝablono:Vikipediisto zh-min-nan-3
Template:FZW-Intro	Ŝablono:DiskutejoMultlingvaBonveno
Help:校對	Helpo:Markitaj versioj
雨冰	Frostiĝanta pluvo
維基大典:驛站	Vikipedio:Bushaltejo
韓國世界語協會	Korea Esperanto-Asocio
Template:Multi-listen item	Ŝablono:Aŭskultu temon
Template:User zh-yue-0	Ŝablono:Vikipediisto zh-yue-0
維基大典:編輯次數	Vikipedio:Listo de uzantoj laŭ redaktonombro
Template:Style/IPA	Ŝablono:Style/IPA
Template:Style/yid	Ŝablono:Style/yid
Module:Yesno	Modulo:Yesno
Special:近易	Specialaĵo:Lastaj ŝanĝoj
Module:HtmlBuilder	Modulo:HtmlBuilder
Module:String	Modulo:String
Module:InfoboxImage	Modulo:InfoboxImage
Category:龍	Kategorio:Ĉinaj drakoj
雨傘運動	Protestoj en Honkongo 2014
代言 (動漫)	Maskoto
